"participant","machine","set","contraction_mode","time_video_rater_cv_ms","time_video_rater_dg_ms","time_smartphone_1_ms","time_smartphone_2_ms","video_rater_mean_ms","smartphones_mean_ms","relative_difference","difference_video_smartphone_ms","mean_video_smartphone_ms","contraction_mode_levels","difference_video_raters_ms","difference_smartphones_ms","video_smartphone_difference_outlier","rater_difference_outlier","smartphone_difference_outlier","normalized_error_smartphone","participant_age_levels","participant_age_years","participant_height_cm","participant_weight_kg","participant_gender"
1,"LEG PRESS",1,"Con01",1340,1360,1650,1700,1350,1675,0.241,-325,1512.5,"Con",-20,-50,FALSE,FALSE,FALSE,19.4,"young",42,187,77,"m"
1,"LEG PRESS",1,"Con02",1160,1180,1350,1350,1170,1350,0.154,-180,1260,"Con",-20,0,FALSE,FALSE,FALSE,13.33,"young",42,187,77,"m"
1,"LEG PRESS",1,"Con03",1220,1240,1400,1350,1230,1375,0.118,-145,1302.5,"Con",-20,50,FALSE,FALSE,FALSE,10.55,"young",42,187,77,"m"
1,"LEG PRESS",1,"Con04",1260,1280,1400,1350,1270,1375,0.083,-105,1322.5,"Con",-20,50,FALSE,FALSE,FALSE,7.64,"young",42,187,77,"m"
1,"LEG PRESS",1,"Con05",1560,1180,1350,1300,1370,1325,0.033,45,1347.5,"Con",380,50,FALSE,TRUE,FALSE,3.4,"young",42,187,77,"m"
1,"LEG PRESS",1,"Con06",1020,1060,1250,1250,1040,1250,0.202,-210,1145,"Con",-40,0,FALSE,FALSE,FALSE,16.8,"young",42,187,77,"m"
1,"LEG PRESS",1,"Con07",1060,1080,1550,1600,1070,1575,0.472,-505,1322.5,"Con",-20,-50,TRUE,FALSE,FALSE,32.06,"young",42,187,77,"m"
1,"LEG PRESS",1,"Con08",1100,1100,1500,1500,1100,1500,0.364,-400,1300,"Con",0,0,TRUE,FALSE,FALSE,26.67,"young",42,187,77,"m"
1,"LEG PRESS",1,"Con09",1060,1060,1600,1650,1060,1625,0.533,-565,1342.5,"Con",0,-50,TRUE,FALSE,FALSE,34.77,"young",42,187,77,"m"
1,"LEG PRESS",1,"Con10",1040,1060,1650,1650,1050,1650,0.571,-600,1350,"Con",-20,0,TRUE,FALSE,FALSE,36.36,"young",42,187,77,"m"
1,"LEG PRESS",2,"Con01",1080,1100,2500,1300,1090,1900,0.743,-810,1495,"Con",-20,1200,TRUE,FALSE,TRUE,42.63,"young",42,187,77,"m"
1,"LEG PRESS",2,"Con02",980,980,1100,1100,980,1100,0.122,-120,1040,"Con",0,0,FALSE,FALSE,FALSE,10.91,"young",42,187,77,"m"
1,"LEG PRESS",2,"Con03",1020,1020,1100,1150,1020,1125,0.103,-105,1072.5,"Con",0,-50,FALSE,FALSE,FALSE,9.33,"young",42,187,77,"m"
1,"LEG PRESS",2,"Con04",1000,1020,1150,1150,1010,1150,0.139,-140,1080,"Con",-20,0,FALSE,FALSE,FALSE,12.17,"young",42,187,77,"m"
1,"LEG PRESS",2,"Con05",940,980,1100,1100,960,1100,0.146,-140,1030,"Con",-40,0,FALSE,FALSE,FALSE,12.73,"young",42,187,77,"m"
1,"LEG PRESS",2,"Con06",1000,1020,1200,1150,1010,1175,0.163,-165,1092.5,"Con",-20,50,FALSE,FALSE,FALSE,14.04,"young",42,187,77,"m"
1,"LEG PRESS",2,"Con07",960,960,1350,1200,960,1275,0.328,-315,1117.5,"Con",0,150,FALSE,FALSE,FALSE,24.71,"young",42,187,77,"m"
1,"LEG PRESS",2,"Con08",1000,980,1450,1400,990,1425,0.439,-435,1207.5,"Con",20,50,TRUE,FALSE,FALSE,30.53,"young",42,187,77,"m"
1,"LEG PRESS",2,"Con09",900,920,1200,1400,910,1300,0.429,-390,1105,"Con",-20,-200,TRUE,FALSE,TRUE,30,"young",42,187,77,"m"
1,"LEG PRESS",2,"Con10",980,1040,1600,1700,1010,1650,0.634,-640,1330,"Con",-60,-100,TRUE,FALSE,FALSE,38.79,"young",42,187,77,"m"
1,"LEG PRESS",1,"Ecc01",2580,2560,2450,2400,2570,2425,0.056,145,2497.5,"Ecc",20,50,FALSE,FALSE,FALSE,5.98,"young",42,187,77,"m"
1,"LEG PRESS",1,"Ecc02",2300,2280,2100,2150,2290,2125,0.072,165,2207.5,"Ecc",20,-50,FALSE,FALSE,FALSE,7.76,"young",42,187,77,"m"
1,"LEG PRESS",1,"Ecc03",2120,2100,1950,2000,2110,1975,0.064,135,2042.5,"Ecc",20,-50,FALSE,FALSE,FALSE,6.84,"young",42,187,77,"m"
1,"LEG PRESS",1,"Ecc04",2080,2080,1950,2000,2080,1975,0.05,105,2027.5,"Ecc",0,-50,FALSE,FALSE,FALSE,5.32,"young",42,187,77,"m"
1,"LEG PRESS",1,"Ecc05",1840,2200,2000,2050,2020,2025,0.002,-5,2022.5,"Ecc",-360,-50,FALSE,TRUE,FALSE,0.25,"young",42,187,77,"m"
1,"LEG PRESS",1,"Ecc06",1940,1900,1750,1700,1920,1725,0.102,195,1822.5,"Ecc",40,50,FALSE,FALSE,FALSE,11.3,"young",42,187,77,"m"
1,"LEG PRESS",1,"Ecc07",2000,2000,1450,1450,2000,1450,0.275,550,1725,"Ecc",0,0,TRUE,FALSE,FALSE,37.93,"young",42,187,77,"m"
1,"LEG PRESS",1,"Ecc08",1820,1820,1500,1450,1820,1475,0.19,345,1647.5,"Ecc",0,50,TRUE,FALSE,FALSE,23.39,"young",42,187,77,"m"
1,"LEG PRESS",1,"Ecc09",1920,1920,1300,1250,1920,1275,0.336,645,1597.5,"Ecc",0,50,TRUE,FALSE,FALSE,50.59,"young",42,187,77,"m"
1,"LEG PRESS",1,"Ecc10",2180,2200,2400,2400,2190,2400,0.096,-210,2295,"Ecc",-20,0,FALSE,FALSE,FALSE,8.75,"young",42,187,77,"m"
1,"LEG PRESS",2,"Ecc01",1540,1520,1450,1450,1530,1450,0.052,80,1490,"Ecc",20,0,FALSE,FALSE,FALSE,5.52,"young",42,187,77,"m"
1,"LEG PRESS",2,"Ecc02",1580,1580,1500,1500,1580,1500,0.051,80,1540,"Ecc",0,0,FALSE,FALSE,FALSE,5.33,"young",42,187,77,"m"
1,"LEG PRESS",2,"Ecc03",1680,1680,1550,1500,1680,1525,0.092,155,1602.5,"Ecc",0,50,FALSE,FALSE,FALSE,10.16,"young",42,187,77,"m"
1,"LEG PRESS",2,"Ecc04",1720,1680,1600,1600,1700,1600,0.059,100,1650,"Ecc",40,0,FALSE,FALSE,FALSE,6.25,"young",42,187,77,"m"
1,"LEG PRESS",2,"Ecc05",1800,1780,1600,1650,1790,1625,0.092,165,1707.5,"Ecc",20,-50,FALSE,FALSE,FALSE,10.15,"young",42,187,77,"m"
1,"LEG PRESS",2,"Ecc06",1780,1760,1600,1600,1770,1600,0.096,170,1685,"Ecc",20,0,FALSE,FALSE,FALSE,10.62,"young",42,187,77,"m"
1,"LEG PRESS",2,"Ecc07",1620,1640,1200,1400,1630,1300,0.202,330,1465,"Ecc",-20,-200,TRUE,FALSE,TRUE,25.38,"young",42,187,77,"m"
1,"LEG PRESS",2,"Ecc08",1660,1660,1200,1200,1660,1200,0.277,460,1430,"Ecc",0,0,TRUE,FALSE,FALSE,38.33,"young",42,187,77,"m"
1,"LEG PRESS",2,"Ecc09",1640,1620,1350,1100,1630,1225,0.248,405,1427.5,"Ecc",20,250,TRUE,FALSE,TRUE,33.06,"young",42,187,77,"m"
1,"LEG PRESS",2,"Ecc10",1900,1840,1400,1350,1870,1375,0.265,495,1622.5,"Ecc",60,50,TRUE,FALSE,FALSE,36,"young",42,187,77,"m"
1,"LEG PRESS",1,"Rep01",3920,3920,4100,4100,3920,4100,0.046,-180,4010,"Rep",0,0,TRUE,FALSE,FALSE,4.39,"young",42,187,77,"m"
1,"LEG PRESS",1,"Rep02",3460,3460,3450,3500,3460,3475,0.004,-15,3467.5,"Rep",0,-50,FALSE,FALSE,FALSE,0.43,"young",42,187,77,"m"
1,"LEG PRESS",1,"Rep03",3340,3340,3350,3350,3340,3350,0.003,-10,3345,"Rep",0,0,FALSE,FALSE,FALSE,0.3,"young",42,187,77,"m"
1,"LEG PRESS",1,"Rep04",3340,3360,3350,3350,3350,3350,0,0,3350,"Rep",-20,0,FALSE,FALSE,FALSE,0,"young",42,187,77,"m"
1,"LEG PRESS",1,"Rep05",3400,3380,3350,3350,3390,3350,0.012,40,3370,"Rep",20,0,FALSE,FALSE,FALSE,1.19,"young",42,187,77,"m"
1,"LEG PRESS",1,"Rep06",2960,2960,3000,2950,2960,2975,0.005,-15,2967.5,"Rep",0,50,FALSE,FALSE,FALSE,0.5,"young",42,187,77,"m"
1,"LEG PRESS",1,"Rep07",3060,3080,3000,3050,3070,3025,0.015,45,3047.5,"Rep",-20,-50,FALSE,FALSE,FALSE,1.49,"young",42,187,77,"m"
1,"LEG PRESS",1,"Rep08",2920,2920,3000,2950,2920,2975,0.019,-55,2947.5,"Rep",0,50,FALSE,FALSE,FALSE,1.85,"young",42,187,77,"m"
1,"LEG PRESS",1,"Rep09",2980,2980,2900,2900,2980,2900,0.027,80,2940,"Rep",0,0,FALSE,FALSE,FALSE,2.76,"young",42,187,77,"m"
1,"LEG PRESS",1,"Rep10",3220,3260,4050,4050,3240,4050,0.25,-810,3645,"Rep",-40,0,TRUE,FALSE,FALSE,20,"young",42,187,77,"m"
1,"LEG PRESS",2,"Rep01",2620,2620,3950,2750,2620,3350,0.279,-730,2985,"Rep",0,1200,TRUE,FALSE,TRUE,21.79,"young",42,187,77,"m"
1,"LEG PRESS",2,"Rep02",2560,2560,2600,2600,2560,2600,0.016,-40,2580,"Rep",0,0,FALSE,FALSE,FALSE,1.54,"young",42,187,77,"m"
1,"LEG PRESS",2,"Rep03",2700,2700,2650,2650,2700,2650,0.019,50,2675,"Rep",0,0,FALSE,FALSE,FALSE,1.89,"young",42,187,77,"m"
1,"LEG PRESS",2,"Rep04",2720,2700,2750,2750,2710,2750,0.015,-40,2730,"Rep",20,0,FALSE,FALSE,FALSE,1.45,"young",42,187,77,"m"
1,"LEG PRESS",2,"Rep05",2740,2760,2700,2750,2750,2725,0.009,25,2737.5,"Rep",-20,-50,FALSE,FALSE,FALSE,0.92,"young",42,187,77,"m"
1,"LEG PRESS",2,"Rep06",2780,2780,2800,2750,2780,2775,0.002,5,2777.5,"Rep",0,50,FALSE,FALSE,FALSE,0.18,"young",42,187,77,"m"
1,"LEG PRESS",2,"Rep07",2580,2600,2550,2600,2590,2575,0.006,15,2582.5,"Rep",-20,-50,FALSE,FALSE,FALSE,0.58,"young",42,187,77,"m"
1,"LEG PRESS",2,"Rep08",2660,2640,2650,2600,2650,2625,0.009,25,2637.5,"Rep",20,50,FALSE,FALSE,FALSE,0.95,"young",42,187,77,"m"
1,"LEG PRESS",2,"Rep09",2540,2540,2550,2500,2540,2525,0.006,15,2532.5,"Rep",0,50,FALSE,FALSE,FALSE,0.59,"young",42,187,77,"m"
1,"LEG PRESS",2,"Rep10",2880,2880,3000,3050,2880,3025,0.05,-145,2952.5,"Rep",0,-50,TRUE,FALSE,FALSE,4.79,"young",42,187,77,"m"
1,"LEG PRESS",1,"TuT",32600,32660,33550,33550,32630,33550,0.028,-920,33090,"TuT",-60,0,TRUE,FALSE,FALSE,2.74,"young",42,187,77,"m"
1,"LEG PRESS",2,"TuT",26780,26780,28200,27000,26780,27600,0.031,-820,27190,"TuT",0,1200,TRUE,FALSE,TRUE,2.97,"young",42,187,77,"m"
1,"LEG EXTENSION",1,"Con01",1160,1140,1300,1300,1150,1300,0.13,-150,1225,"Con",20,0,FALSE,FALSE,FALSE,11.54,"young",42,187,77,"m"
1,"LEG EXTENSION",1,"Con02",1160,1160,1200,1150,1160,1175,0.013,-15,1167.5,"Con",0,50,FALSE,FALSE,FALSE,1.28,"young",42,187,77,"m"
1,"LEG EXTENSION",1,"Con03",1220,1200,1250,1250,1210,1250,0.033,-40,1230,"Con",20,0,FALSE,FALSE,FALSE,3.2,"young",42,187,77,"m"
1,"LEG EXTENSION",1,"Con04",1240,1260,1300,1250,1250,1275,0.02,-25,1262.5,"Con",-20,50,FALSE,FALSE,FALSE,1.96,"young",42,187,77,"m"
1,"LEG EXTENSION",1,"Con05",1220,1200,1250,1300,1210,1275,0.054,-65,1242.5,"Con",20,-50,FALSE,FALSE,FALSE,5.1,"young",42,187,77,"m"
1,"LEG EXTENSION",1,"Con06",1260,1260,1350,1350,1260,1350,0.071,-90,1305,"Con",0,0,FALSE,FALSE,FALSE,6.67,"young",42,187,77,"m"
1,"LEG EXTENSION",1,"Con07",1260,1260,1300,1300,1260,1300,0.032,-40,1280,"Con",0,0,FALSE,FALSE,FALSE,3.08,"young",42,187,77,"m"
1,"LEG EXTENSION",1,"Con08",1220,1220,1350,1350,1220,1350,0.107,-130,1285,"Con",0,0,FALSE,FALSE,FALSE,9.63,"young",42,187,77,"m"
1,"LEG EXTENSION",1,"Con09",1240,1220,1400,1400,1230,1400,0.138,-170,1315,"Con",20,0,FALSE,FALSE,FALSE,12.14,"young",42,187,77,"m"
1,"LEG EXTENSION",1,"Con10",1420,1420,1600,1550,1420,1575,0.109,-155,1497.5,"Con",0,50,FALSE,FALSE,FALSE,9.84,"young",42,187,77,"m"
1,"LEG EXTENSION",2,"Con01",1020,1040,1250,1150,1030,1200,0.165,-170,1115,"Con",-20,100,FALSE,FALSE,FALSE,14.17,"young",42,187,77,"m"
1,"LEG EXTENSION",2,"Con02",1200,1200,1250,1300,1200,1275,0.062,-75,1237.5,"Con",0,-50,FALSE,FALSE,FALSE,5.88,"young",42,187,77,"m"
1,"LEG EXTENSION",2,"Con03",1220,1240,1300,1350,1230,1325,0.077,-95,1277.5,"Con",-20,-50,FALSE,FALSE,FALSE,7.17,"young",42,187,77,"m"
1,"LEG EXTENSION",2,"Con04",1180,1160,1200,1250,1170,1225,0.047,-55,1197.5,"Con",20,-50,FALSE,FALSE,FALSE,4.49,"young",42,187,77,"m"
1,"LEG EXTENSION",2,"Con05",1200,1200,1250,1250,1200,1250,0.042,-50,1225,"Con",0,0,FALSE,FALSE,FALSE,4,"young",42,187,77,"m"
1,"LEG EXTENSION",2,"Con06",1140,1160,1200,1200,1150,1200,0.043,-50,1175,"Con",-20,0,FALSE,FALSE,FALSE,4.17,"young",42,187,77,"m"
1,"LEG EXTENSION",2,"Con07",1160,1180,1250,1250,1170,1250,0.068,-80,1210,"Con",-20,0,FALSE,FALSE,FALSE,6.4,"young",42,187,77,"m"
1,"LEG EXTENSION",2,"Con08",1220,1220,1350,1300,1220,1325,0.086,-105,1272.5,"Con",0,50,FALSE,FALSE,FALSE,7.92,"young",42,187,77,"m"
1,"LEG EXTENSION",2,"Con09",1200,1220,1400,1400,1210,1400,0.157,-190,1305,"Con",-20,0,TRUE,FALSE,FALSE,13.57,"young",42,187,77,"m"
1,"LEG EXTENSION",2,"Con10",1240,1240,1400,1450,1240,1425,0.149,-185,1332.5,"Con",0,-50,TRUE,FALSE,FALSE,12.98,"young",42,187,77,"m"
1,"LEG EXTENSION",1,"Ecc01",2340,2320,2250,2300,2330,2275,0.024,55,2302.5,"Ecc",20,-50,FALSE,FALSE,FALSE,2.42,"young",42,187,77,"m"
1,"LEG EXTENSION",1,"Ecc02",2340,2360,2300,2300,2350,2300,0.021,50,2325,"Ecc",-20,0,FALSE,FALSE,FALSE,2.17,"young",42,187,77,"m"
1,"LEG EXTENSION",1,"Ecc03",2020,2000,2000,2000,2010,2000,0.005,10,2005,"Ecc",20,0,FALSE,FALSE,FALSE,0.5,"young",42,187,77,"m"
1,"LEG EXTENSION",1,"Ecc04",2120,2120,2050,2100,2120,2075,0.021,45,2097.5,"Ecc",0,-50,FALSE,FALSE,FALSE,2.17,"young",42,187,77,"m"
1,"LEG EXTENSION",1,"Ecc05",2100,2120,2050,2000,2110,2025,0.04,85,2067.5,"Ecc",-20,50,FALSE,FALSE,FALSE,4.2,"young",42,187,77,"m"
1,"LEG EXTENSION",1,"Ecc06",2060,2060,2000,2000,2060,2000,0.029,60,2030,"Ecc",0,0,FALSE,FALSE,FALSE,3,"young",42,187,77,"m"
1,"LEG EXTENSION",1,"Ecc07",1940,1940,1850,1850,1940,1850,0.046,90,1895,"Ecc",0,0,FALSE,FALSE,FALSE,4.86,"young",42,187,77,"m"
1,"LEG EXTENSION",1,"Ecc08",2000,2020,1850,1850,2010,1850,0.08,160,1930,"Ecc",-20,0,FALSE,FALSE,FALSE,8.65,"young",42,187,77,"m"
1,"LEG EXTENSION",1,"Ecc09",2080,2060,1900,1950,2070,1925,0.07,145,1997.5,"Ecc",20,-50,FALSE,FALSE,FALSE,7.53,"young",42,187,77,"m"
1,"LEG EXTENSION",1,"Ecc10",2240,2260,2300,2250,2250,2275,0.011,-25,2262.5,"Ecc",-20,50,FALSE,FALSE,FALSE,1.1,"young",42,187,77,"m"
1,"LEG EXTENSION",2,"Ecc01",2120,2140,2050,2050,2130,2050,0.038,80,2090,"Ecc",-20,0,FALSE,FALSE,FALSE,3.9,"young",42,187,77,"m"
1,"LEG EXTENSION",2,"Ecc02",2460,2440,2400,2300,2450,2350,0.041,100,2400,"Ecc",20,100,FALSE,FALSE,FALSE,4.26,"young",42,187,77,"m"
1,"LEG EXTENSION",2,"Ecc03",2400,2400,2350,2300,2400,2325,0.031,75,2362.5,"Ecc",0,50,FALSE,FALSE,FALSE,3.23,"young",42,187,77,"m"
1,"LEG EXTENSION",2,"Ecc04",2220,2240,2200,2200,2230,2200,0.013,30,2215,"Ecc",-20,0,FALSE,FALSE,FALSE,1.36,"young",42,187,77,"m"
1,"LEG EXTENSION",2,"Ecc05",2120,2100,2050,2050,2110,2050,0.028,60,2080,"Ecc",20,0,FALSE,FALSE,FALSE,2.93,"young",42,187,77,"m"
1,"LEG EXTENSION",2,"Ecc06",2580,2560,2500,2500,2570,2500,0.027,70,2535,"Ecc",20,0,FALSE,FALSE,FALSE,2.8,"young",42,187,77,"m"
1,"LEG EXTENSION",2,"Ecc07",2220,2220,2100,2150,2220,2125,0.043,95,2172.5,"Ecc",0,-50,FALSE,FALSE,FALSE,4.47,"young",42,187,77,"m"
1,"LEG EXTENSION",2,"Ecc08",2160,2140,2000,2000,2150,2000,0.07,150,2075,"Ecc",20,0,FALSE,FALSE,FALSE,7.5,"young",42,187,77,"m"
1,"LEG EXTENSION",2,"Ecc09",2140,2140,1950,1950,2140,1950,0.089,190,2045,"Ecc",0,0,TRUE,FALSE,FALSE,9.74,"young",42,187,77,"m"
1,"LEG EXTENSION",2,"Ecc10",2280,2280,2300,2250,2280,2275,0.002,5,2277.5,"Ecc",0,50,FALSE,FALSE,FALSE,0.22,"young",42,187,77,"m"
1,"LEG EXTENSION",1,"Rep01",3500,3460,3550,3600,3480,3575,0.027,-95,3527.5,"Rep",40,-50,FALSE,FALSE,FALSE,2.66,"young",42,187,77,"m"
1,"LEG EXTENSION",1,"Rep02",3500,3520,3500,3450,3510,3475,0.01,35,3492.5,"Rep",-20,50,FALSE,FALSE,FALSE,1.01,"young",42,187,77,"m"
1,"LEG EXTENSION",1,"Rep03",3240,3200,3250,3250,3220,3250,0.009,-30,3235,"Rep",40,0,FALSE,FALSE,FALSE,0.92,"young",42,187,77,"m"
1,"LEG EXTENSION",1,"Rep04",3360,3380,3350,3350,3370,3350,0.006,20,3360,"Rep",-20,0,FALSE,FALSE,FALSE,0.6,"young",42,187,77,"m"
1,"LEG EXTENSION",1,"Rep05",3320,3320,3300,3300,3320,3300,0.006,20,3310,"Rep",0,0,FALSE,FALSE,FALSE,0.61,"young",42,187,77,"m"
1,"LEG EXTENSION",1,"Rep06",3320,3320,3350,3350,3320,3350,0.009,-30,3335,"Rep",0,0,FALSE,FALSE,FALSE,0.9,"young",42,187,77,"m"
1,"LEG EXTENSION",1,"Rep07",3200,3200,3150,3150,3200,3150,0.016,50,3175,"Rep",0,0,FALSE,FALSE,FALSE,1.59,"young",42,187,77,"m"
1,"LEG EXTENSION",1,"Rep08",3220,3240,3200,3200,3230,3200,0.009,30,3215,"Rep",-20,0,FALSE,FALSE,FALSE,0.94,"young",42,187,77,"m"
1,"LEG EXTENSION",1,"Rep09",3320,3280,3300,3350,3300,3325,0.008,-25,3312.5,"Rep",40,-50,FALSE,FALSE,FALSE,0.75,"young",42,187,77,"m"
1,"LEG EXTENSION",1,"Rep10",3660,3680,3900,3800,3670,3850,0.049,-180,3760,"Rep",-20,100,TRUE,FALSE,FALSE,4.68,"young",42,187,77,"m"
1,"LEG EXTENSION",2,"Rep01",3140,3180,3300,3200,3160,3250,0.028,-90,3205,"Rep",-40,100,FALSE,FALSE,FALSE,2.77,"young",42,187,77,"m"
1,"LEG EXTENSION",2,"Rep02",3660,3640,3650,3600,3650,3625,0.007,25,3637.5,"Rep",20,50,FALSE,FALSE,FALSE,0.69,"young",42,187,77,"m"
1,"LEG EXTENSION",2,"Rep03",3620,3640,3650,3650,3630,3650,0.006,-20,3640,"Rep",-20,0,FALSE,FALSE,FALSE,0.55,"young",42,187,77,"m"
1,"LEG EXTENSION",2,"Rep04",3400,3400,3400,3450,3400,3425,0.007,-25,3412.5,"Rep",0,-50,FALSE,FALSE,FALSE,0.73,"young",42,187,77,"m"
1,"LEG EXTENSION",2,"Rep05",3320,3300,3300,3300,3310,3300,0.003,10,3305,"Rep",20,0,FALSE,FALSE,FALSE,0.3,"young",42,187,77,"m"
1,"LEG EXTENSION",2,"Rep06",3720,3720,3700,3700,3720,3700,0.005,20,3710,"Rep",0,0,FALSE,FALSE,FALSE,0.54,"young",42,187,77,"m"
1,"LEG EXTENSION",2,"Rep07",3380,3400,3350,3400,3390,3375,0.004,15,3382.5,"Rep",-20,-50,FALSE,FALSE,FALSE,0.44,"young",42,187,77,"m"
1,"LEG EXTENSION",2,"Rep08",3380,3360,3350,3300,3370,3325,0.013,45,3347.5,"Rep",20,50,FALSE,FALSE,FALSE,1.35,"young",42,187,77,"m"
1,"LEG EXTENSION",2,"Rep09",3340,3360,3350,3350,3350,3350,0,0,3350,"Rep",-20,0,FALSE,FALSE,FALSE,0,"young",42,187,77,"m"
1,"LEG EXTENSION",2,"Rep10",3520,3520,3700,3700,3520,3700,0.051,-180,3610,"Rep",0,0,TRUE,FALSE,FALSE,4.86,"young",42,187,77,"m"
1,"LEG EXTENSION",1,"TuT",33640,33600,33850,33800,33620,33825,0.006,-205,33722.5,"TuT",40,50,TRUE,FALSE,FALSE,0.61,"young",42,187,77,"m"
1,"LEG EXTENSION",2,"TuT",34480,34520,34750,34650,34500,34700,0.006,-200,34600,"TuT",-40,100,TRUE,FALSE,FALSE,0.58,"young",42,187,77,"m"
1,"LEG CURL",1,"Con01",1860,1820,1900,1850,1840,1875,0.019,-35,1857.5,"Con",40,50,FALSE,FALSE,FALSE,1.87,"young",42,187,77,"m"
1,"LEG CURL",1,"Con02",1420,1420,1400,1400,1420,1400,0.014,20,1410,"Con",0,0,FALSE,FALSE,FALSE,1.43,"young",42,187,77,"m"
1,"LEG CURL",1,"Con03",1620,1600,1650,1650,1610,1650,0.025,-40,1630,"Con",20,0,FALSE,FALSE,FALSE,2.42,"young",42,187,77,"m"
1,"LEG CURL",1,"Con04",1320,1360,1400,1500,1340,1450,0.082,-110,1395,"Con",-40,-100,FALSE,FALSE,FALSE,7.59,"young",42,187,77,"m"
1,"LEG CURL",1,"Con05",1320,1320,1450,1450,1320,1450,0.098,-130,1385,"Con",0,0,FALSE,FALSE,FALSE,8.97,"young",42,187,77,"m"
1,"LEG CURL",1,"Con06",1260,1260,1400,1350,1260,1375,0.091,-115,1317.5,"Con",0,50,FALSE,FALSE,FALSE,8.36,"young",42,187,77,"m"
1,"LEG CURL",1,"Con07",1280,1320,1400,1350,1300,1375,0.058,-75,1337.5,"Con",-40,50,FALSE,FALSE,FALSE,5.45,"young",42,187,77,"m"
1,"LEG CURL",1,"Con08",1220,1240,1400,1400,1230,1400,0.138,-170,1315,"Con",-20,0,FALSE,FALSE,FALSE,12.14,"young",42,187,77,"m"
1,"LEG CURL",1,"Con09",1260,1260,1400,1400,1260,1400,0.111,-140,1330,"Con",0,0,FALSE,FALSE,FALSE,10,"young",42,187,77,"m"
1,"LEG CURL",1,"Con10",1340,1360,1550,1600,1350,1575,0.167,-225,1462.5,"Con",-20,-50,FALSE,FALSE,FALSE,14.29,"young",42,187,77,"m"
1,"LEG CURL",2,"Con01",1480,1460,1600,1500,1470,1550,0.054,-80,1510,"Con",20,100,FALSE,FALSE,FALSE,5.16,"young",42,187,77,"m"
1,"LEG CURL",2,"Con02",1420,1400,1450,1550,1410,1500,0.064,-90,1455,"Con",20,-100,FALSE,FALSE,FALSE,6,"young",42,187,77,"m"
1,"LEG CURL",2,"Con03",1380,1380,1450,1500,1380,1475,0.069,-95,1427.5,"Con",0,-50,FALSE,FALSE,FALSE,6.44,"young",42,187,77,"m"
1,"LEG CURL",2,"Con04",1220,1240,1250,1200,1230,1225,0.004,5,1227.5,"Con",-20,50,FALSE,FALSE,FALSE,0.41,"young",42,187,77,"m"
1,"LEG CURL",2,"Con05",1320,1320,1400,1350,1320,1375,0.042,-55,1347.5,"Con",0,50,FALSE,FALSE,FALSE,4,"young",42,187,77,"m"
1,"LEG CURL",2,"Con06",1320,1360,1400,1400,1340,1400,0.045,-60,1370,"Con",-40,0,FALSE,FALSE,FALSE,4.29,"young",42,187,77,"m"
1,"LEG CURL",2,"Con07",1240,1220,1400,1450,1230,1425,0.159,-195,1327.5,"Con",20,-50,FALSE,FALSE,FALSE,13.68,"young",42,187,77,"m"
1,"LEG CURL",2,"Con08",1200,1220,1350,1400,1210,1375,0.136,-165,1292.5,"Con",-20,-50,FALSE,FALSE,FALSE,12,"young",42,187,77,"m"
1,"LEG CURL",2,"Con09",1280,1280,1450,1500,1280,1475,0.152,-195,1377.5,"Con",0,-50,FALSE,FALSE,FALSE,13.22,"young",42,187,77,"m"
1,"LEG CURL",2,"Con10",1300,1300,1450,1400,1300,1425,0.096,-125,1362.5,"Con",0,50,FALSE,FALSE,FALSE,8.77,"young",42,187,77,"m"
1,"LEG CURL",1,"Ecc01",2300,2300,2350,2350,2300,2350,0.022,-50,2325,"Ecc",0,0,FALSE,FALSE,FALSE,2.13,"young",42,187,77,"m"
1,"LEG CURL",1,"Ecc02",2800,2820,2800,2800,2810,2800,0.004,10,2805,"Ecc",-20,0,FALSE,FALSE,FALSE,0.36,"young",42,187,77,"m"
1,"LEG CURL",1,"Ecc03",2680,2660,2600,2550,2670,2575,0.036,95,2622.5,"Ecc",20,50,FALSE,FALSE,FALSE,3.69,"young",42,187,77,"m"
1,"LEG CURL",1,"Ecc04",2460,2440,2400,2300,2450,2350,0.041,100,2400,"Ecc",20,100,FALSE,FALSE,FALSE,4.26,"young",42,187,77,"m"
1,"LEG CURL",1,"Ecc05",2220,2220,2050,2100,2220,2075,0.065,145,2147.5,"Ecc",0,-50,FALSE,FALSE,FALSE,6.99,"young",42,187,77,"m"
1,"LEG CURL",1,"Ecc06",2160,2140,2050,2100,2150,2075,0.035,75,2112.5,"Ecc",20,-50,FALSE,FALSE,FALSE,3.61,"young",42,187,77,"m"
1,"LEG CURL",1,"Ecc07",2280,2260,2100,2150,2270,2125,0.064,145,2197.5,"Ecc",20,-50,FALSE,FALSE,FALSE,6.82,"young",42,187,77,"m"
1,"LEG CURL",1,"Ecc08",2240,2240,2100,2100,2240,2100,0.062,140,2170,"Ecc",0,0,FALSE,FALSE,FALSE,6.67,"young",42,187,77,"m"
1,"LEG CURL",1,"Ecc09",2380,2360,2200,2150,2370,2175,0.082,195,2272.5,"Ecc",20,50,FALSE,FALSE,FALSE,8.97,"young",42,187,77,"m"
1,"LEG CURL",1,"Ecc10",3060,3040,3050,3050,3050,3050,0,0,3050,"Ecc",20,0,FALSE,FALSE,FALSE,0,"young",42,187,77,"m"
1,"LEG CURL",2,"Ecc01",2860,2880,2900,2800,2870,2850,0.007,20,2860,"Ecc",-20,100,FALSE,FALSE,FALSE,0.7,"young",42,187,77,"m"
1,"LEG CURL",2,"Ecc02",3640,3640,3550,3500,3640,3525,0.032,115,3582.5,"Ecc",0,50,FALSE,FALSE,FALSE,3.26,"young",42,187,77,"m"
1,"LEG CURL",2,"Ecc03",3680,3660,3600,3600,3670,3600,0.019,70,3635,"Ecc",20,0,FALSE,FALSE,FALSE,1.94,"young",42,187,77,"m"
1,"LEG CURL",2,"Ecc04",3080,3100,3050,3100,3090,3075,0.005,15,3082.5,"Ecc",-20,-50,FALSE,FALSE,FALSE,0.49,"young",42,187,77,"m"
1,"LEG CURL",2,"Ecc05",3040,3000,2950,3000,3020,2975,0.015,45,2997.5,"Ecc",40,-50,FALSE,FALSE,FALSE,1.51,"young",42,187,77,"m"
1,"LEG CURL",2,"Ecc06",3240,3240,3100,3050,3240,3075,0.051,165,3157.5,"Ecc",0,50,FALSE,FALSE,FALSE,5.37,"young",42,187,77,"m"
1,"LEG CURL",2,"Ecc07",3040,3020,2900,2850,3030,2875,0.051,155,2952.5,"Ecc",20,50,FALSE,FALSE,FALSE,5.39,"young",42,187,77,"m"
1,"LEG CURL",2,"Ecc08",2840,2820,2650,2600,2830,2625,0.072,205,2727.5,"Ecc",20,50,FALSE,FALSE,FALSE,7.81,"young",42,187,77,"m"
1,"LEG CURL",2,"Ecc09",2540,2560,2400,2400,2550,2400,0.059,150,2475,"Ecc",-20,0,FALSE,FALSE,FALSE,6.25,"young",42,187,77,"m"
1,"LEG CURL",2,"Ecc10",2880,2900,2850,2900,2890,2875,0.005,15,2882.5,"Ecc",-20,-50,FALSE,FALSE,FALSE,0.52,"young",42,187,77,"m"
1,"LEG CURL",1,"Rep01",4160,4120,4250,4200,4140,4225,0.021,-85,4182.5,"Rep",40,50,FALSE,FALSE,FALSE,2.01,"young",42,187,77,"m"
1,"LEG CURL",1,"Rep02",4220,4240,4200,4200,4230,4200,0.007,30,4215,"Rep",-20,0,FALSE,FALSE,FALSE,0.71,"young",42,187,77,"m"
1,"LEG CURL",1,"Rep03",4300,4260,4250,4200,4280,4225,0.013,55,4252.5,"Rep",40,50,FALSE,FALSE,FALSE,1.3,"young",42,187,77,"m"
1,"LEG CURL",1,"Rep04",3780,3800,3800,3800,3790,3800,0.003,-10,3795,"Rep",-20,0,FALSE,FALSE,FALSE,0.26,"young",42,187,77,"m"
1,"LEG CURL",1,"Rep05",3540,3540,3500,3550,3540,3525,0.004,15,3532.5,"Rep",0,-50,FALSE,FALSE,FALSE,0.43,"young",42,187,77,"m"
1,"LEG CURL",1,"Rep06",3420,3400,3450,3450,3410,3450,0.012,-40,3430,"Rep",20,0,FALSE,FALSE,FALSE,1.16,"young",42,187,77,"m"
1,"LEG CURL",1,"Rep07",3560,3580,3500,3500,3570,3500,0.02,70,3535,"Rep",-20,0,FALSE,FALSE,FALSE,2,"young",42,187,77,"m"
1,"LEG CURL",1,"Rep08",3460,3480,3500,3500,3470,3500,0.009,-30,3485,"Rep",-20,0,FALSE,FALSE,FALSE,0.86,"young",42,187,77,"m"
1,"LEG CURL",1,"Rep09",3640,3620,3600,3550,3630,3575,0.015,55,3602.5,"Rep",20,50,FALSE,FALSE,FALSE,1.54,"young",42,187,77,"m"
1,"LEG CURL",1,"Rep10",4400,4400,4600,4650,4400,4625,0.051,-225,4512.5,"Rep",0,-50,TRUE,FALSE,FALSE,4.86,"young",42,187,77,"m"
1,"LEG CURL",2,"Rep01",4340,4340,4500,4300,4340,4400,0.014,-60,4370,"Rep",0,200,FALSE,FALSE,TRUE,1.36,"young",42,187,77,"m"
1,"LEG CURL",2,"Rep02",5060,5040,5000,5050,5050,5025,0.005,25,5037.5,"Rep",20,-50,FALSE,FALSE,FALSE,0.5,"young",42,187,77,"m"
1,"LEG CURL",2,"Rep03",5060,5040,5050,5100,5050,5075,0.005,-25,5062.5,"Rep",20,-50,FALSE,FALSE,FALSE,0.49,"young",42,187,77,"m"
1,"LEG CURL",2,"Rep04",4300,4340,4300,4300,4320,4300,0.005,20,4310,"Rep",-40,0,FALSE,FALSE,FALSE,0.47,"young",42,187,77,"m"
1,"LEG CURL",2,"Rep05",4360,4320,4350,4350,4340,4350,0.002,-10,4345,"Rep",40,0,FALSE,FALSE,FALSE,0.23,"young",42,187,77,"m"
1,"LEG CURL",2,"Rep06",4560,4600,4500,4450,4580,4475,0.023,105,4527.5,"Rep",-40,50,FALSE,FALSE,FALSE,2.35,"young",42,187,77,"m"
1,"LEG CURL",2,"Rep07",4280,4240,4300,4300,4260,4300,0.009,-40,4280,"Rep",40,0,FALSE,FALSE,FALSE,0.93,"young",42,187,77,"m"
1,"LEG CURL",2,"Rep08",4040,4040,4000,4000,4040,4000,0.01,40,4020,"Rep",0,0,FALSE,FALSE,FALSE,1,"young",42,187,77,"m"
1,"LEG CURL",2,"Rep09",3820,3840,3850,3900,3830,3875,0.012,-45,3852.5,"Rep",-20,-50,FALSE,FALSE,FALSE,1.16,"young",42,187,77,"m"
1,"LEG CURL",2,"Rep10",4180,4200,4300,4300,4190,4300,0.026,-110,4245,"Rep",-20,0,FALSE,FALSE,FALSE,2.56,"young",42,187,77,"m"
1,"LEG CURL",1,"TuT",38480,38440,38650,38600,38460,38625,0.004,-165,38542.5,"TuT",40,50,FALSE,TRUE,FALSE,0.43,"young",42,187,77,"m"
1,"LEG CURL",2,"TuT",44000,44000,44150,44050,44000,44100,0.002,-100,44050,"TuT",0,100,FALSE,FALSE,FALSE,0.23,"young",42,187,77,"m"
1,"ABDUCTOR",1,"Con01",1780,1720,2150,2400,1750,2275,0.3,-525,2012.5,"Con",60,-250,TRUE,TRUE,TRUE,23.08,"young",42,187,77,"m"
1,"ABDUCTOR",1,"Con02",1680,1680,1750,1800,1680,1775,0.057,-95,1727.5,"Con",0,-50,FALSE,FALSE,FALSE,5.35,"young",42,187,77,"m"
1,"ABDUCTOR",1,"Con03",1440,1420,1550,1400,1430,1475,0.031,-45,1452.5,"Con",20,150,FALSE,FALSE,FALSE,3.05,"young",42,187,77,"m"
1,"ABDUCTOR",1,"Con04",1320,1340,1350,1200,1330,1275,0.041,55,1302.5,"Con",-20,150,FALSE,FALSE,FALSE,4.31,"young",42,187,77,"m"
1,"ABDUCTOR",1,"Con05",1340,1340,1400,1350,1340,1375,0.026,-35,1357.5,"Con",0,50,FALSE,FALSE,FALSE,2.55,"young",42,187,77,"m"
1,"ABDUCTOR",1,"Con06",1420,1440,1400,1350,1430,1375,0.038,55,1402.5,"Con",-20,50,FALSE,FALSE,FALSE,4,"young",42,187,77,"m"
1,"ABDUCTOR",1,"Con07",1400,1440,1450,1500,1420,1475,0.039,-55,1447.5,"Con",-40,-50,FALSE,TRUE,FALSE,3.73,"young",42,187,77,"m"
1,"ABDUCTOR",1,"Con08",1300,1340,1450,1550,1320,1500,0.136,-180,1410,"Con",-40,-100,FALSE,TRUE,FALSE,12,"young",42,187,77,"m"
1,"ABDUCTOR",1,"Con09",1260,1280,1350,1500,1270,1425,0.122,-155,1347.5,"Con",-20,-150,FALSE,FALSE,FALSE,10.88,"young",42,187,77,"m"
1,"ABDUCTOR",1,"Con10",1560,1520,1550,1900,1540,1725,0.12,-185,1632.5,"Con",40,-350,FALSE,TRUE,TRUE,10.72,"young",42,187,77,"m"
1,"ABDUCTOR",2,"Con01",1440,1400,2300,1500,1420,1900,0.338,-480,1660,"Con",40,800,TRUE,TRUE,TRUE,25.26,"young",42,187,77,"m"
1,"ABDUCTOR",2,"Con02",1380,1380,1400,1400,1380,1400,0.014,-20,1390,"Con",0,0,FALSE,FALSE,FALSE,1.43,"young",42,187,77,"m"
1,"ABDUCTOR",2,"Con03",1360,1340,1400,1350,1350,1375,0.019,-25,1362.5,"Con",20,50,FALSE,FALSE,FALSE,1.82,"young",42,187,77,"m"
1,"ABDUCTOR",2,"Con04",1500,1540,1500,1500,1520,1500,0.013,20,1510,"Con",-40,0,FALSE,TRUE,FALSE,1.33,"young",42,187,77,"m"
1,"ABDUCTOR",2,"Con05",1340,1360,1400,1400,1350,1400,0.037,-50,1375,"Con",-20,0,FALSE,FALSE,FALSE,3.57,"young",42,187,77,"m"
1,"ABDUCTOR",2,"Con06",1360,1320,1450,1550,1340,1500,0.119,-160,1420,"Con",40,-100,FALSE,TRUE,FALSE,10.67,"young",42,187,77,"m"
1,"ABDUCTOR",2,"Con07",1440,1460,1550,1600,1450,1575,0.086,-125,1512.5,"Con",-20,-50,FALSE,FALSE,FALSE,7.94,"young",42,187,77,"m"
1,"ABDUCTOR",2,"Con08",1400,1420,1500,1500,1410,1500,0.064,-90,1455,"Con",-20,0,FALSE,FALSE,FALSE,6,"young",42,187,77,"m"
1,"ABDUCTOR",2,"Con09",1520,1540,1650,1700,1530,1675,0.095,-145,1602.5,"Con",-20,-50,FALSE,FALSE,FALSE,8.66,"young",42,187,77,"m"
1,"ABDUCTOR",2,"Con10",1640,1660,1700,1700,1650,1700,0.03,-50,1675,"Con",-20,0,FALSE,FALSE,FALSE,2.94,"young",42,187,77,"m"
1,"ABDUCTOR",1,"Ecc01",2160,2180,2150,2050,2170,2100,0.032,70,2135,"Ecc",-20,100,FALSE,FALSE,FALSE,3.33,"young",42,187,77,"m"
1,"ABDUCTOR",1,"Ecc02",2420,2420,2300,2350,2420,2325,0.039,95,2372.5,"Ecc",0,-50,FALSE,FALSE,FALSE,4.09,"young",42,187,77,"m"
1,"ABDUCTOR",1,"Ecc03",2180,2200,2100,2300,2190,2200,0.005,-10,2195,"Ecc",-20,-200,FALSE,FALSE,FALSE,0.45,"young",42,187,77,"m"
1,"ABDUCTOR",1,"Ecc04",2140,2120,2150,2200,2130,2175,0.021,-45,2152.5,"Ecc",20,-50,FALSE,FALSE,FALSE,2.07,"young",42,187,77,"m"
1,"ABDUCTOR",1,"Ecc05",2160,2160,2100,2200,2160,2150,0.005,10,2155,"Ecc",0,-100,FALSE,FALSE,FALSE,0.47,"young",42,187,77,"m"
1,"ABDUCTOR",1,"Ecc06",2120,2080,2100,2100,2100,2100,0,0,2100,"Ecc",40,0,FALSE,TRUE,FALSE,0,"young",42,187,77,"m"
1,"ABDUCTOR",1,"Ecc07",2000,1980,1950,1850,1990,1900,0.045,90,1945,"Ecc",20,100,FALSE,FALSE,FALSE,4.74,"young",42,187,77,"m"
1,"ABDUCTOR",1,"Ecc08",2160,2100,2000,1850,2130,1925,0.096,205,2027.5,"Ecc",60,150,FALSE,TRUE,FALSE,10.65,"young",42,187,77,"m"
1,"ABDUCTOR",1,"Ecc09",2080,2100,2050,1800,2090,1925,0.079,165,2007.5,"Ecc",-20,250,FALSE,FALSE,FALSE,8.57,"young",42,187,77,"m"
1,"ABDUCTOR",1,"Ecc10",2620,2660,2650,2550,2640,2600,0.015,40,2620,"Ecc",-40,100,FALSE,TRUE,FALSE,1.54,"young",42,187,77,"m"
1,"ABDUCTOR",2,"Ecc01",2160,2180,2150,2100,2170,2125,0.021,45,2147.5,"Ecc",-20,50,FALSE,FALSE,FALSE,2.12,"young",42,187,77,"m"
1,"ABDUCTOR",2,"Ecc02",1940,1940,1900,1950,1940,1925,0.008,15,1932.5,"Ecc",0,-50,FALSE,FALSE,FALSE,0.78,"young",42,187,77,"m"
1,"ABDUCTOR",2,"Ecc03",2000,2000,2000,2050,2000,2025,0.012,-25,2012.5,"Ecc",0,-50,FALSE,FALSE,FALSE,1.23,"young",42,187,77,"m"
1,"ABDUCTOR",2,"Ecc04",1980,1960,1900,1900,1970,1900,0.036,70,1935,"Ecc",20,0,FALSE,FALSE,FALSE,3.68,"young",42,187,77,"m"
1,"ABDUCTOR",2,"Ecc05",2220,2220,2150,2100,2220,2125,0.043,95,2172.5,"Ecc",0,50,FALSE,FALSE,FALSE,4.47,"young",42,187,77,"m"
1,"ABDUCTOR",2,"Ecc06",2200,2240,2100,2050,2220,2075,0.065,145,2147.5,"Ecc",-40,50,FALSE,TRUE,FALSE,6.99,"young",42,187,77,"m"
1,"ABDUCTOR",2,"Ecc07",2200,2160,2100,2050,2180,2075,0.048,105,2127.5,"Ecc",40,50,FALSE,TRUE,FALSE,5.06,"young",42,187,77,"m"
1,"ABDUCTOR",2,"Ecc08",1900,1880,1800,1750,1890,1775,0.061,115,1832.5,"Ecc",20,50,FALSE,FALSE,FALSE,6.48,"young",42,187,77,"m"
1,"ABDUCTOR",2,"Ecc09",2320,2300,2200,2200,2310,2200,0.048,110,2255,"Ecc",20,0,FALSE,FALSE,FALSE,5,"young",42,187,77,"m"
1,"ABDUCTOR",2,"Ecc10",2160,2160,2200,550,2160,1375,0.363,785,1767.5,"Ecc",0,1650,TRUE,FALSE,TRUE,57.09,"young",42,187,77,"m"
1,"ABDUCTOR",1,"Rep01",3940,3900,4300,4450,3920,4375,0.116,-455,4147.5,"Rep",40,-150,TRUE,FALSE,FALSE,10.4,"young",42,187,77,"m"
1,"ABDUCTOR",1,"Rep02",4100,4100,4050,4150,4100,4100,0,0,4100,"Rep",0,-100,FALSE,FALSE,FALSE,0,"young",42,187,77,"m"
1,"ABDUCTOR",1,"Rep03",3620,3620,3650,3700,3620,3675,0.015,-55,3647.5,"Rep",0,-50,FALSE,FALSE,FALSE,1.5,"young",42,187,77,"m"
1,"ABDUCTOR",1,"Rep04",3460,3460,3500,3400,3460,3450,0.003,10,3455,"Rep",0,100,FALSE,FALSE,FALSE,0.29,"young",42,187,77,"m"
1,"ABDUCTOR",1,"Rep05",3500,3500,3500,3550,3500,3525,0.007,-25,3512.5,"Rep",0,-50,FALSE,FALSE,FALSE,0.71,"young",42,187,77,"m"
1,"ABDUCTOR",1,"Rep06",3540,3520,3500,3450,3530,3475,0.016,55,3502.5,"Rep",20,50,FALSE,FALSE,FALSE,1.58,"young",42,187,77,"m"
1,"ABDUCTOR",1,"Rep07",3400,3420,3400,3350,3410,3375,0.01,35,3392.5,"Rep",-20,50,FALSE,FALSE,FALSE,1.04,"young",42,187,77,"m"
1,"ABDUCTOR",1,"Rep08",3460,3440,3450,3400,3450,3425,0.007,25,3437.5,"Rep",20,50,FALSE,FALSE,FALSE,0.73,"young",42,187,77,"m"
1,"ABDUCTOR",1,"Rep09",3340,3380,3400,3300,3360,3350,0.003,10,3355,"Rep",-40,100,FALSE,FALSE,FALSE,0.3,"young",42,187,77,"m"
1,"ABDUCTOR",1,"Rep10",4180,4180,4200,4450,4180,4325,0.035,-145,4252.5,"Rep",0,-250,FALSE,FALSE,FALSE,3.35,"young",42,187,77,"m"
1,"ABDUCTOR",2,"Rep01",3600,3580,4450,3600,3590,4025,0.121,-435,3807.5,"Rep",20,850,TRUE,FALSE,TRUE,10.81,"young",42,187,77,"m"
1,"ABDUCTOR",2,"Rep02",3320,3320,3300,3350,3320,3325,0.002,-5,3322.5,"Rep",0,-50,FALSE,FALSE,FALSE,0.15,"young",42,187,77,"m"
1,"ABDUCTOR",2,"Rep03",3360,3340,3400,3400,3350,3400,0.015,-50,3375,"Rep",20,0,FALSE,FALSE,FALSE,1.47,"young",42,187,77,"m"
1,"ABDUCTOR",2,"Rep04",3480,3500,3400,3400,3490,3400,0.026,90,3445,"Rep",-20,0,FALSE,FALSE,FALSE,2.65,"young",42,187,77,"m"
1,"ABDUCTOR",2,"Rep05",3560,3580,3550,3500,3570,3525,0.013,45,3547.5,"Rep",-20,50,FALSE,FALSE,FALSE,1.28,"young",42,187,77,"m"
1,"ABDUCTOR",2,"Rep06",3560,3560,3550,3600,3560,3575,0.004,-15,3567.5,"Rep",0,-50,FALSE,FALSE,FALSE,0.42,"young",42,187,77,"m"
1,"ABDUCTOR",2,"Rep07",3640,3620,3650,3650,3630,3650,0.006,-20,3640,"Rep",20,0,FALSE,FALSE,FALSE,0.55,"young",42,187,77,"m"
1,"ABDUCTOR",2,"Rep08",3300,3300,3300,3250,3300,3275,0.008,25,3287.5,"Rep",0,50,FALSE,FALSE,FALSE,0.76,"young",42,187,77,"m"
1,"ABDUCTOR",2,"Rep09",3840,3840,3850,3900,3840,3875,0.009,-35,3857.5,"Rep",0,-50,FALSE,FALSE,FALSE,0.9,"young",42,187,77,"m"
1,"ABDUCTOR",2,"Rep10",3800,3820,3900,2250,3810,3075,0.193,735,3442.5,"Rep",-20,1650,TRUE,FALSE,TRUE,23.9,"young",42,187,77,"m"
1,"ABDUCTOR",1,"TuT",36540,36520,36950,37200,36530,37075,0.015,-545,36802.5,"TuT",20,-250,TRUE,FALSE,FALSE,1.47,"young",42,187,77,"m"
1,"ABDUCTOR",2,"TuT",35460,35460,36350,33900,35460,35125,0.009,335,35292.5,"TuT",0,2450,FALSE,FALSE,TRUE,0.95,"young",42,187,77,"m"
1,"ADDUCTOR",1,"Con01",880,880,1050,1000,880,1025,0.165,-145,952.5,"Con",0,50,FALSE,FALSE,FALSE,14.15,"young",42,187,77,"m"
1,"ADDUCTOR",1,"Con02",1000,1000,1100,1200,1000,1150,0.15,-150,1075,"Con",0,-100,FALSE,FALSE,FALSE,13.04,"young",42,187,77,"m"
1,"ADDUCTOR",1,"Con03",1240,1260,1250,1400,1250,1325,0.06,-75,1287.5,"Con",-20,-150,FALSE,FALSE,FALSE,5.66,"young",42,187,77,"m"
1,"ADDUCTOR",1,"Con04",1060,1080,1000,1050,1070,1025,0.042,45,1047.5,"Con",-20,-50,FALSE,FALSE,FALSE,4.39,"young",42,187,77,"m"
1,"ADDUCTOR",1,"Con05",1080,1100,1200,1100,1090,1150,0.055,-60,1120,"Con",-20,100,FALSE,FALSE,FALSE,5.22,"young",42,187,77,"m"
1,"ADDUCTOR",1,"Con06",1040,1060,1100,1050,1050,1075,0.024,-25,1062.5,"Con",-20,50,FALSE,FALSE,FALSE,2.33,"young",42,187,77,"m"
1,"ADDUCTOR",1,"Con07",980,980,1100,1000,980,1050,0.071,-70,1015,"Con",0,100,FALSE,FALSE,FALSE,6.67,"young",42,187,77,"m"
1,"ADDUCTOR",1,"Con08",1040,1060,1300,1250,1050,1275,0.214,-225,1162.5,"Con",-20,50,FALSE,FALSE,FALSE,17.65,"young",42,187,77,"m"
1,"ADDUCTOR",1,"Con09",1060,1080,1200,1250,1070,1225,0.145,-155,1147.5,"Con",-20,-50,FALSE,FALSE,FALSE,12.65,"young",42,187,77,"m"
1,"ADDUCTOR",1,"Con10",1140,1140,1200,1250,1140,1225,0.075,-85,1182.5,"Con",0,-50,FALSE,FALSE,FALSE,6.94,"young",42,187,77,"m"
1,"ADDUCTOR",2,"Con01",1040,1060,1150,1150,1050,1150,0.095,-100,1100,"Con",-20,0,FALSE,FALSE,FALSE,8.7,"young",42,187,77,"m"
1,"ADDUCTOR",2,"Con02",900,920,1050,1050,910,1050,0.154,-140,980,"Con",-20,0,FALSE,FALSE,FALSE,13.33,"young",42,187,77,"m"
1,"ADDUCTOR",2,"Con03",1180,1220,1200,1250,1200,1225,0.021,-25,1212.5,"Con",-40,-50,FALSE,TRUE,FALSE,2.04,"young",42,187,77,"m"
1,"ADDUCTOR",2,"Con04",1040,1020,1050,1150,1030,1100,0.068,-70,1065,"Con",20,-100,FALSE,FALSE,FALSE,6.36,"young",42,187,77,"m"
1,"ADDUCTOR",2,"Con05",1080,1060,1150,1200,1070,1175,0.098,-105,1122.5,"Con",20,-50,FALSE,FALSE,FALSE,8.94,"young",42,187,77,"m"
1,"ADDUCTOR",2,"Con06",980,980,950,1050,980,1000,0.02,-20,990,"Con",0,-100,FALSE,FALSE,FALSE,2,"young",42,187,77,"m"
1,"ADDUCTOR",2,"Con07",1060,1040,1100,1100,1050,1100,0.048,-50,1075,"Con",20,0,FALSE,FALSE,FALSE,4.55,"young",42,187,77,"m"
1,"ADDUCTOR",2,"Con08",1040,1060,1200,1250,1050,1225,0.167,-175,1137.5,"Con",-20,-50,FALSE,FALSE,FALSE,14.29,"young",42,187,77,"m"
1,"ADDUCTOR",2,"Con09",1040,1000,1350,1150,1020,1250,0.225,-230,1135,"Con",40,200,FALSE,TRUE,FALSE,18.4,"young",42,187,77,"m"
1,"ADDUCTOR",2,"Con10",1240,1260,1800,1500,1250,1650,0.32,-400,1450,"Con",-20,300,FALSE,FALSE,FALSE,24.24,"young",42,187,77,"m"
1,"ADDUCTOR",1,"Ecc01",1240,1240,1200,1150,1240,1175,0.052,65,1207.5,"Ecc",0,50,FALSE,FALSE,FALSE,5.53,"young",42,187,77,"m"
1,"ADDUCTOR",1,"Ecc02",1360,1360,1300,1150,1360,1225,0.099,135,1292.5,"Ecc",0,150,FALSE,FALSE,FALSE,11.02,"young",42,187,77,"m"
1,"ADDUCTOR",1,"Ecc03",1580,1560,1600,1500,1570,1550,0.013,20,1560,"Ecc",20,100,FALSE,FALSE,FALSE,1.29,"young",42,187,77,"m"
1,"ADDUCTOR",1,"Ecc04",1580,1560,1550,1600,1570,1575,0.003,-5,1572.5,"Ecc",20,-50,FALSE,FALSE,FALSE,0.32,"young",42,187,77,"m"
1,"ADDUCTOR",1,"Ecc05",1600,1580,1500,1550,1590,1525,0.041,65,1557.5,"Ecc",20,-50,FALSE,FALSE,FALSE,4.26,"young",42,187,77,"m"
1,"ADDUCTOR",1,"Ecc06",1640,1640,1600,1650,1640,1625,0.009,15,1632.5,"Ecc",0,-50,FALSE,FALSE,FALSE,0.92,"young",42,187,77,"m"
1,"ADDUCTOR",1,"Ecc07",1660,1640,1400,1550,1650,1475,0.106,175,1562.5,"Ecc",20,-150,FALSE,FALSE,FALSE,11.86,"young",42,187,77,"m"
1,"ADDUCTOR",1,"Ecc08",1540,1520,1350,1350,1530,1350,0.118,180,1440,"Ecc",20,0,FALSE,FALSE,FALSE,13.33,"young",42,187,77,"m"
1,"ADDUCTOR",1,"Ecc09",1460,1460,1450,1350,1460,1400,0.041,60,1430,"Ecc",0,100,FALSE,FALSE,FALSE,4.29,"young",42,187,77,"m"
1,"ADDUCTOR",1,"Ecc10",2140,2120,2050,2050,2130,2050,0.038,80,2090,"Ecc",20,0,FALSE,FALSE,FALSE,3.9,"young",42,187,77,"m"
1,"ADDUCTOR",2,"Ecc01",1260,1240,1200,1200,1250,1200,0.04,50,1225,"Ecc",20,0,FALSE,FALSE,FALSE,4.17,"young",42,187,77,"m"
1,"ADDUCTOR",2,"Ecc02",1400,1360,1250,1250,1380,1250,0.094,130,1315,"Ecc",40,0,FALSE,TRUE,FALSE,10.4,"young",42,187,77,"m"
1,"ADDUCTOR",2,"Ecc03",1580,1580,1600,1500,1580,1550,0.019,30,1565,"Ecc",0,100,FALSE,FALSE,FALSE,1.94,"young",42,187,77,"m"
1,"ADDUCTOR",2,"Ecc04",1560,1580,1500,1450,1570,1475,0.061,95,1522.5,"Ecc",-20,50,FALSE,FALSE,FALSE,6.44,"young",42,187,77,"m"
1,"ADDUCTOR",2,"Ecc05",1480,1500,1450,1350,1490,1400,0.06,90,1445,"Ecc",-20,100,FALSE,FALSE,FALSE,6.43,"young",42,187,77,"m"
1,"ADDUCTOR",2,"Ecc06",1360,1360,1400,1400,1360,1400,0.029,-40,1380,"Ecc",0,0,FALSE,FALSE,FALSE,2.86,"young",42,187,77,"m"
1,"ADDUCTOR",2,"Ecc07",1420,1400,1300,1200,1410,1250,0.113,160,1330,"Ecc",20,100,FALSE,FALSE,FALSE,12.8,"young",42,187,77,"m"
1,"ADDUCTOR",2,"Ecc08",1420,1440,1200,1300,1430,1250,0.126,180,1340,"Ecc",-20,-100,FALSE,FALSE,FALSE,14.4,"young",42,187,77,"m"
1,"ADDUCTOR",2,"Ecc09",1420,1400,1050,1250,1410,1150,0.184,260,1280,"Ecc",20,-200,FALSE,FALSE,FALSE,22.61,"young",42,187,77,"m"
1,"ADDUCTOR",2,"Ecc10",1680,1720,1350,1550,1700,1450,0.147,250,1575,"Ecc",-40,-200,FALSE,TRUE,FALSE,17.24,"young",42,187,77,"m"
1,"ADDUCTOR",1,"Rep01",2120,2120,2250,2150,2120,2200,0.038,-80,2160,"Rep",0,100,FALSE,FALSE,FALSE,3.64,"young",42,187,77,"m"
1,"ADDUCTOR",1,"Rep02",2360,2360,2400,2350,2360,2375,0.006,-15,2367.5,"Rep",0,50,FALSE,FALSE,FALSE,0.63,"young",42,187,77,"m"
1,"ADDUCTOR",1,"Rep03",2820,2820,2850,2900,2820,2875,0.02,-55,2847.5,"Rep",0,-50,FALSE,FALSE,FALSE,1.91,"young",42,187,77,"m"
1,"ADDUCTOR",1,"Rep04",2640,2640,2550,2650,2640,2600,0.015,40,2620,"Rep",0,-100,FALSE,FALSE,FALSE,1.54,"young",42,187,77,"m"
1,"ADDUCTOR",1,"Rep05",2680,2680,2700,2650,2680,2675,0.002,5,2677.5,"Rep",0,50,FALSE,FALSE,FALSE,0.19,"young",42,187,77,"m"
1,"ADDUCTOR",1,"Rep06",2680,2700,2700,2700,2690,2700,0.004,-10,2695,"Rep",-20,0,FALSE,FALSE,FALSE,0.37,"young",42,187,77,"m"
1,"ADDUCTOR",1,"Rep07",2640,2620,2500,2550,2630,2525,0.04,105,2577.5,"Rep",20,-50,FALSE,FALSE,FALSE,4.16,"young",42,187,77,"m"
1,"ADDUCTOR",1,"Rep08",2580,2580,2650,2600,2580,2625,0.017,-45,2602.5,"Rep",0,50,FALSE,FALSE,FALSE,1.71,"young",42,187,77,"m"
1,"ADDUCTOR",1,"Rep09",2520,2540,2650,2600,2530,2625,0.038,-95,2577.5,"Rep",-20,50,FALSE,FALSE,FALSE,3.62,"young",42,187,77,"m"
1,"ADDUCTOR",1,"Rep10",3280,3260,3250,3300,3270,3275,0.002,-5,3272.5,"Rep",20,-50,FALSE,FALSE,FALSE,0.15,"young",42,187,77,"m"
1,"ADDUCTOR",2,"Rep01",2300,2300,2350,2350,2300,2350,0.022,-50,2325,"Rep",0,0,FALSE,FALSE,FALSE,2.13,"young",42,187,77,"m"
1,"ADDUCTOR",2,"Rep02",2300,2280,2300,2300,2290,2300,0.004,-10,2295,"Rep",20,0,FALSE,FALSE,FALSE,0.43,"young",42,187,77,"m"
1,"ADDUCTOR",2,"Rep03",2760,2800,2800,2750,2780,2775,0.002,5,2777.5,"Rep",-40,50,FALSE,FALSE,FALSE,0.18,"young",42,187,77,"m"
1,"ADDUCTOR",2,"Rep04",2600,2600,2550,2600,2600,2575,0.01,25,2587.5,"Rep",0,-50,FALSE,FALSE,FALSE,0.97,"young",42,187,77,"m"
1,"ADDUCTOR",2,"Rep05",2560,2560,2600,2550,2560,2575,0.006,-15,2567.5,"Rep",0,50,FALSE,FALSE,FALSE,0.58,"young",42,187,77,"m"
1,"ADDUCTOR",2,"Rep06",2340,2340,2350,2450,2340,2400,0.026,-60,2370,"Rep",0,-100,FALSE,FALSE,FALSE,2.5,"young",42,187,77,"m"
1,"ADDUCTOR",2,"Rep07",2480,2440,2400,2300,2460,2350,0.045,110,2405,"Rep",40,100,FALSE,FALSE,FALSE,4.68,"young",42,187,77,"m"
1,"ADDUCTOR",2,"Rep08",2460,2500,2400,2550,2480,2475,0.002,5,2477.5,"Rep",-40,-150,FALSE,FALSE,FALSE,0.2,"young",42,187,77,"m"
1,"ADDUCTOR",2,"Rep09",2460,2400,2400,2400,2430,2400,0.012,30,2415,"Rep",60,0,FALSE,FALSE,FALSE,1.25,"young",42,187,77,"m"
1,"ADDUCTOR",2,"Rep10",2920,2980,3150,3050,2950,3100,0.051,-150,3025,"Rep",-60,100,FALSE,FALSE,FALSE,4.84,"young",42,187,77,"m"
1,"ADDUCTOR",1,"TuT",26320,26320,26500,26450,26320,26475,0.006,-155,26397.5,"TuT",0,50,FALSE,FALSE,FALSE,0.59,"young",42,187,77,"m"
1,"ADDUCTOR",2,"TuT",25180,25200,25300,25300,25190,25300,0.004,-110,25245,"TuT",-20,0,FALSE,FALSE,FALSE,0.43,"young",42,187,77,"m"
1,"LOWER BACK",1,"Con01",1800,1800,1850,1850,1800,1850,0.028,-50,1825,"Con",0,0,FALSE,FALSE,FALSE,2.7,"young",42,187,77,"m"
1,"LOWER BACK",1,"Con02",1840,1820,1900,1900,1830,1900,0.038,-70,1865,"Con",20,0,FALSE,FALSE,FALSE,3.68,"young",42,187,77,"m"
1,"LOWER BACK",1,"Con03",1920,1920,2000,1900,1920,1950,0.016,-30,1935,"Con",0,100,FALSE,FALSE,FALSE,1.54,"young",42,187,77,"m"
1,"LOWER BACK",1,"Con04",1820,1840,1900,1850,1830,1875,0.025,-45,1852.5,"Con",-20,50,FALSE,FALSE,FALSE,2.4,"young",42,187,77,"m"
1,"LOWER BACK",1,"Con05",1820,1820,1850,1850,1820,1850,0.016,-30,1835,"Con",0,0,FALSE,FALSE,FALSE,1.62,"young",42,187,77,"m"
1,"LOWER BACK",1,"Con06",1780,1800,1850,1850,1790,1850,0.034,-60,1820,"Con",-20,0,FALSE,FALSE,FALSE,3.24,"young",42,187,77,"m"
1,"LOWER BACK",1,"Con07",1800,1820,1850,1900,1810,1875,0.036,-65,1842.5,"Con",-20,-50,FALSE,FALSE,FALSE,3.47,"young",42,187,77,"m"
1,"LOWER BACK",1,"Con08",1700,1680,1800,1750,1690,1775,0.05,-85,1732.5,"Con",20,50,FALSE,FALSE,FALSE,4.79,"young",42,187,77,"m"
1,"LOWER BACK",1,"Con09",1880,1900,2000,2000,1890,2000,0.058,-110,1945,"Con",-20,0,FALSE,FALSE,FALSE,5.5,"young",42,187,77,"m"
1,"LOWER BACK",1,"Con10",2000,1960,2150,2150,1980,2150,0.086,-170,2065,"Con",40,0,FALSE,TRUE,FALSE,7.91,"young",42,187,77,"m"
1,"LOWER BACK",2,"Con01",1620,1640,1750,1750,1630,1750,0.074,-120,1690,"Con",-20,0,FALSE,FALSE,FALSE,6.86,"young",42,187,77,"m"
1,"LOWER BACK",2,"Con02",1640,1620,1650,1650,1630,1650,0.012,-20,1640,"Con",20,0,FALSE,FALSE,FALSE,1.21,"young",42,187,77,"m"
1,"LOWER BACK",2,"Con03",1760,1780,1800,1800,1770,1800,0.017,-30,1785,"Con",-20,0,FALSE,FALSE,FALSE,1.67,"young",42,187,77,"m"
1,"LOWER BACK",2,"Con04",1760,1760,1700,1700,1760,1700,0.034,60,1730,"Con",0,0,FALSE,FALSE,FALSE,3.53,"young",42,187,77,"m"
1,"LOWER BACK",2,"Con05",1720,1740,1750,1750,1730,1750,0.012,-20,1740,"Con",-20,0,FALSE,FALSE,FALSE,1.14,"young",42,187,77,"m"
1,"LOWER BACK",2,"Con06",1680,1680,1650,1700,1680,1675,0.003,5,1677.5,"Con",0,-50,FALSE,FALSE,FALSE,0.3,"young",42,187,77,"m"
1,"LOWER BACK",2,"Con07",1680,1680,1750,1750,1680,1750,0.042,-70,1715,"Con",0,0,FALSE,FALSE,FALSE,4,"young",42,187,77,"m"
1,"LOWER BACK",2,"Con08",1700,1700,1800,1800,1700,1800,0.059,-100,1750,"Con",0,0,FALSE,FALSE,FALSE,5.56,"young",42,187,77,"m"
1,"LOWER BACK",2,"Con09",1600,1580,1750,1750,1590,1750,0.101,-160,1670,"Con",20,0,FALSE,FALSE,FALSE,9.14,"young",42,187,77,"m"
1,"LOWER BACK",2,"Con10",1720,1720,1850,1850,1720,1850,0.076,-130,1785,"Con",0,0,FALSE,FALSE,FALSE,7.03,"young",42,187,77,"m"
1,"LOWER BACK",1,"Ecc01",2600,2600,2550,2550,2600,2550,0.019,50,2575,"Ecc",0,0,FALSE,FALSE,FALSE,1.96,"young",42,187,77,"m"
1,"LOWER BACK",1,"Ecc02",3120,3140,3050,3100,3130,3075,0.018,55,3102.5,"Ecc",-20,-50,FALSE,FALSE,FALSE,1.79,"young",42,187,77,"m"
1,"LOWER BACK",1,"Ecc03",2760,2760,2700,2750,2760,2725,0.013,35,2742.5,"Ecc",0,-50,FALSE,FALSE,FALSE,1.28,"young",42,187,77,"m"
1,"LOWER BACK",1,"Ecc04",2860,2840,2800,2850,2850,2825,0.009,25,2837.5,"Ecc",20,-50,FALSE,FALSE,FALSE,0.88,"young",42,187,77,"m"
1,"LOWER BACK",1,"Ecc05",2820,2820,2750,2750,2820,2750,0.025,70,2785,"Ecc",0,0,FALSE,FALSE,FALSE,2.55,"young",42,187,77,"m"
1,"LOWER BACK",1,"Ecc06",2600,2560,2550,2500,2580,2525,0.021,55,2552.5,"Ecc",40,50,FALSE,FALSE,FALSE,2.18,"young",42,187,77,"m"
1,"LOWER BACK",1,"Ecc07",2540,2540,2450,2500,2540,2475,0.026,65,2507.5,"Ecc",0,-50,FALSE,FALSE,FALSE,2.63,"young",42,187,77,"m"
1,"LOWER BACK",1,"Ecc08",2340,2360,2250,2250,2350,2250,0.043,100,2300,"Ecc",-20,0,FALSE,FALSE,FALSE,4.44,"young",42,187,77,"m"
1,"LOWER BACK",1,"Ecc09",2500,2500,2350,2350,2500,2350,0.06,150,2425,"Ecc",0,0,FALSE,FALSE,FALSE,6.38,"young",42,187,77,"m"
1,"LOWER BACK",1,"Ecc10",2380,2400,2400,2400,2390,2400,0.004,-10,2395,"Ecc",-20,0,FALSE,FALSE,FALSE,0.42,"young",42,187,77,"m"
1,"LOWER BACK",2,"Ecc01",2420,2400,2350,2400,2410,2375,0.015,35,2392.5,"Ecc",20,-50,FALSE,FALSE,FALSE,1.47,"young",42,187,77,"m"
1,"LOWER BACK",2,"Ecc02",2500,2500,2450,2450,2500,2450,0.02,50,2475,"Ecc",0,0,FALSE,FALSE,FALSE,2.04,"young",42,187,77,"m"
1,"LOWER BACK",2,"Ecc03",2560,2560,2600,2600,2560,2600,0.016,-40,2580,"Ecc",0,0,FALSE,FALSE,FALSE,1.54,"young",42,187,77,"m"
1,"LOWER BACK",2,"Ecc04",2220,2220,2250,2250,2220,2250,0.014,-30,2235,"Ecc",0,0,FALSE,FALSE,FALSE,1.33,"young",42,187,77,"m"
1,"LOWER BACK",2,"Ecc05",2340,2320,2350,2300,2330,2325,0.002,5,2327.5,"Ecc",20,50,FALSE,FALSE,FALSE,0.22,"young",42,187,77,"m"
1,"LOWER BACK",2,"Ecc06",2300,2300,2250,2250,2300,2250,0.022,50,2275,"Ecc",0,0,FALSE,FALSE,FALSE,2.22,"young",42,187,77,"m"
1,"LOWER BACK",2,"Ecc07",2240,2240,2200,2200,2240,2200,0.018,40,2220,"Ecc",0,0,FALSE,FALSE,FALSE,1.82,"young",42,187,77,"m"
1,"LOWER BACK",2,"Ecc08",2320,2320,2150,2150,2320,2150,0.073,170,2235,"Ecc",0,0,FALSE,FALSE,FALSE,7.91,"young",42,187,77,"m"
1,"LOWER BACK",2,"Ecc09",2140,2160,2000,2000,2150,2000,0.07,150,2075,"Ecc",-20,0,FALSE,FALSE,FALSE,7.5,"young",42,187,77,"m"
1,"LOWER BACK",2,"Ecc10",2140,2180,2200,2200,2160,2200,0.019,-40,2180,"Ecc",-40,0,FALSE,FALSE,FALSE,1.82,"young",42,187,77,"m"
1,"LOWER BACK",1,"Rep01",4400,4400,4400,4400,4400,4400,0,0,4400,"Rep",0,0,FALSE,FALSE,FALSE,0,"young",42,187,77,"m"
1,"LOWER BACK",1,"Rep02",4960,4960,4950,5000,4960,4975,0.003,-15,4967.5,"Rep",0,-50,FALSE,FALSE,FALSE,0.3,"young",42,187,77,"m"
1,"LOWER BACK",1,"Rep03",4680,4680,4700,4650,4680,4675,0.001,5,4677.5,"Rep",0,50,FALSE,FALSE,FALSE,0.11,"young",42,187,77,"m"
1,"LOWER BACK",1,"Rep04",4680,4680,4700,4700,4680,4700,0.004,-20,4690,"Rep",0,0,FALSE,FALSE,FALSE,0.43,"young",42,187,77,"m"
1,"LOWER BACK",1,"Rep05",4640,4640,4600,4600,4640,4600,0.009,40,4620,"Rep",0,0,FALSE,FALSE,FALSE,0.87,"young",42,187,77,"m"
1,"LOWER BACK",1,"Rep06",4380,4360,4400,4350,4370,4375,0.001,-5,4372.5,"Rep",20,50,FALSE,FALSE,FALSE,0.11,"young",42,187,77,"m"
1,"LOWER BACK",1,"Rep07",4340,4360,4300,4400,4350,4350,0,0,4350,"Rep",-20,-100,FALSE,FALSE,FALSE,0,"young",42,187,77,"m"
1,"LOWER BACK",1,"Rep08",4040,4040,4050,4000,4040,4025,0.004,15,4032.5,"Rep",0,50,FALSE,FALSE,FALSE,0.37,"young",42,187,77,"m"
1,"LOWER BACK",1,"Rep09",4380,4400,4350,4350,4390,4350,0.009,40,4370,"Rep",-20,0,FALSE,FALSE,FALSE,0.92,"young",42,187,77,"m"
1,"LOWER BACK",1,"Rep10",4380,4360,4550,4550,4370,4550,0.041,-180,4460,"Rep",20,0,TRUE,FALSE,FALSE,3.96,"young",42,187,77,"m"
1,"LOWER BACK",2,"Rep01",4040,4040,4100,4150,4040,4125,0.021,-85,4082.5,"Rep",0,-50,FALSE,FALSE,FALSE,2.06,"young",42,187,77,"m"
1,"LOWER BACK",2,"Rep02",4140,4120,4100,4100,4130,4100,0.007,30,4115,"Rep",20,0,FALSE,FALSE,FALSE,0.73,"young",42,187,77,"m"
1,"LOWER BACK",2,"Rep03",4320,4340,4400,4400,4330,4400,0.016,-70,4365,"Rep",-20,0,FALSE,FALSE,FALSE,1.59,"young",42,187,77,"m"
1,"LOWER BACK",2,"Rep04",3980,3980,3950,3950,3980,3950,0.008,30,3965,"Rep",0,0,FALSE,FALSE,FALSE,0.76,"young",42,187,77,"m"
1,"LOWER BACK",2,"Rep05",4060,4060,4100,4050,4060,4075,0.004,-15,4067.5,"Rep",0,50,FALSE,FALSE,FALSE,0.37,"young",42,187,77,"m"
1,"LOWER BACK",2,"Rep06",3980,3980,3900,3950,3980,3925,0.014,55,3952.5,"Rep",0,-50,FALSE,FALSE,FALSE,1.4,"young",42,187,77,"m"
1,"LOWER BACK",2,"Rep07",3920,3920,3950,3950,3920,3950,0.008,-30,3935,"Rep",0,0,FALSE,FALSE,FALSE,0.76,"young",42,187,77,"m"
1,"LOWER BACK",2,"Rep08",4020,4020,3950,3950,4020,3950,0.017,70,3985,"Rep",0,0,FALSE,FALSE,FALSE,1.77,"young",42,187,77,"m"
1,"LOWER BACK",2,"Rep09",3740,3740,3750,3750,3740,3750,0.003,-10,3745,"Rep",0,0,FALSE,FALSE,FALSE,0.27,"young",42,187,77,"m"
1,"LOWER BACK",2,"Rep10",3860,3900,4050,4050,3880,4050,0.044,-170,3965,"Rep",-40,0,TRUE,FALSE,FALSE,4.2,"young",42,187,77,"m"
1,"LOWER BACK",1,"TuT",44880,44880,45000,45000,44880,45000,0.003,-120,44940,"TuT",0,0,FALSE,FALSE,FALSE,0.27,"young",42,187,77,"m"
1,"LOWER BACK",2,"TuT",40060,40100,40250,40300,40080,40275,0.005,-195,40177.5,"TuT",-40,-50,FALSE,FALSE,FALSE,0.48,"young",42,187,77,"m"
1,"TOTAL ABDOMINAL",1,"Con01",1500,1500,1550,1700,1500,1625,0.083,-125,1562.5,"Con",0,-150,FALSE,FALSE,FALSE,7.69,"young",42,187,77,"m"
1,"TOTAL ABDOMINAL",1,"Con02",1520,1520,1550,1600,1520,1575,0.036,-55,1547.5,"Con",0,-50,FALSE,FALSE,FALSE,3.49,"young",42,187,77,"m"
1,"TOTAL ABDOMINAL",1,"Con03",1500,1520,1550,1500,1510,1525,0.01,-15,1517.5,"Con",-20,50,FALSE,FALSE,FALSE,0.98,"young",42,187,77,"m"
1,"TOTAL ABDOMINAL",1,"Con04",1540,1500,1550,1550,1520,1550,0.02,-30,1535,"Con",40,0,FALSE,TRUE,FALSE,1.94,"young",42,187,77,"m"
1,"TOTAL ABDOMINAL",1,"Con05",1500,1500,1600,1550,1500,1575,0.05,-75,1537.5,"Con",0,50,FALSE,FALSE,FALSE,4.76,"young",42,187,77,"m"
1,"TOTAL ABDOMINAL",1,"Con06",1520,1520,1650,1600,1520,1625,0.069,-105,1572.5,"Con",0,50,FALSE,FALSE,FALSE,6.46,"young",42,187,77,"m"
1,"TOTAL ABDOMINAL",1,"Con07",1440,1420,1550,1500,1430,1525,0.066,-95,1477.5,"Con",20,50,FALSE,FALSE,FALSE,6.23,"young",42,187,77,"m"
1,"TOTAL ABDOMINAL",1,"Con08",1460,1480,1550,1550,1470,1550,0.054,-80,1510,"Con",-20,0,FALSE,FALSE,FALSE,5.16,"young",42,187,77,"m"
1,"TOTAL ABDOMINAL",1,"Con09",1480,1500,1600,1650,1490,1625,0.091,-135,1557.5,"Con",-20,-50,FALSE,FALSE,FALSE,8.31,"young",42,187,77,"m"
1,"TOTAL ABDOMINAL",1,"Con10",1460,1480,1700,1850,1470,1775,0.207,-305,1622.5,"Con",-20,-150,TRUE,FALSE,FALSE,17.18,"young",42,187,77,"m"
1,"TOTAL ABDOMINAL",2,"Con01",1220,1240,1500,1400,1230,1450,0.179,-220,1340,"Con",-20,100,TRUE,FALSE,FALSE,15.17,"young",42,187,77,"m"
1,"TOTAL ABDOMINAL",2,"Con02",1340,1360,1350,1500,1350,1425,0.056,-75,1387.5,"Con",-20,-150,FALSE,FALSE,FALSE,5.26,"young",42,187,77,"m"
1,"TOTAL ABDOMINAL",2,"Con03",1420,1460,1400,1500,1440,1450,0.007,-10,1445,"Con",-40,-100,FALSE,TRUE,FALSE,0.69,"young",42,187,77,"m"
1,"TOTAL ABDOMINAL",2,"Con04",1420,1440,1400,1450,1430,1425,0.003,5,1427.5,"Con",-20,-50,FALSE,FALSE,FALSE,0.35,"young",42,187,77,"m"
1,"TOTAL ABDOMINAL",2,"Con05",1460,1480,1500,1500,1470,1500,0.02,-30,1485,"Con",-20,0,FALSE,FALSE,FALSE,2,"young",42,187,77,"m"
1,"TOTAL ABDOMINAL",2,"Con06",1560,1560,1650,1600,1560,1625,0.042,-65,1592.5,"Con",0,50,FALSE,FALSE,FALSE,4,"young",42,187,77,"m"
1,"TOTAL ABDOMINAL",2,"Con07",1380,1400,1550,1450,1390,1500,0.079,-110,1445,"Con",-20,100,FALSE,FALSE,FALSE,7.33,"young",42,187,77,"m"
1,"TOTAL ABDOMINAL",2,"Con08",1460,1440,1600,1550,1450,1575,0.086,-125,1512.5,"Con",20,50,FALSE,FALSE,FALSE,7.94,"young",42,187,77,"m"
1,"TOTAL ABDOMINAL",2,"Con09",1420,1440,1700,1650,1430,1675,0.171,-245,1552.5,"Con",-20,50,TRUE,FALSE,FALSE,14.63,"young",42,187,77,"m"
1,"TOTAL ABDOMINAL",2,"Con10",1560,1580,1750,1750,1570,1750,0.115,-180,1660,"Con",-20,0,TRUE,FALSE,FALSE,10.29,"young",42,187,77,"m"
1,"TOTAL ABDOMINAL",1,"Ecc01",2880,2860,2850,2750,2870,2800,0.024,70,2835,"Ecc",20,100,FALSE,FALSE,FALSE,2.5,"young",42,187,77,"m"
1,"TOTAL ABDOMINAL",1,"Ecc02",2500,2500,2450,2450,2500,2450,0.02,50,2475,"Ecc",0,0,FALSE,FALSE,FALSE,2.04,"young",42,187,77,"m"
1,"TOTAL ABDOMINAL",1,"Ecc03",2420,2440,2400,2450,2430,2425,0.002,5,2427.5,"Ecc",-20,-50,FALSE,FALSE,FALSE,0.21,"young",42,187,77,"m"
1,"TOTAL ABDOMINAL",1,"Ecc04",2220,2220,2150,2200,2220,2175,0.02,45,2197.5,"Ecc",0,-50,FALSE,FALSE,FALSE,2.07,"young",42,187,77,"m"
1,"TOTAL ABDOMINAL",1,"Ecc05",2100,2120,2000,2000,2110,2000,0.052,110,2055,"Ecc",-20,0,FALSE,FALSE,FALSE,5.5,"young",42,187,77,"m"
1,"TOTAL ABDOMINAL",1,"Ecc06",2100,2100,1950,2050,2100,2000,0.048,100,2050,"Ecc",0,-100,FALSE,FALSE,FALSE,5,"young",42,187,77,"m"
1,"TOTAL ABDOMINAL",1,"Ecc07",2280,2280,2200,2200,2280,2200,0.035,80,2240,"Ecc",0,0,FALSE,FALSE,FALSE,3.64,"young",42,187,77,"m"
1,"TOTAL ABDOMINAL",1,"Ecc08",2260,2240,2150,2100,2250,2125,0.056,125,2187.5,"Ecc",20,50,FALSE,FALSE,FALSE,5.88,"young",42,187,77,"m"
1,"TOTAL ABDOMINAL",1,"Ecc09",2340,2300,2150,2000,2320,2075,0.106,245,2197.5,"Ecc",40,150,TRUE,TRUE,FALSE,11.81,"young",42,187,77,"m"
1,"TOTAL ABDOMINAL",1,"Ecc10",2460,2420,2350,2350,2440,2350,0.037,90,2395,"Ecc",40,0,FALSE,TRUE,FALSE,3.83,"young",42,187,77,"m"
1,"TOTAL ABDOMINAL",2,"Ecc01",2180,2160,2200,2000,2170,2100,0.032,70,2135,"Ecc",20,200,FALSE,FALSE,TRUE,3.33,"young",42,187,77,"m"
1,"TOTAL ABDOMINAL",2,"Ecc02",2220,2180,2200,2100,2200,2150,0.023,50,2175,"Ecc",40,100,FALSE,TRUE,FALSE,2.33,"young",42,187,77,"m"
1,"TOTAL ABDOMINAL",2,"Ecc03",2200,2180,2250,2200,2190,2225,0.016,-35,2207.5,"Ecc",20,50,FALSE,FALSE,FALSE,1.57,"young",42,187,77,"m"
1,"TOTAL ABDOMINAL",2,"Ecc04",2200,2180,2200,2150,2190,2175,0.007,15,2182.5,"Ecc",20,50,FALSE,FALSE,FALSE,0.69,"young",42,187,77,"m"
1,"TOTAL ABDOMINAL",2,"Ecc05",2100,2080,2000,2050,2090,2025,0.031,65,2057.5,"Ecc",20,-50,FALSE,FALSE,FALSE,3.21,"young",42,187,77,"m"
1,"TOTAL ABDOMINAL",2,"Ecc06",2220,2220,2100,2150,2220,2125,0.043,95,2172.5,"Ecc",0,-50,FALSE,FALSE,FALSE,4.47,"young",42,187,77,"m"
1,"TOTAL ABDOMINAL",2,"Ecc07",2120,2100,1950,2050,2110,2000,0.052,110,2055,"Ecc",20,-100,FALSE,FALSE,FALSE,5.5,"young",42,187,77,"m"
1,"TOTAL ABDOMINAL",2,"Ecc08",1940,1960,1750,1800,1950,1775,0.09,175,1862.5,"Ecc",-20,-50,TRUE,FALSE,FALSE,9.86,"young",42,187,77,"m"
1,"TOTAL ABDOMINAL",2,"Ecc09",1920,1900,1700,1700,1910,1700,0.11,210,1805,"Ecc",20,0,TRUE,FALSE,FALSE,12.35,"young",42,187,77,"m"
1,"TOTAL ABDOMINAL",2,"Ecc10",2400,2400,2350,2350,2400,2350,0.021,50,2375,"Ecc",0,0,FALSE,FALSE,FALSE,2.13,"young",42,187,77,"m"
1,"TOTAL ABDOMINAL",1,"Rep01",4380,4360,4400,4450,4370,4425,0.013,-55,4397.5,"Rep",20,-50,FALSE,FALSE,FALSE,1.24,"young",42,187,77,"m"
1,"TOTAL ABDOMINAL",1,"Rep02",4020,4020,4000,4050,4020,4025,0.001,-5,4022.5,"Rep",0,-50,FALSE,FALSE,FALSE,0.12,"young",42,187,77,"m"
1,"TOTAL ABDOMINAL",1,"Rep03",3920,3960,3950,3950,3940,3950,0.003,-10,3945,"Rep",-40,0,FALSE,FALSE,FALSE,0.25,"young",42,187,77,"m"
1,"TOTAL ABDOMINAL",1,"Rep04",3760,3720,3700,3750,3740,3725,0.004,15,3732.5,"Rep",40,-50,FALSE,FALSE,FALSE,0.4,"young",42,187,77,"m"
1,"TOTAL ABDOMINAL",1,"Rep05",3600,3620,3600,3550,3610,3575,0.01,35,3592.5,"Rep",-20,50,FALSE,FALSE,FALSE,0.98,"young",42,187,77,"m"
1,"TOTAL ABDOMINAL",1,"Rep06",3620,3620,3600,3650,3620,3625,0.001,-5,3622.5,"Rep",0,-50,FALSE,FALSE,FALSE,0.14,"young",42,187,77,"m"
1,"TOTAL ABDOMINAL",1,"Rep07",3720,3700,3750,3700,3710,3725,0.004,-15,3717.5,"Rep",20,50,FALSE,FALSE,FALSE,0.4,"young",42,187,77,"m"
1,"TOTAL ABDOMINAL",1,"Rep08",3720,3720,3700,3650,3720,3675,0.012,45,3697.5,"Rep",0,50,FALSE,FALSE,FALSE,1.22,"young",42,187,77,"m"
1,"TOTAL ABDOMINAL",1,"Rep09",3820,3800,3750,3650,3810,3700,0.029,110,3755,"Rep",20,100,FALSE,FALSE,FALSE,2.97,"young",42,187,77,"m"
1,"TOTAL ABDOMINAL",1,"Rep10",3920,3900,4050,4200,3910,4125,0.055,-215,4017.5,"Rep",20,-150,TRUE,FALSE,FALSE,5.21,"young",42,187,77,"m"
1,"TOTAL ABDOMINAL",2,"Rep01",3400,3400,3700,3400,3400,3550,0.044,-150,3475,"Rep",0,300,TRUE,FALSE,TRUE,4.23,"young",42,187,77,"m"
1,"TOTAL ABDOMINAL",2,"Rep02",3560,3540,3550,3600,3550,3575,0.007,-25,3562.5,"Rep",20,-50,FALSE,FALSE,FALSE,0.7,"young",42,187,77,"m"
1,"TOTAL ABDOMINAL",2,"Rep03",3620,3640,3650,3700,3630,3675,0.012,-45,3652.5,"Rep",-20,-50,FALSE,FALSE,FALSE,1.22,"young",42,187,77,"m"
1,"TOTAL ABDOMINAL",2,"Rep04",3620,3620,3600,3600,3620,3600,0.006,20,3610,"Rep",0,0,FALSE,FALSE,FALSE,0.56,"young",42,187,77,"m"
1,"TOTAL ABDOMINAL",2,"Rep05",3560,3560,3500,3550,3560,3525,0.01,35,3542.5,"Rep",0,-50,FALSE,FALSE,FALSE,0.99,"young",42,187,77,"m"
1,"TOTAL ABDOMINAL",2,"Rep06",3780,3780,3750,3750,3780,3750,0.008,30,3765,"Rep",0,0,FALSE,FALSE,FALSE,0.8,"young",42,187,77,"m"
1,"TOTAL ABDOMINAL",2,"Rep07",3500,3500,3500,3500,3500,3500,0,0,3500,"Rep",0,0,FALSE,FALSE,FALSE,0,"young",42,187,77,"m"
1,"TOTAL ABDOMINAL",2,"Rep08",3400,3400,3350,3350,3400,3350,0.015,50,3375,"Rep",0,0,FALSE,FALSE,FALSE,1.49,"young",42,187,77,"m"
1,"TOTAL ABDOMINAL",2,"Rep09",3340,3340,3400,3350,3340,3375,0.01,-35,3357.5,"Rep",0,50,FALSE,FALSE,FALSE,1.04,"young",42,187,77,"m"
1,"TOTAL ABDOMINAL",2,"Rep10",3960,3980,4100,4100,3970,4100,0.033,-130,4035,"Rep",-20,0,TRUE,FALSE,FALSE,3.17,"young",42,187,77,"m"
1,"TOTAL ABDOMINAL",1,"TuT",38480,38420,38500,38600,38450,38550,0.003,-100,38500,"TuT",60,-100,FALSE,TRUE,FALSE,0.26,"young",42,187,77,"m"
1,"TOTAL ABDOMINAL",2,"TuT",35740,35760,36100,35900,35750,36000,0.007,-250,35875,"TuT",-20,200,TRUE,FALSE,FALSE,0.69,"young",42,187,77,"m"
1,"VERTICAL TRACTION",1,"Con01",1680,1680,1750,1650,1680,1700,0.012,-20,1690,"Con",0,100,FALSE,FALSE,FALSE,1.18,"young",42,187,77,"m"
1,"VERTICAL TRACTION",1,"Con02",1920,1900,2200,2300,1910,2250,0.178,-340,2080,"Con",20,-100,TRUE,FALSE,FALSE,15.11,"young",42,187,77,"m"
1,"VERTICAL TRACTION",1,"Con03",2040,2060,2250,2250,2050,2250,0.098,-200,2150,"Con",-20,0,FALSE,FALSE,FALSE,8.89,"young",42,187,77,"m"
1,"VERTICAL TRACTION",1,"Con04",2140,2160,2300,2300,2150,2300,0.07,-150,2225,"Con",-20,0,FALSE,FALSE,FALSE,6.52,"young",42,187,77,"m"
1,"VERTICAL TRACTION",1,"Con05",2020,2020,2100,2100,2020,2100,0.04,-80,2060,"Con",0,0,FALSE,FALSE,FALSE,3.81,"young",42,187,77,"m"
1,"VERTICAL TRACTION",1,"Con06",2060,2080,2050,2050,2070,2050,0.01,20,2060,"Con",-20,0,FALSE,FALSE,FALSE,0.98,"young",42,187,77,"m"
1,"VERTICAL TRACTION",1,"Con07",2080,2100,2000,2000,2090,2000,0.043,90,2045,"Con",-20,0,FALSE,FALSE,FALSE,4.5,"young",42,187,77,"m"
1,"VERTICAL TRACTION",1,"Con08",2040,2040,1900,2000,2040,1950,0.044,90,1995,"Con",0,-100,FALSE,FALSE,FALSE,4.62,"young",42,187,77,"m"
1,"VERTICAL TRACTION",1,"Con09",2040,2060,1950,1950,2050,1950,0.049,100,2000,"Con",-20,0,FALSE,FALSE,FALSE,5.13,"young",42,187,77,"m"
1,"VERTICAL TRACTION",1,"Con10",2420,2400,2450,2400,2410,2425,0.006,-15,2417.5,"Con",20,50,FALSE,FALSE,FALSE,0.62,"young",42,187,77,"m"
1,"VERTICAL TRACTION",2,"Con01",1780,1660,3400,3600,1720,3500,1.035,-1780,2610,"Con",120,-200,TRUE,TRUE,TRUE,50.86,"young",42,187,77,"m"
1,"VERTICAL TRACTION",2,"Con02",1760,1760,1800,1800,1760,1800,0.023,-40,1780,"Con",0,0,FALSE,FALSE,FALSE,2.22,"young",42,187,77,"m"
1,"VERTICAL TRACTION",2,"Con03",1820,1840,1900,1900,1830,1900,0.038,-70,1865,"Con",-20,0,FALSE,FALSE,FALSE,3.68,"young",42,187,77,"m"
1,"VERTICAL TRACTION",2,"Con04",1760,1800,1850,1800,1780,1825,0.025,-45,1802.5,"Con",-40,50,FALSE,FALSE,FALSE,2.47,"young",42,187,77,"m"
1,"VERTICAL TRACTION",2,"Con05",1880,1880,2000,1850,1880,1925,0.024,-45,1902.5,"Con",0,150,FALSE,FALSE,FALSE,2.34,"young",42,187,77,"m"
1,"VERTICAL TRACTION",2,"Con06",1860,1880,1900,1800,1870,1850,0.011,20,1860,"Con",-20,100,FALSE,FALSE,FALSE,1.08,"young",42,187,77,"m"
1,"VERTICAL TRACTION",2,"Con07",1820,1860,1800,1850,1840,1825,0.008,15,1832.5,"Con",-40,-50,FALSE,FALSE,FALSE,0.82,"young",42,187,77,"m"
1,"VERTICAL TRACTION",2,"Con08",1980,1980,1900,2050,1980,1975,0.003,5,1977.5,"Con",0,-150,FALSE,FALSE,FALSE,0.25,"young",42,187,77,"m"
1,"VERTICAL TRACTION",2,"Con09",1920,1920,1850,2000,1920,1925,0.003,-5,1922.5,"Con",0,-150,FALSE,FALSE,FALSE,0.26,"young",42,187,77,"m"
1,"VERTICAL TRACTION",2,"Con10",2180,2200,2300,2250,2190,2275,0.039,-85,2232.5,"Con",-20,50,FALSE,FALSE,FALSE,3.74,"young",42,187,77,"m"
1,"VERTICAL TRACTION",1,"Ecc01",2940,2960,2750,2650,2950,2700,0.085,250,2825,"Ecc",-20,100,FALSE,FALSE,FALSE,9.26,"young",42,187,77,"m"
1,"VERTICAL TRACTION",1,"Ecc02",3260,3260,3050,3050,3260,3050,0.064,210,3155,"Ecc",0,0,FALSE,FALSE,FALSE,6.89,"young",42,187,77,"m"
1,"VERTICAL TRACTION",1,"Ecc03",2880,2860,2650,2650,2870,2650,0.077,220,2760,"Ecc",20,0,FALSE,FALSE,FALSE,8.3,"young",42,187,77,"m"
1,"VERTICAL TRACTION",1,"Ecc04",3060,3040,3000,3000,3050,3000,0.016,50,3025,"Ecc",20,0,FALSE,FALSE,FALSE,1.67,"young",42,187,77,"m"
1,"VERTICAL TRACTION",1,"Ecc05",2900,2900,2850,2850,2900,2850,0.017,50,2875,"Ecc",0,0,FALSE,FALSE,FALSE,1.75,"young",42,187,77,"m"
1,"VERTICAL TRACTION",1,"Ecc06",2820,2780,2850,2850,2800,2850,0.018,-50,2825,"Ecc",40,0,FALSE,FALSE,FALSE,1.75,"young",42,187,77,"m"
1,"VERTICAL TRACTION",1,"Ecc07",2760,2760,2900,2850,2760,2875,0.042,-115,2817.5,"Ecc",0,50,FALSE,FALSE,FALSE,4,"young",42,187,77,"m"
1,"VERTICAL TRACTION",1,"Ecc08",2560,2560,2700,2650,2560,2675,0.045,-115,2617.5,"Ecc",0,50,FALSE,FALSE,FALSE,4.3,"young",42,187,77,"m"
1,"VERTICAL TRACTION",1,"Ecc09",2720,2720,2750,2800,2720,2775,0.02,-55,2747.5,"Ecc",0,-50,FALSE,FALSE,FALSE,1.98,"young",42,187,77,"m"
1,"VERTICAL TRACTION",1,"Ecc10",3760,2500,2450,2450,3130,2450,0.217,680,2790,"Ecc",1260,0,TRUE,TRUE,FALSE,27.76,"young",42,187,77,"m"
1,"VERTICAL TRACTION",2,"Ecc01",2500,2500,2550,2400,2500,2475,0.01,25,2487.5,"Ecc",0,150,FALSE,FALSE,FALSE,1.01,"young",42,187,77,"m"
1,"VERTICAL TRACTION",2,"Ecc02",2460,2460,2400,2400,2460,2400,0.024,60,2430,"Ecc",0,0,FALSE,FALSE,FALSE,2.5,"young",42,187,77,"m"
1,"VERTICAL TRACTION",2,"Ecc03",2620,2580,2500,2550,2600,2525,0.029,75,2562.5,"Ecc",40,-50,FALSE,FALSE,FALSE,2.97,"young",42,187,77,"m"
1,"VERTICAL TRACTION",2,"Ecc04",2600,2580,2500,2600,2590,2550,0.015,40,2570,"Ecc",20,-100,FALSE,FALSE,FALSE,1.57,"young",42,187,77,"m"
1,"VERTICAL TRACTION",2,"Ecc05",2560,2560,2500,2600,2560,2550,0.004,10,2555,"Ecc",0,-100,FALSE,FALSE,FALSE,0.39,"young",42,187,77,"m"
1,"VERTICAL TRACTION",2,"Ecc06",2520,2480,2500,2550,2500,2525,0.01,-25,2512.5,"Ecc",40,-50,FALSE,FALSE,FALSE,0.99,"young",42,187,77,"m"
1,"VERTICAL TRACTION",2,"Ecc07",2600,2600,2650,2550,2600,2600,0,0,2600,"Ecc",0,100,FALSE,FALSE,FALSE,0,"young",42,187,77,"m"
1,"VERTICAL TRACTION",2,"Ecc08",2460,2440,2550,2400,2450,2475,0.01,-25,2462.5,"Ecc",20,150,FALSE,FALSE,FALSE,1.01,"young",42,187,77,"m"
1,"VERTICAL TRACTION",2,"Ecc09",2440,2440,2400,2350,2440,2375,0.027,65,2407.5,"Ecc",0,50,FALSE,FALSE,FALSE,2.74,"young",42,187,77,"m"
1,"VERTICAL TRACTION",2,"Ecc10",3920,2600,2600,2600,3260,2600,0.202,660,2930,"Ecc",1320,0,TRUE,TRUE,FALSE,25.38,"young",42,187,77,"m"
1,"VERTICAL TRACTION",1,"Rep01",4620,4640,4500,4300,4630,4400,0.05,230,4515,"Rep",-20,200,TRUE,FALSE,TRUE,5.23,"young",42,187,77,"m"
1,"VERTICAL TRACTION",1,"Rep02",5180,5160,5250,5350,5170,5300,0.025,-130,5235,"Rep",20,-100,FALSE,FALSE,FALSE,2.45,"young",42,187,77,"m"
1,"VERTICAL TRACTION",1,"Rep03",4920,4920,4900,4900,4920,4900,0.004,20,4910,"Rep",0,0,FALSE,FALSE,FALSE,0.41,"young",42,187,77,"m"
1,"VERTICAL TRACTION",1,"Rep04",5200,5200,5300,5300,5200,5300,0.019,-100,5250,"Rep",0,0,FALSE,FALSE,FALSE,1.89,"young",42,187,77,"m"
1,"VERTICAL TRACTION",1,"Rep05",4920,4920,4950,4950,4920,4950,0.006,-30,4935,"Rep",0,0,FALSE,FALSE,FALSE,0.61,"young",42,187,77,"m"
1,"VERTICAL TRACTION",1,"Rep06",4880,4860,4900,4900,4870,4900,0.006,-30,4885,"Rep",20,0,FALSE,FALSE,FALSE,0.61,"young",42,187,77,"m"
1,"VERTICAL TRACTION",1,"Rep07",4840,4860,4900,4850,4850,4875,0.005,-25,4862.5,"Rep",-20,50,FALSE,FALSE,FALSE,0.51,"young",42,187,77,"m"
1,"VERTICAL TRACTION",1,"Rep08",4600,4600,4600,4650,4600,4625,0.005,-25,4612.5,"Rep",0,-50,FALSE,FALSE,FALSE,0.54,"young",42,187,77,"m"
1,"VERTICAL TRACTION",1,"Rep09",4760,4780,4700,4750,4770,4725,0.009,45,4747.5,"Rep",-20,-50,FALSE,FALSE,FALSE,0.95,"young",42,187,77,"m"
1,"VERTICAL TRACTION",1,"Rep10",6180,4900,4900,4850,5540,4875,0.12,665,5207.5,"Rep",1280,50,TRUE,TRUE,FALSE,13.64,"young",42,187,77,"m"
1,"VERTICAL TRACTION",2,"Rep01",4280,4160,5950,6000,4220,5975,0.416,-1755,5097.5,"Rep",120,-50,TRUE,TRUE,FALSE,29.37,"young",42,187,77,"m"
1,"VERTICAL TRACTION",2,"Rep02",4220,4220,4200,4200,4220,4200,0.005,20,4210,"Rep",0,0,FALSE,FALSE,FALSE,0.48,"young",42,187,77,"m"
1,"VERTICAL TRACTION",2,"Rep03",4440,4420,4400,4450,4430,4425,0.001,5,4427.5,"Rep",20,-50,FALSE,FALSE,FALSE,0.11,"young",42,187,77,"m"
1,"VERTICAL TRACTION",2,"Rep04",4360,4380,4350,4400,4370,4375,0.001,-5,4372.5,"Rep",-20,-50,FALSE,FALSE,FALSE,0.11,"young",42,187,77,"m"
1,"VERTICAL TRACTION",2,"Rep05",4440,4440,4500,4450,4440,4475,0.008,-35,4457.5,"Rep",0,50,FALSE,FALSE,FALSE,0.78,"young",42,187,77,"m"
1,"VERTICAL TRACTION",2,"Rep06",4380,4360,4400,4350,4370,4375,0.001,-5,4372.5,"Rep",20,50,FALSE,FALSE,FALSE,0.11,"young",42,187,77,"m"
1,"VERTICAL TRACTION",2,"Rep07",4420,4460,4450,4400,4440,4425,0.003,15,4432.5,"Rep",-40,50,FALSE,FALSE,FALSE,0.34,"young",42,187,77,"m"
1,"VERTICAL TRACTION",2,"Rep08",4440,4420,4450,4450,4430,4450,0.005,-20,4440,"Rep",20,0,FALSE,FALSE,FALSE,0.45,"young",42,187,77,"m"
1,"VERTICAL TRACTION",2,"Rep09",4360,4360,4250,4350,4360,4300,0.014,60,4330,"Rep",0,-100,FALSE,FALSE,FALSE,1.4,"young",42,187,77,"m"
1,"VERTICAL TRACTION",2,"Rep10",6100,4800,4900,4850,5450,4875,0.106,575,5162.5,"Rep",1300,50,TRUE,TRUE,FALSE,11.79,"young",42,187,77,"m"
1,"VERTICAL TRACTION",1,"TuT",50100,48840,48900,48800,49470,48850,0.013,620,49160,"TuT",1260,100,FALSE,TRUE,FALSE,1.27,"young",42,187,77,"m"
1,"VERTICAL TRACTION",2,"TuT",45440,44020,45850,45900,44730,45875,0.026,-1145,45302.5,"TuT",1420,-50,FALSE,TRUE,FALSE,2.5,"young",42,187,77,"m"
1,"CHEST PRESS",1,"Con01",1720,1700,3650,3650,1710,3650,1.135,-1940,2680,"Con",20,0,TRUE,FALSE,FALSE,53.15,"young",42,187,77,"m"
1,"CHEST PRESS",1,"Con02",1760,1740,1900,1900,1750,1900,0.086,-150,1825,"Con",20,0,FALSE,FALSE,FALSE,7.89,"young",42,187,77,"m"
1,"CHEST PRESS",1,"Con03",1500,1500,1550,1500,1500,1525,0.017,-25,1512.5,"Con",0,50,FALSE,FALSE,FALSE,1.64,"young",42,187,77,"m"
1,"CHEST PRESS",1,"Con04",1560,1540,1500,1600,1550,1550,0,0,1550,"Con",20,-100,FALSE,FALSE,FALSE,0,"young",42,187,77,"m"
1,"CHEST PRESS",1,"Con05",1460,1460,1550,1550,1460,1550,0.062,-90,1505,"Con",0,0,FALSE,FALSE,FALSE,5.81,"young",42,187,77,"m"
1,"CHEST PRESS",1,"Con06",1520,1520,1550,1500,1520,1525,0.003,-5,1522.5,"Con",0,50,FALSE,FALSE,FALSE,0.33,"young",42,187,77,"m"
1,"CHEST PRESS",1,"Con07",1560,1580,1500,1600,1570,1550,0.013,20,1560,"Con",-20,-100,FALSE,FALSE,FALSE,1.29,"young",42,187,77,"m"
1,"CHEST PRESS",1,"Con08",1540,1560,1550,1650,1550,1600,0.032,-50,1575,"Con",-20,-100,FALSE,FALSE,FALSE,3.12,"young",42,187,77,"m"
1,"CHEST PRESS",1,"Con09",1640,1620,1550,1700,1630,1625,0.003,5,1627.5,"Con",20,-150,FALSE,FALSE,FALSE,0.31,"young",42,187,77,"m"
1,"CHEST PRESS",1,"Con10",2060,2020,2100,1950,2040,2025,0.007,15,2032.5,"Con",40,150,FALSE,TRUE,FALSE,0.74,"young",42,187,77,"m"
1,"CHEST PRESS",2,"Con01",1380,1340,4050,3650,1360,3850,1.831,-2490,2605,"Con",40,400,TRUE,TRUE,TRUE,64.68,"young",42,187,77,"m"
1,"CHEST PRESS",2,"Con02",1360,1380,1450,1350,1370,1400,0.022,-30,1385,"Con",-20,100,FALSE,FALSE,FALSE,2.14,"young",42,187,77,"m"
1,"CHEST PRESS",2,"Con03",1440,1440,1450,1350,1440,1400,0.028,40,1420,"Con",0,100,FALSE,FALSE,FALSE,2.86,"young",42,187,77,"m"
1,"CHEST PRESS",2,"Con04",1380,1380,1400,1500,1380,1450,0.051,-70,1415,"Con",0,-100,FALSE,FALSE,FALSE,4.83,"young",42,187,77,"m"
1,"CHEST PRESS",2,"Con05",1420,1440,1400,1500,1430,1450,0.014,-20,1440,"Con",-20,-100,FALSE,FALSE,FALSE,1.38,"young",42,187,77,"m"
1,"CHEST PRESS",2,"Con06",1400,1380,1400,1500,1390,1450,0.043,-60,1420,"Con",20,-100,FALSE,FALSE,FALSE,4.14,"young",42,187,77,"m"
1,"CHEST PRESS",2,"Con07",1460,1460,1450,1450,1460,1450,0.007,10,1455,"Con",0,0,FALSE,FALSE,FALSE,0.69,"young",42,187,77,"m"
1,"CHEST PRESS",2,"Con08",1500,1520,1550,1450,1510,1500,0.007,10,1505,"Con",-20,100,FALSE,FALSE,FALSE,0.67,"young",42,187,77,"m"
1,"CHEST PRESS",2,"Con09",1600,1600,1600,1550,1600,1575,0.016,25,1587.5,"Con",0,50,FALSE,FALSE,FALSE,1.59,"young",42,187,77,"m"
1,"CHEST PRESS",2,"Con10",1740,1740,1850,1650,1740,1750,0.006,-10,1745,"Con",0,200,FALSE,FALSE,FALSE,0.57,"young",42,187,77,"m"
1,"CHEST PRESS",1,"Ecc01",2740,2760,2500,2600,2750,2550,0.073,200,2650,"Ecc",-20,-100,FALSE,FALSE,FALSE,7.84,"young",42,187,77,"m"
1,"CHEST PRESS",1,"Ecc02",2720,2720,2650,2700,2720,2675,0.017,45,2697.5,"Ecc",0,-50,FALSE,FALSE,FALSE,1.68,"young",42,187,77,"m"
1,"CHEST PRESS",1,"Ecc03",2640,2660,2650,2650,2650,2650,0,0,2650,"Ecc",-20,0,FALSE,FALSE,FALSE,0,"young",42,187,77,"m"
1,"CHEST PRESS",1,"Ecc04",2360,2360,2350,2250,2360,2300,0.025,60,2330,"Ecc",0,100,FALSE,FALSE,FALSE,2.61,"young",42,187,77,"m"
1,"CHEST PRESS",1,"Ecc05",2420,2440,2350,2400,2430,2375,0.023,55,2402.5,"Ecc",-20,-50,FALSE,FALSE,FALSE,2.32,"young",42,187,77,"m"
1,"CHEST PRESS",1,"Ecc06",2320,2300,2350,2300,2310,2325,0.006,-15,2317.5,"Ecc",20,50,FALSE,FALSE,FALSE,0.65,"young",42,187,77,"m"
1,"CHEST PRESS",1,"Ecc07",2140,2120,2150,2100,2130,2125,0.002,5,2127.5,"Ecc",20,50,FALSE,FALSE,FALSE,0.24,"young",42,187,77,"m"
1,"CHEST PRESS",1,"Ecc08",2240,2240,2300,2150,2240,2225,0.007,15,2232.5,"Ecc",0,150,FALSE,FALSE,FALSE,0.67,"young",42,187,77,"m"
1,"CHEST PRESS",1,"Ecc09",2300,2320,2300,2300,2310,2300,0.004,10,2305,"Ecc",-20,0,FALSE,FALSE,FALSE,0.43,"young",42,187,77,"m"
1,"CHEST PRESS",1,"Ecc10",3440,2800,2450,2500,3120,2475,0.207,645,2797.5,"Ecc",640,-50,TRUE,TRUE,FALSE,26.06,"young",42,187,77,"m"
1,"CHEST PRESS",2,"Ecc01",2100,2100,2000,2050,2100,2025,0.036,75,2062.5,"Ecc",0,-50,FALSE,FALSE,FALSE,3.7,"young",42,187,77,"m"
1,"CHEST PRESS",2,"Ecc02",2060,2040,2000,2100,2050,2050,0,0,2050,"Ecc",20,-100,FALSE,FALSE,FALSE,0,"young",42,187,77,"m"
1,"CHEST PRESS",2,"Ecc03",2100,2120,2100,2100,2110,2100,0.005,10,2105,"Ecc",-20,0,FALSE,FALSE,FALSE,0.48,"young",42,187,77,"m"
1,"CHEST PRESS",2,"Ecc04",2000,1980,2000,1900,1990,1950,0.02,40,1970,"Ecc",20,100,FALSE,FALSE,FALSE,2.05,"young",42,187,77,"m"
1,"CHEST PRESS",2,"Ecc05",2000,2000,2000,1900,2000,1950,0.025,50,1975,"Ecc",0,100,FALSE,FALSE,FALSE,2.56,"young",42,187,77,"m"
1,"CHEST PRESS",2,"Ecc06",2060,2080,2100,2050,2070,2075,0.002,-5,2072.5,"Ecc",-20,50,FALSE,FALSE,FALSE,0.24,"young",42,187,77,"m"
1,"CHEST PRESS",2,"Ecc07",2040,2020,2000,2050,2030,2025,0.002,5,2027.5,"Ecc",20,-50,FALSE,FALSE,FALSE,0.25,"young",42,187,77,"m"
1,"CHEST PRESS",2,"Ecc08",1980,1980,1950,2000,1980,1975,0.003,5,1977.5,"Ecc",0,-50,FALSE,FALSE,FALSE,0.25,"young",42,187,77,"m"
1,"CHEST PRESS",2,"Ecc09",1840,1820,1800,1950,1830,1875,0.025,-45,1852.5,"Ecc",20,-150,FALSE,FALSE,FALSE,2.4,"young",42,187,77,"m"
1,"CHEST PRESS",2,"Ecc10",3260,2100,2050,2150,2680,2100,0.216,580,2390,"Ecc",1160,-100,TRUE,TRUE,FALSE,27.62,"young",42,187,77,"m"
1,"CHEST PRESS",1,"Rep01",4460,4460,6150,6250,4460,6200,0.39,-1740,5330,"Rep",0,-100,TRUE,FALSE,FALSE,28.06,"young",42,187,77,"m"
1,"CHEST PRESS",1,"Rep02",4480,4460,4550,4600,4470,4575,0.023,-105,4522.5,"Rep",20,-50,FALSE,FALSE,FALSE,2.3,"young",42,187,77,"m"
1,"CHEST PRESS",1,"Rep03",4140,4160,4200,4150,4150,4175,0.006,-25,4162.5,"Rep",-20,50,FALSE,FALSE,FALSE,0.6,"young",42,187,77,"m"
1,"CHEST PRESS",1,"Rep04",3920,3900,3850,3850,3910,3850,0.015,60,3880,"Rep",20,0,FALSE,FALSE,FALSE,1.56,"young",42,187,77,"m"
1,"CHEST PRESS",1,"Rep05",3880,3900,3900,3950,3890,3925,0.009,-35,3907.5,"Rep",-20,-50,FALSE,FALSE,FALSE,0.89,"young",42,187,77,"m"
1,"CHEST PRESS",1,"Rep06",3840,3820,3900,3800,3830,3850,0.005,-20,3840,"Rep",20,100,FALSE,FALSE,FALSE,0.52,"young",42,187,77,"m"
1,"CHEST PRESS",1,"Rep07",3700,3700,3650,3700,3700,3675,0.007,25,3687.5,"Rep",0,-50,FALSE,FALSE,FALSE,0.68,"young",42,187,77,"m"
1,"CHEST PRESS",1,"Rep08",3780,3800,3850,3800,3790,3825,0.009,-35,3807.5,"Rep",-20,50,FALSE,FALSE,FALSE,0.92,"young",42,187,77,"m"
1,"CHEST PRESS",1,"Rep09",3940,3940,3850,4000,3940,3925,0.004,15,3932.5,"Rep",0,-150,FALSE,FALSE,FALSE,0.38,"young",42,187,77,"m"
1,"CHEST PRESS",1,"Rep10",5500,4820,4550,4450,5160,4500,0.128,660,4830,"Rep",680,100,TRUE,TRUE,FALSE,14.67,"young",42,187,77,"m"
1,"CHEST PRESS",2,"Rep01",3480,3440,6050,5700,3460,5875,0.698,-2415,4667.5,"Rep",40,350,TRUE,FALSE,TRUE,41.11,"young",42,187,77,"m"
1,"CHEST PRESS",2,"Rep02",3420,3420,3450,3450,3420,3450,0.009,-30,3435,"Rep",0,0,FALSE,FALSE,FALSE,0.87,"young",42,187,77,"m"
1,"CHEST PRESS",2,"Rep03",3540,3560,3550,3450,3550,3500,0.014,50,3525,"Rep",-20,100,FALSE,FALSE,FALSE,1.43,"young",42,187,77,"m"
1,"CHEST PRESS",2,"Rep04",3380,3360,3400,3400,3370,3400,0.009,-30,3385,"Rep",20,0,FALSE,FALSE,FALSE,0.88,"young",42,187,77,"m"
1,"CHEST PRESS",2,"Rep05",3420,3440,3400,3400,3430,3400,0.009,30,3415,"Rep",-20,0,FALSE,FALSE,FALSE,0.88,"young",42,187,77,"m"
1,"CHEST PRESS",2,"Rep06",3460,3460,3500,3550,3460,3525,0.019,-65,3492.5,"Rep",0,-50,FALSE,FALSE,FALSE,1.84,"young",42,187,77,"m"
1,"CHEST PRESS",2,"Rep07",3500,3480,3450,3500,3490,3475,0.004,15,3482.5,"Rep",20,-50,FALSE,FALSE,FALSE,0.43,"young",42,187,77,"m"
1,"CHEST PRESS",2,"Rep08",3480,3500,3500,3450,3490,3475,0.004,15,3482.5,"Rep",-20,50,FALSE,FALSE,FALSE,0.43,"young",42,187,77,"m"
1,"CHEST PRESS",2,"Rep09",3440,3420,3400,3500,3430,3450,0.006,-20,3440,"Rep",20,-100,FALSE,FALSE,FALSE,0.58,"young",42,187,77,"m"
1,"CHEST PRESS",2,"Rep10",5000,3840,3900,3800,4420,3850,0.129,570,4135,"Rep",1160,100,TRUE,TRUE,FALSE,14.81,"young",42,187,77,"m"
1,"CHEST PRESS",1,"TuT",41640,40960,42450,42550,41300,42500,0.029,-1200,41900,"TuT",680,-100,FALSE,TRUE,FALSE,2.82,"young",42,187,77,"m"
1,"CHEST PRESS",2,"TuT",36120,34920,37600,37200,35520,37400,0.053,-1880,36460,"TuT",1200,400,TRUE,TRUE,FALSE,5.03,"young",42,187,77,"m"
2,"LEG PRESS",1,"Con01",1120,1140,1400,1350,1130,1375,0.217,-245,1252.5,"Con",-20,50,FALSE,FALSE,FALSE,17.82,"young",31,180,105,"m"
2,"LEG PRESS",1,"Con02",1200,1160,1300,1300,1180,1300,0.102,-120,1240,"Con",40,0,FALSE,FALSE,FALSE,9.23,"young",31,180,105,"m"
2,"LEG PRESS",1,"Con03",1360,1320,1400,1400,1340,1400,0.045,-60,1370,"Con",40,0,FALSE,FALSE,FALSE,4.29,"young",31,180,105,"m"
2,"LEG PRESS",1,"Con04",1360,1380,1350,1450,1370,1400,0.022,-30,1385,"Con",-20,-100,FALSE,FALSE,FALSE,2.14,"young",31,180,105,"m"
2,"LEG PRESS",1,"Con05",1240,1240,1300,1350,1240,1325,0.069,-85,1282.5,"Con",0,-50,FALSE,FALSE,FALSE,6.42,"young",31,180,105,"m"
2,"LEG PRESS",1,"Con06",1260,1240,1300,1350,1250,1325,0.06,-75,1287.5,"Con",20,-50,FALSE,FALSE,FALSE,5.66,"young",31,180,105,"m"
2,"LEG PRESS",1,"Con07",1180,1160,1350,1300,1170,1325,0.132,-155,1247.5,"Con",20,50,FALSE,FALSE,FALSE,11.7,"young",31,180,105,"m"
2,"LEG PRESS",1,"Con08",1180,1140,1350,1250,1160,1300,0.121,-140,1230,"Con",40,100,FALSE,FALSE,FALSE,10.77,"young",31,180,105,"m"
2,"LEG PRESS",1,"Con09",1260,1260,1400,1300,1260,1350,0.071,-90,1305,"Con",0,100,FALSE,FALSE,FALSE,6.67,"young",31,180,105,"m"
2,"LEG PRESS",1,"Con10",1280,1200,1450,1400,1240,1425,0.149,-185,1332.5,"Con",80,50,FALSE,TRUE,FALSE,12.98,"young",31,180,105,"m"
2,"LEG PRESS",2,"Con01",1320,1280,1450,1450,1300,1450,0.115,-150,1375,"Con",40,0,FALSE,FALSE,FALSE,10.34,"young",31,180,105,"m"
2,"LEG PRESS",2,"Con02",1240,1220,1300,1300,1230,1300,0.057,-70,1265,"Con",20,0,FALSE,FALSE,FALSE,5.38,"young",31,180,105,"m"
2,"LEG PRESS",2,"Con03",1300,1220,1250,1250,1260,1250,0.008,10,1255,"Con",80,0,FALSE,TRUE,FALSE,0.8,"young",31,180,105,"m"
2,"LEG PRESS",2,"Con04",1280,1260,1350,1400,1270,1375,0.083,-105,1322.5,"Con",20,-50,FALSE,FALSE,FALSE,7.64,"young",31,180,105,"m"
2,"LEG PRESS",2,"Con05",1440,1420,1500,1550,1430,1525,0.066,-95,1477.5,"Con",20,-50,FALSE,FALSE,FALSE,6.23,"young",31,180,105,"m"
2,"LEG PRESS",2,"Con06",1420,1400,1550,1450,1410,1500,0.064,-90,1455,"Con",20,100,FALSE,FALSE,FALSE,6,"young",31,180,105,"m"
2,"LEG PRESS",2,"Con07",1460,1420,1600,1600,1440,1600,0.111,-160,1520,"Con",40,0,FALSE,FALSE,FALSE,10,"young",31,180,105,"m"
2,"LEG PRESS",2,"Con08",1380,1360,1550,1550,1370,1550,0.131,-180,1460,"Con",20,0,FALSE,FALSE,FALSE,11.61,"young",31,180,105,"m"
2,"LEG PRESS",2,"Con09",1420,1400,1550,1550,1410,1550,0.099,-140,1480,"Con",20,0,FALSE,FALSE,FALSE,9.03,"young",31,180,105,"m"
2,"LEG PRESS",2,"Con10",1500,1460,1700,1800,1480,1750,0.182,-270,1615,"Con",40,-100,FALSE,FALSE,FALSE,15.43,"young",31,180,105,"m"
2,"LEG PRESS",1,"Ecc01",3060,3060,2950,2950,3060,2950,0.036,110,3005,"Ecc",0,0,FALSE,FALSE,FALSE,3.73,"young",31,180,105,"m"
2,"LEG PRESS",1,"Ecc02",2320,2340,2250,2200,2330,2225,0.045,105,2277.5,"Ecc",-20,50,FALSE,FALSE,FALSE,4.72,"young",31,180,105,"m"
2,"LEG PRESS",1,"Ecc03",2200,2240,2150,2150,2220,2150,0.032,70,2185,"Ecc",-40,0,FALSE,FALSE,FALSE,3.26,"young",31,180,105,"m"
2,"LEG PRESS",1,"Ecc04",2040,2040,2050,1950,2040,2000,0.02,40,2020,"Ecc",0,100,FALSE,FALSE,FALSE,2,"young",31,180,105,"m"
2,"LEG PRESS",1,"Ecc05",1920,1940,1850,1800,1930,1825,0.054,105,1877.5,"Ecc",-20,50,FALSE,FALSE,FALSE,5.75,"young",31,180,105,"m"
2,"LEG PRESS",1,"Ecc06",1820,1860,1750,1750,1840,1750,0.049,90,1795,"Ecc",-40,0,FALSE,FALSE,FALSE,5.14,"young",31,180,105,"m"
2,"LEG PRESS",1,"Ecc07",1800,1820,1650,1700,1810,1675,0.075,135,1742.5,"Ecc",-20,-50,FALSE,FALSE,FALSE,8.06,"young",31,180,105,"m"
2,"LEG PRESS",1,"Ecc08",1860,1880,1700,1800,1870,1750,0.064,120,1810,"Ecc",-20,-100,FALSE,FALSE,FALSE,6.86,"young",31,180,105,"m"
2,"LEG PRESS",1,"Ecc09",1920,1960,1750,1850,1940,1800,0.072,140,1870,"Ecc",-40,-100,FALSE,FALSE,FALSE,7.78,"young",31,180,105,"m"
2,"LEG PRESS",1,"Ecc10",2180,2140,2150,2150,2160,2150,0.005,10,2155,"Ecc",40,0,FALSE,FALSE,FALSE,0.47,"young",31,180,105,"m"
2,"LEG PRESS",2,"Ecc01",3120,3140,3100,3100,3130,3100,0.01,30,3115,"Ecc",-20,0,FALSE,FALSE,FALSE,0.97,"young",31,180,105,"m"
2,"LEG PRESS",2,"Ecc02",2420,2460,2400,2400,2440,2400,0.016,40,2420,"Ecc",-40,0,FALSE,FALSE,FALSE,1.67,"young",31,180,105,"m"
2,"LEG PRESS",2,"Ecc03",2200,2300,2250,2200,2250,2225,0.011,25,2237.5,"Ecc",-100,50,FALSE,TRUE,FALSE,1.12,"young",31,180,105,"m"
2,"LEG PRESS",2,"Ecc04",2400,2380,2300,2250,2390,2275,0.048,115,2332.5,"Ecc",20,50,FALSE,FALSE,FALSE,5.05,"young",31,180,105,"m"
2,"LEG PRESS",2,"Ecc05",2240,2300,2150,2200,2270,2175,0.042,95,2222.5,"Ecc",-60,-50,FALSE,FALSE,FALSE,4.37,"young",31,180,105,"m"
2,"LEG PRESS",2,"Ecc06",2080,2060,1950,2000,2070,1975,0.046,95,2022.5,"Ecc",20,-50,FALSE,FALSE,FALSE,4.81,"young",31,180,105,"m"
2,"LEG PRESS",2,"Ecc07",2140,2180,2000,2000,2160,2000,0.074,160,2080,"Ecc",-40,0,FALSE,FALSE,FALSE,8,"young",31,180,105,"m"
2,"LEG PRESS",2,"Ecc08",2080,2100,1900,1900,2090,1900,0.091,190,1995,"Ecc",-20,0,FALSE,FALSE,FALSE,10,"young",31,180,105,"m"
2,"LEG PRESS",2,"Ecc09",1920,1980,1850,1800,1950,1825,0.064,125,1887.5,"Ecc",-60,50,FALSE,FALSE,FALSE,6.85,"young",31,180,105,"m"
2,"LEG PRESS",2,"Ecc10",2400,2460,2650,2600,2430,2625,0.08,-195,2527.5,"Ecc",-60,50,FALSE,FALSE,FALSE,7.43,"young",31,180,105,"m"
2,"LEG PRESS",1,"Rep01",4180,4200,4350,4300,4190,4325,0.032,-135,4257.5,"Rep",-20,50,TRUE,FALSE,FALSE,3.12,"young",31,180,105,"m"
2,"LEG PRESS",1,"Rep02",3520,3500,3550,3500,3510,3525,0.004,-15,3517.5,"Rep",20,50,FALSE,FALSE,FALSE,0.43,"young",31,180,105,"m"
2,"LEG PRESS",1,"Rep03",3560,3560,3550,3550,3560,3550,0.003,10,3555,"Rep",0,0,FALSE,FALSE,FALSE,0.28,"young",31,180,105,"m"
2,"LEG PRESS",1,"Rep04",3400,3420,3400,3400,3410,3400,0.003,10,3405,"Rep",-20,0,FALSE,FALSE,FALSE,0.29,"young",31,180,105,"m"
2,"LEG PRESS",1,"Rep05",3160,3180,3150,3150,3170,3150,0.006,20,3160,"Rep",-20,0,FALSE,FALSE,FALSE,0.63,"young",31,180,105,"m"
2,"LEG PRESS",1,"Rep06",3080,3100,3050,3100,3090,3075,0.005,15,3082.5,"Rep",-20,-50,FALSE,FALSE,FALSE,0.49,"young",31,180,105,"m"
2,"LEG PRESS",1,"Rep07",2980,2980,3000,3000,2980,3000,0.007,-20,2990,"Rep",0,0,FALSE,FALSE,FALSE,0.67,"young",31,180,105,"m"
2,"LEG PRESS",1,"Rep08",3040,3020,3050,3050,3030,3050,0.007,-20,3040,"Rep",20,0,FALSE,FALSE,FALSE,0.66,"young",31,180,105,"m"
2,"LEG PRESS",1,"Rep09",3180,3220,3150,3150,3200,3150,0.016,50,3175,"Rep",-40,0,FALSE,FALSE,FALSE,1.59,"young",31,180,105,"m"
2,"LEG PRESS",1,"Rep10",3460,3340,3600,3550,3400,3575,0.051,-175,3487.5,"Rep",120,50,TRUE,TRUE,FALSE,4.9,"young",31,180,105,"m"
2,"LEG PRESS",2,"Rep01",4440,4420,4550,4550,4430,4550,0.027,-120,4490,"Rep",20,0,TRUE,FALSE,FALSE,2.64,"young",31,180,105,"m"
2,"LEG PRESS",2,"Rep02",3660,3680,3700,3700,3670,3700,0.008,-30,3685,"Rep",-20,0,FALSE,FALSE,FALSE,0.81,"young",31,180,105,"m"
2,"LEG PRESS",2,"Rep03",3500,3520,3500,3450,3510,3475,0.01,35,3492.5,"Rep",-20,50,FALSE,FALSE,FALSE,1.01,"young",31,180,105,"m"
2,"LEG PRESS",2,"Rep04",3680,3640,3650,3650,3660,3650,0.003,10,3655,"Rep",40,0,FALSE,FALSE,FALSE,0.27,"young",31,180,105,"m"
2,"LEG PRESS",2,"Rep05",3680,3720,3650,3750,3700,3700,0,0,3700,"Rep",-40,-100,FALSE,FALSE,TRUE,0,"young",31,180,105,"m"
2,"LEG PRESS",2,"Rep06",3500,3460,3500,3450,3480,3475,0.001,5,3477.5,"Rep",40,50,FALSE,FALSE,FALSE,0.14,"young",31,180,105,"m"
2,"LEG PRESS",2,"Rep07",3600,3600,3600,3600,3600,3600,0,0,3600,"Rep",0,0,FALSE,FALSE,FALSE,0,"young",31,180,105,"m"
2,"LEG PRESS",2,"Rep08",3460,3460,3450,3450,3460,3450,0.003,10,3455,"Rep",0,0,FALSE,FALSE,FALSE,0.29,"young",31,180,105,"m"
2,"LEG PRESS",2,"Rep09",3340,3380,3400,3350,3360,3375,0.004,-15,3367.5,"Rep",-40,50,FALSE,FALSE,FALSE,0.44,"young",31,180,105,"m"
2,"LEG PRESS",2,"Rep10",3900,3920,4350,4400,3910,4375,0.119,-465,4142.5,"Rep",-20,-50,TRUE,FALSE,FALSE,10.63,"young",31,180,105,"m"
2,"LEG PRESS",1,"TuT",33560,33520,33850,33750,33540,33800,0.008,-260,33670,"TuT",40,100,FALSE,FALSE,FALSE,0.77,"young",31,180,105,"m"
2,"LEG PRESS",2,"TuT",36760,36800,37350,37350,36780,37350,0.015,-570,37065,"TuT",-40,0,FALSE,FALSE,FALSE,1.53,"young",31,180,105,"m"
2,"LEG EXTENSION",1,"Con01",1120,1140,1300,1250,1130,1275,0.128,-145,1202.5,"Con",-20,50,FALSE,FALSE,FALSE,11.37,"young",31,180,105,"m"
2,"LEG EXTENSION",1,"Con02",1060,940,900,950,1000,925,0.075,75,962.5,"Con",120,-50,FALSE,TRUE,FALSE,8.11,"young",31,180,105,"m"
2,"LEG EXTENSION",1,"Con03",960,1000,1000,1050,980,1025,0.046,-45,1002.5,"Con",-40,-50,FALSE,TRUE,FALSE,4.39,"young",31,180,105,"m"
2,"LEG EXTENSION",1,"Con04",940,980,1500,950,960,1225,0.276,-265,1092.5,"Con",-40,550,TRUE,TRUE,TRUE,21.63,"young",31,180,105,"m"
2,"LEG EXTENSION",1,"Con05",980,980,1850,1050,980,1450,0.48,-470,1215,"Con",0,800,TRUE,FALSE,TRUE,32.41,"young",31,180,105,"m"
2,"LEG EXTENSION",1,"Con06",1000,1060,1200,1200,1030,1200,0.165,-170,1115,"Con",-60,0,FALSE,TRUE,FALSE,14.17,"young",31,180,105,"m"
2,"LEG EXTENSION",1,"Con07",980,1020,2100,1950,1000,2025,1.025,-1025,1512.5,"Con",-40,150,TRUE,TRUE,FALSE,50.62,"young",31,180,105,"m"
2,"LEG EXTENSION",1,"Con08",900,940,1150,1300,920,1225,0.332,-305,1072.5,"Con",-40,-150,TRUE,TRUE,FALSE,24.9,"young",31,180,105,"m"
2,"LEG EXTENSION",1,"Con09",940,940,1000,1250,940,1125,0.197,-185,1032.5,"Con",0,-250,TRUE,FALSE,TRUE,16.44,"young",31,180,105,"m"
2,"LEG EXTENSION",1,"Con10",940,940,1100,1600,940,1350,0.436,-410,1145,"Con",0,-500,TRUE,FALSE,TRUE,30.37,"young",31,180,105,"m"
2,"LEG EXTENSION",2,"Con01",1080,1140,1350,1250,1110,1300,0.171,-190,1205,"Con",-60,100,TRUE,TRUE,FALSE,14.62,"young",31,180,105,"m"
2,"LEG EXTENSION",2,"Con02",920,960,1050,1050,940,1050,0.117,-110,995,"Con",-40,0,FALSE,TRUE,FALSE,10.48,"young",31,180,105,"m"
2,"LEG EXTENSION",2,"Con03",880,900,1150,1150,890,1150,0.292,-260,1020,"Con",-20,0,TRUE,FALSE,FALSE,22.61,"young",31,180,105,"m"
2,"LEG EXTENSION",2,"Con04",980,1020,1250,1000,1000,1125,0.125,-125,1062.5,"Con",-40,250,FALSE,TRUE,TRUE,11.11,"young",31,180,105,"m"
2,"LEG EXTENSION",2,"Con05",900,920,1050,1100,910,1075,0.181,-165,992.5,"Con",-20,-50,FALSE,FALSE,FALSE,15.35,"young",31,180,105,"m"
2,"LEG EXTENSION",2,"Con06",900,900,1000,1000,900,1000,0.111,-100,950,"Con",0,0,FALSE,FALSE,FALSE,10,"young",31,180,105,"m"
2,"LEG EXTENSION",2,"Con07",880,900,1000,1000,890,1000,0.124,-110,945,"Con",-20,0,FALSE,FALSE,FALSE,11,"young",31,180,105,"m"
2,"LEG EXTENSION",2,"Con08",860,880,1000,950,870,975,0.121,-105,922.5,"Con",-20,50,FALSE,FALSE,FALSE,10.77,"young",31,180,105,"m"
2,"LEG EXTENSION",2,"Con09",920,880,1050,1050,900,1050,0.167,-150,975,"Con",40,0,FALSE,TRUE,FALSE,14.29,"young",31,180,105,"m"
2,"LEG EXTENSION",2,"Con10",980,960,1250,1300,970,1275,0.314,-305,1122.5,"Con",20,-50,TRUE,FALSE,FALSE,23.92,"young",31,180,105,"m"
2,"LEG EXTENSION",1,"Ecc01",3340,3480,3500,3500,3410,3500,0.026,-90,3455,"Ecc",-140,0,FALSE,TRUE,FALSE,2.57,"young",31,180,105,"m"
2,"LEG EXTENSION",1,"Ecc02",3320,3260,3300,3250,3290,3275,0.005,15,3282.5,"Ecc",60,50,FALSE,TRUE,FALSE,0.46,"young",31,180,105,"m"
2,"LEG EXTENSION",1,"Ecc03",3300,3280,2800,3250,3290,3025,0.081,265,3157.5,"Ecc",20,-450,TRUE,FALSE,TRUE,8.76,"young",31,180,105,"m"
2,"LEG EXTENSION",1,"Ecc04",3520,3500,2600,3450,3510,3025,0.138,485,3267.5,"Ecc",20,-850,TRUE,FALSE,TRUE,16.03,"young",31,180,105,"m"
2,"LEG EXTENSION",1,"Ecc05",3120,3060,2950,2950,3090,2950,0.045,140,3020,"Ecc",60,0,FALSE,TRUE,FALSE,4.75,"young",31,180,105,"m"
2,"LEG EXTENSION",1,"Ecc06",3500,3460,2350,2600,3480,2475,0.289,1005,2977.5,"Ecc",40,-250,TRUE,TRUE,TRUE,40.61,"young",31,180,105,"m"
2,"LEG EXTENSION",1,"Ecc07",2780,2740,2550,2350,2760,2450,0.112,310,2605,"Ecc",40,200,TRUE,TRUE,TRUE,12.65,"young",31,180,105,"m"
2,"LEG EXTENSION",1,"Ecc08",2620,2600,2500,2300,2610,2400,0.08,210,2505,"Ecc",20,200,TRUE,FALSE,TRUE,8.75,"young",31,180,105,"m"
2,"LEG EXTENSION",1,"Ecc09",2580,2600,2450,1900,2590,2175,0.16,415,2382.5,"Ecc",-20,550,TRUE,FALSE,TRUE,19.08,"young",31,180,105,"m"
2,"LEG EXTENSION",1,"Ecc10",2300,2300,2250,2350,2300,2300,0,0,2300,"Ecc",0,-100,FALSE,FALSE,FALSE,0,"young",31,180,105,"m"
2,"LEG EXTENSION",2,"Ecc01",2940,2900,2800,2800,2920,2800,0.041,120,2860,"Ecc",40,0,FALSE,TRUE,FALSE,4.29,"young",31,180,105,"m"
2,"LEG EXTENSION",2,"Ecc02",2120,2080,1850,1850,2100,1850,0.119,250,1975,"Ecc",40,0,TRUE,TRUE,FALSE,13.51,"young",31,180,105,"m"
2,"LEG EXTENSION",2,"Ecc03",2040,2020,1750,2000,2030,1875,0.076,155,1952.5,"Ecc",20,-250,FALSE,FALSE,TRUE,8.27,"young",31,180,105,"m"
2,"LEG EXTENSION",2,"Ecc04",2300,2280,2100,2100,2290,2100,0.083,190,2195,"Ecc",20,0,TRUE,FALSE,FALSE,9.05,"young",31,180,105,"m"
2,"LEG EXTENSION",2,"Ecc05",2080,2060,2000,1950,2070,1975,0.046,95,2022.5,"Ecc",20,50,FALSE,FALSE,FALSE,4.81,"young",31,180,105,"m"
2,"LEG EXTENSION",2,"Ecc06",2800,2800,2700,2700,2800,2700,0.036,100,2750,"Ecc",0,0,FALSE,FALSE,FALSE,3.7,"young",31,180,105,"m"
2,"LEG EXTENSION",2,"Ecc07",2520,2500,2350,2400,2510,2375,0.054,135,2442.5,"Ecc",20,-50,FALSE,FALSE,FALSE,5.68,"young",31,180,105,"m"
2,"LEG EXTENSION",2,"Ecc08",2460,2480,2350,2350,2470,2350,0.049,120,2410,"Ecc",-20,0,FALSE,FALSE,FALSE,5.11,"young",31,180,105,"m"
2,"LEG EXTENSION",2,"Ecc09",2220,2240,1950,1950,2230,1950,0.126,280,2090,"Ecc",-20,0,TRUE,FALSE,FALSE,14.36,"young",31,180,105,"m"
2,"LEG EXTENSION",2,"Ecc10",2720,2740,2950,2700,2730,2825,0.035,-95,2777.5,"Ecc",-20,250,FALSE,FALSE,TRUE,3.36,"young",31,180,105,"m"
2,"LEG EXTENSION",1,"Rep01",4460,4620,4800,4750,4540,4775,0.052,-235,4657.5,"Rep",-160,50,TRUE,TRUE,FALSE,4.92,"young",31,180,105,"m"
2,"LEG EXTENSION",1,"Rep02",4380,4200,4200,4200,4290,4200,0.021,90,4245,"Rep",180,0,FALSE,TRUE,FALSE,2.14,"young",31,180,105,"m"
2,"LEG EXTENSION",1,"Rep03",4260,4280,3800,4300,4270,4050,0.052,220,4160,"Rep",-20,-500,TRUE,FALSE,TRUE,5.43,"young",31,180,105,"m"
2,"LEG EXTENSION",1,"Rep04",4460,4480,4100,4400,4470,4250,0.049,220,4360,"Rep",-20,-300,TRUE,FALSE,TRUE,5.18,"young",31,180,105,"m"
2,"LEG EXTENSION",1,"Rep05",4100,4040,4800,4000,4070,4400,0.081,-330,4235,"Rep",60,800,TRUE,FALSE,TRUE,7.5,"young",31,180,105,"m"
2,"LEG EXTENSION",1,"Rep06",4500,4520,3550,3800,4510,3675,0.185,835,4092.5,"Rep",-20,-250,TRUE,FALSE,TRUE,22.72,"young",31,180,105,"m"
2,"LEG EXTENSION",1,"Rep07",3760,3760,4650,4300,3760,4475,0.19,-715,4117.5,"Rep",0,350,TRUE,FALSE,TRUE,15.98,"young",31,180,105,"m"
2,"LEG EXTENSION",1,"Rep08",3520,3540,3650,3600,3530,3625,0.027,-95,3577.5,"Rep",-20,50,FALSE,FALSE,FALSE,2.62,"young",31,180,105,"m"
2,"LEG EXTENSION",1,"Rep09",3520,3540,3450,3150,3530,3300,0.065,230,3415,"Rep",-20,300,TRUE,FALSE,TRUE,6.97,"young",31,180,105,"m"
2,"LEG EXTENSION",1,"Rep10",3240,3240,3350,3950,3240,3650,0.127,-410,3445,"Rep",0,-600,TRUE,FALSE,TRUE,11.23,"young",31,180,105,"m"
2,"LEG EXTENSION",2,"Rep01",4020,4040,4150,4050,4030,4100,0.017,-70,4065,"Rep",-20,100,FALSE,FALSE,FALSE,1.71,"young",31,180,105,"m"
2,"LEG EXTENSION",2,"Rep02",3040,3040,2900,2900,3040,2900,0.046,140,2970,"Rep",0,0,TRUE,FALSE,FALSE,4.83,"young",31,180,105,"m"
2,"LEG EXTENSION",2,"Rep03",2920,2920,2900,3150,2920,3025,0.036,-105,2972.5,"Rep",0,-250,FALSE,FALSE,TRUE,3.47,"young",31,180,105,"m"
2,"LEG EXTENSION",2,"Rep04",3280,3300,3350,3100,3290,3225,0.02,65,3257.5,"Rep",-20,250,FALSE,FALSE,TRUE,2.02,"young",31,180,105,"m"
2,"LEG EXTENSION",2,"Rep05",2980,2980,3050,3050,2980,3050,0.023,-70,3015,"Rep",0,0,FALSE,FALSE,FALSE,2.3,"young",31,180,105,"m"
2,"LEG EXTENSION",2,"Rep06",3700,3700,3700,3700,3700,3700,0,0,3700,"Rep",0,0,FALSE,FALSE,FALSE,0,"young",31,180,105,"m"
2,"LEG EXTENSION",2,"Rep07",3400,3400,3350,3400,3400,3375,0.007,25,3387.5,"Rep",0,-50,FALSE,FALSE,FALSE,0.74,"young",31,180,105,"m"
2,"LEG EXTENSION",2,"Rep08",3320,3360,3350,3300,3340,3325,0.004,15,3332.5,"Rep",-40,50,FALSE,FALSE,FALSE,0.45,"young",31,180,105,"m"
2,"LEG EXTENSION",2,"Rep09",3140,3120,3000,3000,3130,3000,0.042,130,3065,"Rep",20,0,TRUE,FALSE,FALSE,4.33,"young",31,180,105,"m"
2,"LEG EXTENSION",2,"Rep10",3700,3700,4200,4000,3700,4100,0.108,-400,3900,"Rep",0,200,TRUE,FALSE,TRUE,9.76,"young",31,180,105,"m"
2,"LEG EXTENSION",1,"TuT",40200,40220,40350,40450,40210,40400,0.005,-190,40305,"TuT",-20,-100,TRUE,FALSE,FALSE,0.47,"young",31,180,105,"m"
2,"LEG EXTENSION",2,"TuT",33500,33560,33950,33650,33530,33800,0.008,-270,33665,"TuT",-60,300,TRUE,FALSE,TRUE,0.8,"young",31,180,105,"m"
2,"LEG CURL",1,"Con01",2220,2220,1750,2400,2220,2075,0.065,145,2147.5,"Con",0,-650,FALSE,FALSE,TRUE,6.99,"young",31,180,105,"m"
2,"LEG CURL",1,"Con02",1640,1620,1650,1550,1630,1600,0.018,30,1615,"Con",20,100,FALSE,FALSE,FALSE,1.88,"young",31,180,105,"m"
2,"LEG CURL",1,"Con03",1640,1640,1650,1500,1640,1575,0.04,65,1607.5,"Con",0,150,FALSE,FALSE,FALSE,4.13,"young",31,180,105,"m"
2,"LEG CURL",1,"Con04",1480,1460,1550,1350,1470,1450,0.014,20,1460,"Con",20,200,FALSE,FALSE,TRUE,1.38,"young",31,180,105,"m"
2,"LEG CURL",1,"Con05",1640,1680,1800,1550,1660,1675,0.009,-15,1667.5,"Con",-40,250,FALSE,FALSE,TRUE,0.9,"young",31,180,105,"m"
2,"LEG CURL",1,"Con06",1620,1620,1750,1650,1620,1700,0.049,-80,1660,"Con",0,100,FALSE,FALSE,FALSE,4.71,"young",31,180,105,"m"
2,"LEG CURL",1,"Con07",1460,1440,1500,1600,1450,1550,0.069,-100,1500,"Con",20,-100,FALSE,FALSE,FALSE,6.45,"young",31,180,105,"m"
2,"LEG CURL",1,"Con08",1500,1500,1500,1700,1500,1600,0.067,-100,1550,"Con",0,-200,FALSE,FALSE,TRUE,6.25,"young",31,180,105,"m"
2,"LEG CURL",1,"Con09",1520,1560,1600,1750,1540,1675,0.088,-135,1607.5,"Con",-40,-150,FALSE,FALSE,FALSE,8.06,"young",31,180,105,"m"
2,"LEG CURL",1,"Con10",1600,1620,1650,1950,1610,1800,0.118,-190,1705,"Con",-20,-300,FALSE,FALSE,TRUE,10.56,"young",31,180,105,"m"
2,"LEG CURL",2,"Con01",2220,2200,1950,1550,2210,1750,0.208,460,1980,"Con",20,400,TRUE,FALSE,TRUE,26.29,"young",31,180,105,"m"
2,"LEG CURL",2,"Con02",1620,1600,1550,1550,1610,1550,0.037,60,1580,"Con",20,0,FALSE,FALSE,FALSE,3.87,"young",31,180,105,"m"
2,"LEG CURL",2,"Con03",1660,1660,1600,1600,1660,1600,0.036,60,1630,"Con",0,0,FALSE,FALSE,FALSE,3.75,"young",31,180,105,"m"
2,"LEG CURL",2,"Con04",1480,1540,1500,1450,1510,1475,0.023,35,1492.5,"Con",-60,50,FALSE,FALSE,FALSE,2.37,"young",31,180,105,"m"
2,"LEG CURL",2,"Con05",1400,1400,1350,1500,1400,1425,0.018,-25,1412.5,"Con",0,-150,FALSE,FALSE,FALSE,1.75,"young",31,180,105,"m"
2,"LEG CURL",2,"Con06",1480,1500,1450,1450,1490,1450,0.027,40,1470,"Con",-20,0,FALSE,FALSE,FALSE,2.76,"young",31,180,105,"m"
2,"LEG CURL",2,"Con07",1360,1360,1550,1400,1360,1475,0.085,-115,1417.5,"Con",0,150,FALSE,FALSE,FALSE,7.8,"young",31,180,105,"m"
2,"LEG CURL",2,"Con08",1360,1340,1450,1400,1350,1425,0.056,-75,1387.5,"Con",20,50,FALSE,FALSE,FALSE,5.26,"young",31,180,105,"m"
2,"LEG CURL",2,"Con09",1480,1480,1600,1550,1480,1575,0.064,-95,1527.5,"Con",0,50,FALSE,FALSE,FALSE,6.03,"young",31,180,105,"m"
2,"LEG CURL",2,"Con10",1480,1500,1700,1800,1490,1750,0.174,-260,1620,"Con",-20,-100,TRUE,FALSE,FALSE,14.86,"young",31,180,105,"m"
2,"LEG CURL",1,"Ecc01",3360,3380,3300,3450,3370,3375,0.001,-5,3372.5,"Ecc",-20,-150,FALSE,FALSE,FALSE,0.15,"young",31,180,105,"m"
2,"LEG CURL",1,"Ecc02",2760,2760,2700,2850,2760,2775,0.005,-15,2767.5,"Ecc",0,-150,FALSE,FALSE,FALSE,0.54,"young",31,180,105,"m"
2,"LEG CURL",1,"Ecc03",2620,2620,2650,2750,2620,2700,0.031,-80,2660,"Ecc",0,-100,FALSE,FALSE,FALSE,2.96,"young",31,180,105,"m"
2,"LEG CURL",1,"Ecc04",2640,2640,2450,2750,2640,2600,0.015,40,2620,"Ecc",0,-300,FALSE,FALSE,TRUE,1.54,"young",31,180,105,"m"
2,"LEG CURL",1,"Ecc05",2540,2520,2400,2600,2530,2500,0.012,30,2515,"Ecc",20,-200,FALSE,FALSE,TRUE,1.2,"young",31,180,105,"m"
2,"LEG CURL",1,"Ecc06",2520,2520,2450,2400,2520,2425,0.038,95,2472.5,"Ecc",0,50,FALSE,FALSE,FALSE,3.92,"young",31,180,105,"m"
2,"LEG CURL",1,"Ecc07",2560,2580,2550,2400,2570,2475,0.037,95,2522.5,"Ecc",-20,150,FALSE,FALSE,FALSE,3.84,"young",31,180,105,"m"
2,"LEG CURL",1,"Ecc08",2340,2300,2300,2100,2320,2200,0.052,120,2260,"Ecc",40,200,FALSE,FALSE,TRUE,5.45,"young",31,180,105,"m"
2,"LEG CURL",1,"Ecc09",2320,2300,2250,2000,2310,2125,0.08,185,2217.5,"Ecc",20,250,FALSE,FALSE,TRUE,8.71,"young",31,180,105,"m"
2,"LEG CURL",1,"Ecc10",3100,3120,3150,3000,3110,3075,0.011,35,3092.5,"Ecc",-20,150,FALSE,FALSE,FALSE,1.14,"young",31,180,105,"m"
2,"LEG CURL",2,"Ecc01",3220,3220,3250,3250,3220,3250,0.009,-30,3235,"Ecc",0,0,FALSE,FALSE,FALSE,0.92,"young",31,180,105,"m"
2,"LEG CURL",2,"Ecc02",2740,2760,2850,2800,2750,2825,0.027,-75,2787.5,"Ecc",-20,50,FALSE,FALSE,FALSE,2.65,"young",31,180,105,"m"
2,"LEG CURL",2,"Ecc03",2600,2580,2600,2650,2590,2625,0.014,-35,2607.5,"Ecc",20,-50,FALSE,FALSE,FALSE,1.33,"young",31,180,105,"m"
2,"LEG CURL",2,"Ecc04",2260,2220,2300,2250,2240,2275,0.016,-35,2257.5,"Ecc",40,50,FALSE,FALSE,FALSE,1.54,"young",31,180,105,"m"
2,"LEG CURL",2,"Ecc05",2120,2120,2250,2150,2120,2200,0.038,-80,2160,"Ecc",0,100,FALSE,FALSE,FALSE,3.64,"young",31,180,105,"m"
2,"LEG CURL",2,"Ecc06",2260,2220,2050,2200,2240,2125,0.051,115,2182.5,"Ecc",40,-150,FALSE,FALSE,FALSE,5.41,"young",31,180,105,"m"
2,"LEG CURL",2,"Ecc07",2060,2100,1950,2000,2080,1975,0.05,105,2027.5,"Ecc",-40,-50,FALSE,FALSE,FALSE,5.32,"young",31,180,105,"m"
2,"LEG CURL",2,"Ecc08",2000,1980,1850,1950,1990,1900,0.045,90,1945,"Ecc",20,-100,FALSE,FALSE,FALSE,4.74,"young",31,180,105,"m"
2,"LEG CURL",2,"Ecc09",2140,2160,2000,1950,2150,1975,0.081,175,2062.5,"Ecc",-20,50,FALSE,FALSE,FALSE,8.86,"young",31,180,105,"m"
2,"LEG CURL",2,"Ecc10",2920,2960,2850,2850,2940,2850,0.031,90,2895,"Ecc",-40,0,FALSE,FALSE,FALSE,3.16,"young",31,180,105,"m"
2,"LEG CURL",1,"Rep01",5580,5600,5050,5850,5590,5450,0.025,140,5520,"Rep",-20,-800,FALSE,FALSE,TRUE,2.57,"young",31,180,105,"m"
2,"LEG CURL",1,"Rep02",4400,4380,4350,4400,4390,4375,0.003,15,4382.5,"Rep",20,-50,FALSE,FALSE,FALSE,0.34,"young",31,180,105,"m"
2,"LEG CURL",1,"Rep03",4260,4260,4300,4250,4260,4275,0.004,-15,4267.5,"Rep",0,50,FALSE,FALSE,FALSE,0.35,"young",31,180,105,"m"
2,"LEG CURL",1,"Rep04",4120,4100,4000,4100,4110,4050,0.015,60,4080,"Rep",20,-100,FALSE,FALSE,FALSE,1.48,"young",31,180,105,"m"
2,"LEG CURL",1,"Rep05",4180,4200,4200,4150,4190,4175,0.004,15,4182.5,"Rep",-20,50,FALSE,FALSE,FALSE,0.36,"young",31,180,105,"m"
2,"LEG CURL",1,"Rep06",4140,4140,4200,4050,4140,4125,0.004,15,4132.5,"Rep",0,150,FALSE,FALSE,FALSE,0.36,"young",31,180,105,"m"
2,"LEG CURL",1,"Rep07",4020,4020,4050,4000,4020,4025,0.001,-5,4022.5,"Rep",0,50,FALSE,FALSE,FALSE,0.12,"young",31,180,105,"m"
2,"LEG CURL",1,"Rep08",3840,3800,3800,3800,3820,3800,0.005,20,3810,"Rep",40,0,FALSE,FALSE,FALSE,0.53,"young",31,180,105,"m"
2,"LEG CURL",1,"Rep09",3840,3860,3850,3750,3850,3800,0.013,50,3825,"Rep",-20,100,FALSE,FALSE,FALSE,1.32,"young",31,180,105,"m"
2,"LEG CURL",1,"Rep10",4700,4740,4800,4950,4720,4875,0.033,-155,4797.5,"Rep",-40,-150,FALSE,FALSE,FALSE,3.18,"young",31,180,105,"m"
2,"LEG CURL",2,"Rep01",5440,5420,5200,4800,5430,5000,0.079,430,5215,"Rep",20,400,TRUE,FALSE,TRUE,8.6,"young",31,180,105,"m"
2,"LEG CURL",2,"Rep02",4360,4360,4400,4350,4360,4375,0.003,-15,4367.5,"Rep",0,50,FALSE,FALSE,FALSE,0.34,"young",31,180,105,"m"
2,"LEG CURL",2,"Rep03",4260,4240,4200,4250,4250,4225,0.006,25,4237.5,"Rep",20,-50,FALSE,FALSE,FALSE,0.59,"young",31,180,105,"m"
2,"LEG CURL",2,"Rep04",3740,3760,3800,3700,3750,3750,0,0,3750,"Rep",-20,100,FALSE,FALSE,FALSE,0,"young",31,180,105,"m"
2,"LEG CURL",2,"Rep05",3520,3520,3600,3650,3520,3625,0.03,-105,3572.5,"Rep",0,-50,FALSE,FALSE,FALSE,2.9,"young",31,180,105,"m"
2,"LEG CURL",2,"Rep06",3740,3720,3500,3650,3730,3575,0.042,155,3652.5,"Rep",20,-150,FALSE,FALSE,FALSE,4.34,"young",31,180,105,"m"
2,"LEG CURL",2,"Rep07",3420,3460,3500,3400,3440,3450,0.003,-10,3445,"Rep",-40,100,FALSE,FALSE,FALSE,0.29,"young",31,180,105,"m"
2,"LEG CURL",2,"Rep08",3360,3320,3300,3350,3340,3325,0.004,15,3332.5,"Rep",40,-50,FALSE,FALSE,FALSE,0.45,"young",31,180,105,"m"
2,"LEG CURL",2,"Rep09",3620,3640,3600,3500,3630,3550,0.022,80,3590,"Rep",-20,100,FALSE,FALSE,FALSE,2.25,"young",31,180,105,"m"
2,"LEG CURL",2,"Rep10",4400,4460,4550,4650,4430,4600,0.038,-170,4515,"Rep",-60,-100,TRUE,FALSE,FALSE,3.7,"young",31,180,105,"m"
2,"LEG CURL",1,"TuT",43080,43100,42600,43300,43090,42950,0.003,140,43020,"TuT",-20,-700,FALSE,FALSE,TRUE,0.33,"young",31,180,105,"m"
2,"LEG CURL",2,"TuT",39860,39900,39650,39300,39880,39475,0.01,405,39677.5,"TuT",-40,350,TRUE,TRUE,TRUE,1.03,"young",31,180,105,"m"
2,"ABDUCTOR",1,"Con01",1100,1100,1300,1400,1100,1350,0.227,-250,1225,"Con",0,-100,FALSE,FALSE,FALSE,18.52,"young",31,180,105,"m"
2,"ABDUCTOR",1,"Con02",1240,1240,1200,1300,1240,1250,0.008,-10,1245,"Con",0,-100,FALSE,FALSE,FALSE,0.8,"young",31,180,105,"m"
2,"ABDUCTOR",1,"Con03",1040,1040,1100,1150,1040,1125,0.082,-85,1082.5,"Con",0,-50,FALSE,FALSE,FALSE,7.56,"young",31,180,105,"m"
2,"ABDUCTOR",1,"Con04",1220,1220,1400,1200,1220,1300,0.066,-80,1260,"Con",0,200,FALSE,FALSE,FALSE,6.15,"young",31,180,105,"m"
2,"ABDUCTOR",1,"Con05",1120,1120,1450,1250,1120,1350,0.205,-230,1235,"Con",0,200,FALSE,FALSE,FALSE,17.04,"young",31,180,105,"m"
2,"ABDUCTOR",1,"Con06",1100,1120,1200,1200,1110,1200,0.081,-90,1155,"Con",-20,0,FALSE,FALSE,FALSE,7.5,"young",31,180,105,"m"
2,"ABDUCTOR",1,"Con07",1120,1100,1100,1100,1110,1100,0.009,10,1105,"Con",20,0,FALSE,FALSE,FALSE,0.91,"young",31,180,105,"m"
2,"ABDUCTOR",1,"Con08",1020,980,1100,1150,1000,1125,0.125,-125,1062.5,"Con",40,-50,FALSE,TRUE,FALSE,11.11,"young",31,180,105,"m"
2,"ABDUCTOR",1,"Con09",1100,1100,1350,1300,1100,1325,0.205,-225,1212.5,"Con",0,50,FALSE,FALSE,FALSE,16.98,"young",31,180,105,"m"
2,"ABDUCTOR",1,"Con10",1100,1060,1300,1350,1080,1325,0.227,-245,1202.5,"Con",40,-50,FALSE,TRUE,FALSE,18.49,"young",31,180,105,"m"
2,"ABDUCTOR",2,"Con01",960,960,4400,1350,960,2875,1.995,-1915,1917.5,"Con",0,3050,TRUE,FALSE,TRUE,66.61,"young",31,180,105,"m"
2,"ABDUCTOR",2,"Con02",980,1020,1300,1150,1000,1225,0.225,-225,1112.5,"Con",-40,150,FALSE,TRUE,FALSE,18.37,"young",31,180,105,"m"
2,"ABDUCTOR",2,"Con03",1060,1020,1050,1200,1040,1125,0.082,-85,1082.5,"Con",40,-150,FALSE,TRUE,FALSE,7.56,"young",31,180,105,"m"
2,"ABDUCTOR",2,"Con04",1060,1100,1050,1300,1080,1175,0.088,-95,1127.5,"Con",-40,-250,FALSE,TRUE,TRUE,8.09,"young",31,180,105,"m"
2,"ABDUCTOR",2,"Con05",1000,980,950,1000,990,975,0.015,15,982.5,"Con",20,-50,FALSE,FALSE,FALSE,1.54,"young",31,180,105,"m"
2,"ABDUCTOR",2,"Con06",1100,1120,1300,1100,1110,1200,0.081,-90,1155,"Con",-20,200,FALSE,FALSE,FALSE,7.5,"young",31,180,105,"m"
2,"ABDUCTOR",2,"Con07",1140,1140,1200,1100,1140,1150,0.009,-10,1145,"Con",0,100,FALSE,FALSE,FALSE,0.87,"young",31,180,105,"m"
2,"ABDUCTOR",2,"Con08",1100,1100,1200,1200,1100,1200,0.091,-100,1150,"Con",0,0,FALSE,FALSE,FALSE,8.33,"young",31,180,105,"m"
2,"ABDUCTOR",2,"Con09",1080,1060,1300,1350,1070,1325,0.238,-255,1197.5,"Con",20,-50,FALSE,FALSE,FALSE,19.25,"young",31,180,105,"m"
2,"ABDUCTOR",2,"Con10",1100,1060,1600,1250,1080,1425,0.319,-345,1252.5,"Con",40,350,TRUE,TRUE,TRUE,24.21,"young",31,180,105,"m"
2,"ABDUCTOR",1,"Ecc01",3620,3600,3650,3450,3610,3550,0.017,60,3580,"Ecc",20,200,FALSE,FALSE,FALSE,1.69,"young",31,180,105,"m"
2,"ABDUCTOR",1,"Ecc02",2700,2740,2650,2650,2720,2650,0.026,70,2685,"Ecc",-40,0,FALSE,TRUE,FALSE,2.64,"young",31,180,105,"m"
2,"ABDUCTOR",1,"Ecc03",2040,2020,2000,2000,2030,2000,0.015,30,2015,"Ecc",20,0,FALSE,FALSE,FALSE,1.5,"young",31,180,105,"m"
2,"ABDUCTOR",1,"Ecc04",2160,2160,1800,2100,2160,1950,0.097,210,2055,"Ecc",0,-300,FALSE,FALSE,FALSE,10.77,"young",31,180,105,"m"
2,"ABDUCTOR",1,"Ecc05",2140,2160,1950,2000,2150,1975,0.081,175,2062.5,"Ecc",-20,-50,FALSE,FALSE,FALSE,8.86,"young",31,180,105,"m"
2,"ABDUCTOR",1,"Ecc06",2020,2040,2000,2000,2030,2000,0.015,30,2015,"Ecc",-20,0,FALSE,FALSE,FALSE,1.5,"young",31,180,105,"m"
2,"ABDUCTOR",1,"Ecc07",2060,2060,2050,1950,2060,2000,0.029,60,2030,"Ecc",0,100,FALSE,FALSE,FALSE,3,"young",31,180,105,"m"
2,"ABDUCTOR",1,"Ecc08",1760,1780,1550,1650,1770,1600,0.096,170,1685,"Ecc",-20,-100,FALSE,FALSE,FALSE,10.62,"young",31,180,105,"m"
2,"ABDUCTOR",1,"Ecc09",1920,1960,1750,1700,1940,1725,0.111,215,1832.5,"Ecc",-40,50,FALSE,TRUE,FALSE,12.46,"young",31,180,105,"m"
2,"ABDUCTOR",1,"Ecc10",2920,2920,3850,3750,2920,3800,0.301,-880,3360,"Ecc",0,100,TRUE,FALSE,FALSE,23.16,"young",31,180,105,"m"
2,"ABDUCTOR",2,"Ecc01",2400,2360,2000,2250,2380,2125,0.107,255,2252.5,"Ecc",40,-250,FALSE,TRUE,FALSE,12,"young",31,180,105,"m"
2,"ABDUCTOR",2,"Ecc02",2100,2120,2050,1900,2110,1975,0.064,135,2042.5,"Ecc",-20,150,FALSE,FALSE,FALSE,6.84,"young",31,180,105,"m"
2,"ABDUCTOR",2,"Ecc03",2080,2060,2050,1800,2070,1925,0.07,145,1997.5,"Ecc",20,250,FALSE,FALSE,FALSE,7.53,"young",31,180,105,"m"
2,"ABDUCTOR",2,"Ecc04",1800,1800,1850,1750,1800,1800,0,0,1800,"Ecc",0,100,FALSE,FALSE,FALSE,0,"young",31,180,105,"m"
2,"ABDUCTOR",2,"Ecc05",1840,1820,1700,1850,1830,1775,0.03,55,1802.5,"Ecc",20,-150,FALSE,FALSE,FALSE,3.1,"young",31,180,105,"m"
2,"ABDUCTOR",2,"Ecc06",1760,1740,1650,1750,1750,1700,0.029,50,1725,"Ecc",20,-100,FALSE,FALSE,FALSE,2.94,"young",31,180,105,"m"
2,"ABDUCTOR",2,"Ecc07",1800,1820,1750,1800,1810,1775,0.019,35,1792.5,"Ecc",-20,-50,FALSE,FALSE,FALSE,1.97,"young",31,180,105,"m"
2,"ABDUCTOR",2,"Ecc08",1820,1820,1600,1600,1820,1600,0.121,220,1710,"Ecc",0,0,FALSE,FALSE,FALSE,13.75,"young",31,180,105,"m"
2,"ABDUCTOR",2,"Ecc09",1680,1680,1350,1500,1680,1425,0.152,255,1552.5,"Ecc",0,-150,FALSE,FALSE,FALSE,17.89,"young",31,180,105,"m"
2,"ABDUCTOR",2,"Ecc10",2020,2020,1900,1800,2020,1850,0.084,170,1935,"Ecc",0,100,FALSE,FALSE,FALSE,9.19,"young",31,180,105,"m"
2,"ABDUCTOR",1,"Rep01",4720,4700,4950,4850,4710,4900,0.04,-190,4805,"Rep",20,100,FALSE,FALSE,FALSE,3.88,"young",31,180,105,"m"
2,"ABDUCTOR",1,"Rep02",3940,3980,3850,3950,3960,3900,0.015,60,3930,"Rep",-40,-100,FALSE,FALSE,FALSE,1.54,"young",31,180,105,"m"
2,"ABDUCTOR",1,"Rep03",3080,3060,3100,3150,3070,3125,0.018,-55,3097.5,"Rep",20,-50,FALSE,FALSE,FALSE,1.76,"young",31,180,105,"m"
2,"ABDUCTOR",1,"Rep04",3380,3380,3200,3300,3380,3250,0.038,130,3315,"Rep",0,-100,FALSE,FALSE,FALSE,4,"young",31,180,105,"m"
2,"ABDUCTOR",1,"Rep05",3260,3280,3400,3250,3270,3325,0.017,-55,3297.5,"Rep",-20,150,FALSE,FALSE,FALSE,1.65,"young",31,180,105,"m"
2,"ABDUCTOR",1,"Rep06",3120,3160,3200,3200,3140,3200,0.019,-60,3170,"Rep",-40,0,FALSE,FALSE,FALSE,1.88,"young",31,180,105,"m"
2,"ABDUCTOR",1,"Rep07",3180,3160,3150,3050,3170,3100,0.022,70,3135,"Rep",20,100,FALSE,FALSE,FALSE,2.26,"young",31,180,105,"m"
2,"ABDUCTOR",1,"Rep08",2780,2760,2650,2800,2770,2725,0.016,45,2747.5,"Rep",20,-150,FALSE,FALSE,FALSE,1.65,"young",31,180,105,"m"
2,"ABDUCTOR",1,"Rep09",3020,3060,3100,3000,3040,3050,0.003,-10,3045,"Rep",-40,100,FALSE,FALSE,FALSE,0.33,"young",31,180,105,"m"
2,"ABDUCTOR",1,"Rep10",4020,3980,5150,5100,4000,5125,0.281,-1125,4562.5,"Rep",40,50,TRUE,FALSE,FALSE,21.95,"young",31,180,105,"m"
2,"ABDUCTOR",2,"Rep01",3360,3320,6400,3600,3340,5000,0.497,-1660,4170,"Rep",40,2800,TRUE,FALSE,TRUE,33.2,"young",31,180,105,"m"
2,"ABDUCTOR",2,"Rep02",3080,3140,3350,3050,3110,3200,0.029,-90,3155,"Rep",-60,300,FALSE,FALSE,FALSE,2.81,"young",31,180,105,"m"
2,"ABDUCTOR",2,"Rep03",3140,3080,3100,3000,3110,3050,0.019,60,3080,"Rep",60,100,FALSE,FALSE,FALSE,1.97,"young",31,180,105,"m"
2,"ABDUCTOR",2,"Rep04",2860,2900,2900,3050,2880,2975,0.033,-95,2927.5,"Rep",-40,-150,FALSE,FALSE,FALSE,3.19,"young",31,180,105,"m"
2,"ABDUCTOR",2,"Rep05",2840,2800,2650,2850,2820,2750,0.025,70,2785,"Rep",40,-200,FALSE,FALSE,FALSE,2.55,"young",31,180,105,"m"
2,"ABDUCTOR",2,"Rep06",2860,2860,2950,2850,2860,2900,0.014,-40,2880,"Rep",0,100,FALSE,FALSE,FALSE,1.38,"young",31,180,105,"m"
2,"ABDUCTOR",2,"Rep07",2940,2960,2950,2900,2950,2925,0.008,25,2937.5,"Rep",-20,50,FALSE,FALSE,FALSE,0.85,"young",31,180,105,"m"
2,"ABDUCTOR",2,"Rep08",2920,2920,2800,2800,2920,2800,0.041,120,2860,"Rep",0,0,FALSE,FALSE,FALSE,4.29,"young",31,180,105,"m"
2,"ABDUCTOR",2,"Rep09",2760,2740,2650,2850,2750,2750,0,0,2750,"Rep",20,-200,FALSE,FALSE,FALSE,0,"young",31,180,105,"m"
2,"ABDUCTOR",2,"Rep10",3120,3080,3500,3050,3100,3275,0.056,-175,3187.5,"Rep",40,450,FALSE,FALSE,TRUE,5.34,"young",31,180,105,"m"
2,"ABDUCTOR",1,"TuT",34500,34520,35750,35650,34510,35700,0.034,-1190,35105,"TuT",-20,100,TRUE,FALSE,FALSE,3.33,"young",31,180,105,"m"
2,"ABDUCTOR",2,"TuT",29880,29800,33250,30000,29840,31625,0.06,-1785,30732.5,"TuT",80,3250,TRUE,TRUE,TRUE,5.64,"young",31,180,105,"m"
2,"ADDUCTOR",1,"Con01",1300,1300,1600,1750,1300,1675,0.288,-375,1487.5,"Con",0,-150,FALSE,FALSE,FALSE,22.39,"young",31,180,105,"m"
2,"ADDUCTOR",1,"Con02",1200,1220,1200,1350,1210,1275,0.054,-65,1242.5,"Con",-20,-150,FALSE,FALSE,FALSE,5.1,"young",31,180,105,"m"
2,"ADDUCTOR",1,"Con03",1340,1320,1350,1100,1330,1225,0.079,105,1277.5,"Con",20,250,FALSE,FALSE,FALSE,8.57,"young",31,180,105,"m"
2,"ADDUCTOR",1,"Con04",1300,1300,1450,1350,1300,1400,0.077,-100,1350,"Con",0,100,FALSE,FALSE,FALSE,7.14,"young",31,180,105,"m"
2,"ADDUCTOR",1,"Con05",1260,1220,1200,1450,1240,1325,0.069,-85,1282.5,"Con",40,-250,FALSE,TRUE,FALSE,6.42,"young",31,180,105,"m"
2,"ADDUCTOR",1,"Con06",1240,1220,1300,1950,1230,1625,0.321,-395,1427.5,"Con",20,-650,FALSE,FALSE,TRUE,24.31,"young",31,180,105,"m"
2,"ADDUCTOR",1,"Con07",1320,1320,1550,1800,1320,1675,0.269,-355,1497.5,"Con",0,-250,FALSE,FALSE,FALSE,21.19,"young",31,180,105,"m"
2,"ADDUCTOR",1,"Con08",1340,1280,1700,2050,1310,1875,0.431,-565,1592.5,"Con",60,-350,FALSE,TRUE,TRUE,30.13,"young",31,180,105,"m"
2,"ADDUCTOR",1,"Con09",1320,1340,1400,1250,1330,1325,0.004,5,1327.5,"Con",-20,150,FALSE,FALSE,FALSE,0.38,"young",31,180,105,"m"
2,"ADDUCTOR",1,"Con10",1640,1680,2150,1050,1660,1600,0.036,60,1630,"Con",-40,1100,FALSE,TRUE,TRUE,3.75,"young",31,180,105,"m"
2,"ADDUCTOR",2,"Con01",1260,1260,1650,1600,1260,1625,0.29,-365,1442.5,"Con",0,50,FALSE,FALSE,FALSE,22.46,"young",31,180,105,"m"
2,"ADDUCTOR",2,"Con02",1180,1200,1450,2200,1190,1825,0.534,-635,1507.5,"Con",-20,-750,TRUE,FALSE,TRUE,34.79,"young",31,180,105,"m"
2,"ADDUCTOR",2,"Con03",1200,1200,1300,1550,1200,1425,0.188,-225,1312.5,"Con",0,-250,FALSE,FALSE,FALSE,15.79,"young",31,180,105,"m"
2,"ADDUCTOR",2,"Con04",1160,1140,800,900,1150,850,0.261,300,1000,"Con",20,-100,FALSE,FALSE,FALSE,35.29,"young",31,180,105,"m"
2,"ADDUCTOR",2,"Con05",1140,1140,1050,800,1140,925,0.189,215,1032.5,"Con",0,250,FALSE,FALSE,FALSE,23.24,"young",31,180,105,"m"
2,"ADDUCTOR",2,"Con06",1180,1200,1100,1150,1190,1125,0.055,65,1157.5,"Con",-20,-50,FALSE,FALSE,FALSE,5.78,"young",31,180,105,"m"
2,"ADDUCTOR",2,"Con07",1160,1160,1100,1150,1160,1125,0.03,35,1142.5,"Con",0,-50,FALSE,FALSE,FALSE,3.11,"young",31,180,105,"m"
2,"ADDUCTOR",2,"Con08",1240,1220,1450,1300,1230,1375,0.118,-145,1302.5,"Con",20,150,FALSE,FALSE,FALSE,10.55,"young",31,180,105,"m"
2,"ADDUCTOR",2,"Con09",1200,1240,1850,1650,1220,1750,0.434,-530,1485,"Con",-40,200,FALSE,TRUE,FALSE,30.29,"young",31,180,105,"m"
2,"ADDUCTOR",2,"Con10",1500,1520,4100,2050,1510,3075,1.036,-1565,2292.5,"Con",-20,2050,TRUE,FALSE,TRUE,50.89,"young",31,180,105,"m"
2,"ADDUCTOR",1,"Ecc01",1980,1960,2100,1600,1970,1850,0.061,120,1910,"Ecc",20,500,FALSE,FALSE,TRUE,6.49,"young",31,180,105,"m"
2,"ADDUCTOR",1,"Ecc02",2060,2040,2100,2200,2050,2150,0.049,-100,2100,"Ecc",20,-100,FALSE,FALSE,FALSE,4.65,"young",31,180,105,"m"
2,"ADDUCTOR",1,"Ecc03",1800,1840,1650,1950,1820,1800,0.011,20,1810,"Ecc",-40,-300,FALSE,TRUE,FALSE,1.11,"young",31,180,105,"m"
2,"ADDUCTOR",1,"Ecc04",1960,1940,1900,1900,1950,1900,0.026,50,1925,"Ecc",20,0,FALSE,FALSE,FALSE,2.63,"young",31,180,105,"m"
2,"ADDUCTOR",1,"Ecc05",1840,1880,1850,1250,1860,1550,0.167,310,1705,"Ecc",-40,600,FALSE,TRUE,TRUE,20,"young",31,180,105,"m"
2,"ADDUCTOR",1,"Ecc06",1720,1740,1700,1150,1730,1425,0.176,305,1577.5,"Ecc",-20,550,FALSE,FALSE,TRUE,21.4,"young",31,180,105,"m"
2,"ADDUCTOR",1,"Ecc07",2060,2080,1650,1250,2070,1450,0.3,620,1760,"Ecc",-20,400,TRUE,FALSE,TRUE,42.76,"young",31,180,105,"m"
2,"ADDUCTOR",1,"Ecc08",1640,1680,1450,1450,1660,1450,0.127,210,1555,"Ecc",-40,0,FALSE,TRUE,FALSE,14.48,"young",31,180,105,"m"
2,"ADDUCTOR",1,"Ecc09",1980,1920,1800,2300,1950,2050,0.051,-100,2000,"Ecc",60,-500,FALSE,TRUE,TRUE,4.88,"young",31,180,105,"m"
2,"ADDUCTOR",1,"Ecc10",2280,2300,2450,3200,2290,2825,0.234,-535,2557.5,"Ecc",-20,-750,FALSE,FALSE,TRUE,18.94,"young",31,180,105,"m"
2,"ADDUCTOR",2,"Ecc01",1860,1880,1450,1200,1870,1325,0.291,545,1597.5,"Ecc",-20,250,FALSE,FALSE,FALSE,41.13,"young",31,180,105,"m"
2,"ADDUCTOR",2,"Ecc02",1760,1760,1650,850,1760,1250,0.29,510,1505,"Ecc",0,800,FALSE,FALSE,TRUE,40.8,"young",31,180,105,"m"
2,"ADDUCTOR",2,"Ecc03",1960,1960,1950,2000,1960,1975,0.008,-15,1967.5,"Ecc",0,-50,FALSE,FALSE,FALSE,0.76,"young",31,180,105,"m"
2,"ADDUCTOR",2,"Ecc04",1880,1900,2200,2200,1890,2200,0.164,-310,2045,"Ecc",-20,0,FALSE,FALSE,FALSE,14.09,"young",31,180,105,"m"
2,"ADDUCTOR",2,"Ecc05",1700,1680,1800,2000,1690,1900,0.124,-210,1795,"Ecc",20,-200,FALSE,FALSE,FALSE,11.05,"young",31,180,105,"m"
2,"ADDUCTOR",2,"Ecc06",1680,1660,1700,1600,1670,1650,0.012,20,1660,"Ecc",20,100,FALSE,FALSE,FALSE,1.21,"young",31,180,105,"m"
2,"ADDUCTOR",2,"Ecc07",1540,1540,1600,1650,1540,1625,0.055,-85,1582.5,"Ecc",0,-50,FALSE,FALSE,FALSE,5.23,"young",31,180,105,"m"
2,"ADDUCTOR",2,"Ecc08",1740,1740,1300,1500,1740,1400,0.195,340,1570,"Ecc",0,-200,FALSE,FALSE,FALSE,24.29,"young",31,180,105,"m"
2,"ADDUCTOR",2,"Ecc09",1840,1800,950,1150,1820,1050,0.423,770,1435,"Ecc",40,-200,TRUE,TRUE,FALSE,73.33,"young",31,180,105,"m"
2,"ADDUCTOR",2,"Ecc10",2820,2840,750,1050,2830,900,0.682,1930,1865,"Ecc",-20,-300,TRUE,FALSE,FALSE,214.44,"young",31,180,105,"m"
2,"ADDUCTOR",1,"Rep01",3280,3260,3700,3350,3270,3525,0.078,-255,3397.5,"Rep",20,350,FALSE,FALSE,TRUE,7.23,"young",31,180,105,"m"
2,"ADDUCTOR",1,"Rep02",3260,3260,3300,3550,3260,3425,0.051,-165,3342.5,"Rep",0,-250,FALSE,FALSE,TRUE,4.82,"young",31,180,105,"m"
2,"ADDUCTOR",1,"Rep03",3140,3160,3000,3050,3150,3025,0.04,125,3087.5,"Rep",-20,-50,FALSE,FALSE,FALSE,4.13,"young",31,180,105,"m"
2,"ADDUCTOR",1,"Rep04",3260,3240,3350,3250,3250,3300,0.015,-50,3275,"Rep",20,100,FALSE,FALSE,FALSE,1.52,"young",31,180,105,"m"
2,"ADDUCTOR",1,"Rep05",3100,3100,3050,2700,3100,2875,0.073,225,2987.5,"Rep",0,350,FALSE,FALSE,TRUE,7.83,"young",31,180,105,"m"
2,"ADDUCTOR",1,"Rep06",2960,2960,3000,3100,2960,3050,0.03,-90,3005,"Rep",0,-100,FALSE,FALSE,FALSE,2.95,"young",31,180,105,"m"
2,"ADDUCTOR",1,"Rep07",3380,3400,3200,3050,3390,3125,0.078,265,3257.5,"Rep",-20,150,FALSE,FALSE,FALSE,8.48,"young",31,180,105,"m"
2,"ADDUCTOR",1,"Rep08",2980,2960,3150,3500,2970,3325,0.12,-355,3147.5,"Rep",20,-350,FALSE,FALSE,TRUE,10.68,"young",31,180,105,"m"
2,"ADDUCTOR",1,"Rep09",3300,3260,3200,3550,3280,3375,0.029,-95,3327.5,"Rep",40,-350,FALSE,FALSE,TRUE,2.81,"young",31,180,105,"m"
2,"ADDUCTOR",1,"Rep10",3920,3980,4600,4250,3950,4425,0.12,-475,4187.5,"Rep",-60,350,TRUE,FALSE,TRUE,10.73,"young",31,180,105,"m"
2,"ADDUCTOR",2,"Rep01",3120,3140,3100,2800,3130,2950,0.058,180,3040,"Rep",-20,300,FALSE,FALSE,TRUE,6.1,"young",31,180,105,"m"
2,"ADDUCTOR",2,"Rep02",2940,2960,3100,3050,2950,3075,0.042,-125,3012.5,"Rep",-20,50,FALSE,FALSE,FALSE,4.07,"young",31,180,105,"m"
2,"ADDUCTOR",2,"Rep03",3160,3160,3250,3550,3160,3400,0.076,-240,3280,"Rep",0,-300,FALSE,FALSE,TRUE,7.06,"young",31,180,105,"m"
2,"ADDUCTOR",2,"Rep04",3040,3040,3000,3100,3040,3050,0.003,-10,3045,"Rep",0,-100,FALSE,FALSE,FALSE,0.33,"young",31,180,105,"m"
2,"ADDUCTOR",2,"Rep05",2840,2820,2850,2800,2830,2825,0.002,5,2827.5,"Rep",20,50,FALSE,FALSE,FALSE,0.18,"young",31,180,105,"m"
2,"ADDUCTOR",2,"Rep06",2860,2860,2800,2750,2860,2775,0.03,85,2817.5,"Rep",0,50,FALSE,FALSE,FALSE,3.06,"young",31,180,105,"m"
2,"ADDUCTOR",2,"Rep07",2700,2700,2700,2800,2700,2750,0.019,-50,2725,"Rep",0,-100,FALSE,FALSE,FALSE,1.82,"young",31,180,105,"m"
2,"ADDUCTOR",2,"Rep08",2980,2960,2750,2800,2970,2775,0.066,195,2872.5,"Rep",20,-50,FALSE,FALSE,FALSE,7.03,"young",31,180,105,"m"
2,"ADDUCTOR",2,"Rep09",3040,3040,2800,2800,3040,2800,0.079,240,2920,"Rep",0,0,FALSE,FALSE,FALSE,8.57,"young",31,180,105,"m"
2,"ADDUCTOR",2,"Rep10",4320,4360,4850,3100,4340,3975,0.084,365,4157.5,"Rep",-40,1750,FALSE,FALSE,TRUE,9.18,"young",31,180,105,"m"
2,"ADDUCTOR",1,"TuT",32580,32580,33550,33350,32580,33450,0.027,-870,33015,"TuT",0,200,FALSE,FALSE,FALSE,2.6,"young",31,180,105,"m"
2,"ADDUCTOR",2,"TuT",31000,31040,31200,29550,31020,30375,0.021,645,30697.5,"TuT",-40,1650,FALSE,TRUE,TRUE,2.12,"young",31,180,105,"m"
2,"LOWER BACK",1,"Con01",1660,1660,1600,1700,1660,1650,0.006,10,1655,"Con",0,-100,FALSE,FALSE,FALSE,0.61,"young",31,180,105,"m"
2,"LOWER BACK",1,"Con02",1580,1540,1600,1500,1560,1550,0.006,10,1555,"Con",40,100,FALSE,TRUE,FALSE,0.65,"young",31,180,105,"m"
2,"LOWER BACK",1,"Con03",1640,1640,1550,1650,1640,1600,0.024,40,1620,"Con",0,-100,FALSE,FALSE,FALSE,2.5,"young",31,180,105,"m"
2,"LOWER BACK",1,"Con04",1600,1560,1450,1650,1580,1550,0.019,30,1565,"Con",40,-200,FALSE,TRUE,TRUE,1.94,"young",31,180,105,"m"
2,"LOWER BACK",1,"Con05",1600,1600,1600,1600,1600,1600,0,0,1600,"Con",0,0,FALSE,FALSE,FALSE,0,"young",31,180,105,"m"
2,"LOWER BACK",1,"Con06",1480,1480,1550,1550,1480,1550,0.047,-70,1515,"Con",0,0,FALSE,FALSE,FALSE,4.52,"young",31,180,105,"m"
2,"LOWER BACK",1,"Con07",1480,1440,1600,1500,1460,1550,0.062,-90,1505,"Con",40,100,FALSE,TRUE,FALSE,5.81,"young",31,180,105,"m"
2,"LOWER BACK",1,"Con08",1400,1380,1600,1450,1390,1525,0.097,-135,1457.5,"Con",20,150,FALSE,FALSE,FALSE,8.85,"young",31,180,105,"m"
2,"LOWER BACK",1,"Con09",1560,1520,1800,1600,1540,1700,0.104,-160,1620,"Con",40,200,FALSE,TRUE,TRUE,9.41,"young",31,180,105,"m"
2,"LOWER BACK",1,"Con10",1580,1560,1800,1750,1570,1775,0.131,-205,1672.5,"Con",20,50,TRUE,FALSE,FALSE,11.55,"young",31,180,105,"m"
2,"LOWER BACK",2,"Con01",1600,1560,1650,1550,1580,1600,0.013,-20,1590,"Con",40,100,FALSE,TRUE,FALSE,1.25,"young",31,180,105,"m"
2,"LOWER BACK",2,"Con02",1460,1460,1550,1450,1460,1500,0.027,-40,1480,"Con",0,100,FALSE,FALSE,FALSE,2.67,"young",31,180,105,"m"
2,"LOWER BACK",2,"Con03",1400,1400,1400,1300,1400,1350,0.036,50,1375,"Con",0,100,FALSE,FALSE,FALSE,3.7,"young",31,180,105,"m"
2,"LOWER BACK",2,"Con04",1360,1360,1400,1350,1360,1375,0.011,-15,1367.5,"Con",0,50,FALSE,FALSE,FALSE,1.09,"young",31,180,105,"m"
2,"LOWER BACK",2,"Con05",1460,1440,1450,1450,1450,1450,0,0,1450,"Con",20,0,FALSE,FALSE,FALSE,0,"young",31,180,105,"m"
2,"LOWER BACK",2,"Con06",1360,1340,1350,1450,1350,1400,0.037,-50,1375,"Con",20,-100,FALSE,FALSE,FALSE,3.57,"young",31,180,105,"m"
2,"LOWER BACK",2,"Con07",1400,1420,1400,1500,1410,1450,0.028,-40,1430,"Con",-20,-100,FALSE,FALSE,FALSE,2.76,"young",31,180,105,"m"
2,"LOWER BACK",2,"Con08",1380,1380,1400,1500,1380,1450,0.051,-70,1415,"Con",0,-100,FALSE,FALSE,FALSE,4.83,"young",31,180,105,"m"
2,"LOWER BACK",2,"Con09",1380,1380,1500,1500,1380,1500,0.087,-120,1440,"Con",0,0,FALSE,FALSE,FALSE,8,"young",31,180,105,"m"
2,"LOWER BACK",2,"Con10",1380,1400,1600,1550,1390,1575,0.133,-185,1482.5,"Con",-20,50,FALSE,FALSE,FALSE,11.75,"young",31,180,105,"m"
2,"LOWER BACK",1,"Ecc01",2780,2800,2850,2800,2790,2825,0.013,-35,2807.5,"Ecc",-20,50,FALSE,FALSE,FALSE,1.24,"young",31,180,105,"m"
2,"LOWER BACK",1,"Ecc02",2440,2480,2450,2550,2460,2500,0.016,-40,2480,"Ecc",-40,-100,FALSE,FALSE,FALSE,1.6,"young",31,180,105,"m"
2,"LOWER BACK",1,"Ecc03",2020,2040,2200,1950,2030,2075,0.022,-45,2052.5,"Ecc",-20,250,FALSE,FALSE,TRUE,2.17,"young",31,180,105,"m"
2,"LOWER BACK",1,"Ecc04",2080,2100,2150,2050,2090,2100,0.005,-10,2095,"Ecc",-20,100,FALSE,FALSE,FALSE,0.48,"young",31,180,105,"m"
2,"LOWER BACK",1,"Ecc05",2020,2020,2000,2000,2020,2000,0.01,20,2010,"Ecc",0,0,FALSE,FALSE,FALSE,1,"young",31,180,105,"m"
2,"LOWER BACK",1,"Ecc06",1880,1880,1750,1800,1880,1775,0.056,105,1827.5,"Ecc",0,-50,FALSE,FALSE,FALSE,5.92,"young",31,180,105,"m"
2,"LOWER BACK",1,"Ecc07",1840,1880,1700,1850,1860,1775,0.046,85,1817.5,"Ecc",-40,-150,FALSE,FALSE,FALSE,4.79,"young",31,180,105,"m"
2,"LOWER BACK",1,"Ecc08",1860,1880,1650,1800,1870,1725,0.078,145,1797.5,"Ecc",-20,-150,FALSE,FALSE,FALSE,8.41,"young",31,180,105,"m"
2,"LOWER BACK",1,"Ecc09",1860,1920,1550,1800,1890,1675,0.114,215,1782.5,"Ecc",-60,-250,TRUE,FALSE,TRUE,12.84,"young",31,180,105,"m"
2,"LOWER BACK",1,"Ecc10",2580,2600,2550,2500,2590,2525,0.025,65,2557.5,"Ecc",-20,50,FALSE,FALSE,FALSE,2.57,"young",31,180,105,"m"
2,"LOWER BACK",2,"Ecc01",2380,2400,2350,2400,2390,2375,0.006,15,2382.5,"Ecc",-20,-50,FALSE,FALSE,FALSE,0.63,"young",31,180,105,"m"
2,"LOWER BACK",2,"Ecc02",1940,1920,1900,2000,1930,1950,0.01,-20,1940,"Ecc",20,-100,FALSE,FALSE,FALSE,1.03,"young",31,180,105,"m"
2,"LOWER BACK",2,"Ecc03",1760,1760,1750,1850,1760,1800,0.023,-40,1780,"Ecc",0,-100,FALSE,FALSE,FALSE,2.22,"young",31,180,105,"m"
2,"LOWER BACK",2,"Ecc04",1620,1640,1600,1600,1630,1600,0.018,30,1615,"Ecc",-20,0,FALSE,FALSE,FALSE,1.88,"young",31,180,105,"m"
2,"LOWER BACK",2,"Ecc05",1740,1760,1750,1700,1750,1725,0.014,25,1737.5,"Ecc",-20,50,FALSE,FALSE,FALSE,1.45,"young",31,180,105,"m"
2,"LOWER BACK",2,"Ecc06",1680,1680,1700,1600,1680,1650,0.018,30,1665,"Ecc",0,100,FALSE,FALSE,FALSE,1.82,"young",31,180,105,"m"
2,"LOWER BACK",2,"Ecc07",1720,1720,1700,1600,1720,1650,0.041,70,1685,"Ecc",0,100,FALSE,FALSE,FALSE,4.24,"young",31,180,105,"m"
2,"LOWER BACK",2,"Ecc08",1740,1740,1650,1600,1740,1625,0.066,115,1682.5,"Ecc",0,50,FALSE,FALSE,FALSE,7.08,"young",31,180,105,"m"
2,"LOWER BACK",2,"Ecc09",1760,1760,1600,1650,1760,1625,0.077,135,1692.5,"Ecc",0,-50,FALSE,FALSE,FALSE,8.31,"young",31,180,105,"m"
2,"LOWER BACK",2,"Ecc10",2460,2440,2200,2200,2450,2200,0.102,250,2325,"Ecc",20,0,TRUE,FALSE,FALSE,11.36,"young",31,180,105,"m"
2,"LOWER BACK",1,"Rep01",4440,4460,4450,4500,4450,4475,0.006,-25,4462.5,"Rep",-20,-50,FALSE,FALSE,FALSE,0.56,"young",31,180,105,"m"
2,"LOWER BACK",1,"Rep02",4020,4020,4050,4050,4020,4050,0.007,-30,4035,"Rep",0,0,FALSE,FALSE,FALSE,0.74,"young",31,180,105,"m"
2,"LOWER BACK",1,"Rep03",3660,3680,3750,3600,3670,3675,0.001,-5,3672.5,"Rep",-20,150,FALSE,FALSE,FALSE,0.14,"young",31,180,105,"m"
2,"LOWER BACK",1,"Rep04",3680,3660,3600,3700,3670,3650,0.005,20,3660,"Rep",20,-100,FALSE,FALSE,FALSE,0.55,"young",31,180,105,"m"
2,"LOWER BACK",1,"Rep05",3620,3620,3600,3600,3620,3600,0.006,20,3610,"Rep",0,0,FALSE,FALSE,FALSE,0.56,"young",31,180,105,"m"
2,"LOWER BACK",1,"Rep06",3360,3360,3300,3350,3360,3325,0.01,35,3342.5,"Rep",0,-50,FALSE,FALSE,FALSE,1.05,"young",31,180,105,"m"
2,"LOWER BACK",1,"Rep07",3320,3320,3300,3350,3320,3325,0.002,-5,3322.5,"Rep",0,-50,FALSE,FALSE,FALSE,0.15,"young",31,180,105,"m"
2,"LOWER BACK",1,"Rep08",3260,3260,3250,3250,3260,3250,0.003,10,3255,"Rep",0,0,FALSE,FALSE,FALSE,0.31,"young",31,180,105,"m"
2,"LOWER BACK",1,"Rep09",3420,3440,3350,3400,3430,3375,0.016,55,3402.5,"Rep",-20,-50,FALSE,FALSE,FALSE,1.63,"young",31,180,105,"m"
2,"LOWER BACK",1,"Rep10",4160,4160,4350,4250,4160,4300,0.034,-140,4230,"Rep",0,100,TRUE,FALSE,FALSE,3.26,"young",31,180,105,"m"
2,"LOWER BACK",2,"Rep01",3980,3960,4000,3950,3970,3975,0.001,-5,3972.5,"Rep",20,50,FALSE,FALSE,FALSE,0.13,"young",31,180,105,"m"
2,"LOWER BACK",2,"Rep02",3400,3380,3450,3450,3390,3450,0.018,-60,3420,"Rep",20,0,FALSE,FALSE,FALSE,1.74,"young",31,180,105,"m"
2,"LOWER BACK",2,"Rep03",3160,3160,3150,3150,3160,3150,0.003,10,3155,"Rep",0,0,FALSE,FALSE,FALSE,0.32,"young",31,180,105,"m"
2,"LOWER BACK",2,"Rep04",2980,3000,3000,2950,2990,2975,0.005,15,2982.5,"Rep",-20,50,FALSE,FALSE,FALSE,0.5,"young",31,180,105,"m"
2,"LOWER BACK",2,"Rep05",3200,3200,3200,3150,3200,3175,0.008,25,3187.5,"Rep",0,50,FALSE,FALSE,FALSE,0.79,"young",31,180,105,"m"
2,"LOWER BACK",2,"Rep06",3040,3020,3050,3050,3030,3050,0.007,-20,3040,"Rep",20,0,FALSE,FALSE,FALSE,0.66,"young",31,180,105,"m"
2,"LOWER BACK",2,"Rep07",3120,3140,3100,3100,3130,3100,0.01,30,3115,"Rep",-20,0,FALSE,FALSE,FALSE,0.97,"young",31,180,105,"m"
2,"LOWER BACK",2,"Rep08",3120,3120,3050,3100,3120,3075,0.014,45,3097.5,"Rep",0,-50,FALSE,FALSE,FALSE,1.46,"young",31,180,105,"m"
2,"LOWER BACK",2,"Rep09",3140,3140,3100,3150,3140,3125,0.005,15,3132.5,"Rep",0,-50,FALSE,FALSE,FALSE,0.48,"young",31,180,105,"m"
2,"LOWER BACK",2,"Rep10",3840,3840,3800,3750,3840,3775,0.017,65,3807.5,"Rep",0,50,FALSE,FALSE,FALSE,1.72,"young",31,180,105,"m"
2,"LOWER BACK",1,"TuT",36940,36980,37000,37050,36960,37025,0.002,-65,36992.5,"TuT",-40,-50,FALSE,FALSE,FALSE,0.18,"young",31,180,105,"m"
2,"LOWER BACK",2,"TuT",32980,32960,32900,32800,32970,32850,0.004,120,32910,"TuT",20,100,FALSE,FALSE,FALSE,0.37,"young",31,180,105,"m"
2,"TOTAL ABDOMINAL",1,"Con01",1620,1620,1550,1750,1620,1650,0.019,-30,1635,"Con",0,-200,FALSE,FALSE,TRUE,1.82,"young",31,180,105,"m"
2,"TOTAL ABDOMINAL",1,"Con02",1640,1620,1700,1800,1630,1750,0.074,-120,1690,"Con",20,-100,FALSE,FALSE,FALSE,6.86,"young",31,180,105,"m"
2,"TOTAL ABDOMINAL",1,"Con03",1540,1540,1600,1600,1540,1600,0.039,-60,1570,"Con",0,0,FALSE,FALSE,FALSE,3.75,"young",31,180,105,"m"
2,"TOTAL ABDOMINAL",1,"Con04",1420,1420,1450,1450,1420,1450,0.021,-30,1435,"Con",0,0,FALSE,FALSE,FALSE,2.07,"young",31,180,105,"m"
2,"TOTAL ABDOMINAL",1,"Con05",1480,1460,1600,1600,1470,1600,0.088,-130,1535,"Con",20,0,FALSE,FALSE,FALSE,8.12,"young",31,180,105,"m"
2,"TOTAL ABDOMINAL",1,"Con06",1560,1560,1750,1650,1560,1700,0.09,-140,1630,"Con",0,100,FALSE,FALSE,FALSE,8.24,"young",31,180,105,"m"
2,"TOTAL ABDOMINAL",1,"Con07",1580,1580,1650,1700,1580,1675,0.06,-95,1627.5,"Con",0,-50,FALSE,FALSE,FALSE,5.67,"young",31,180,105,"m"
2,"TOTAL ABDOMINAL",1,"Con08",1440,1440,1500,1600,1440,1550,0.076,-110,1495,"Con",0,-100,FALSE,FALSE,FALSE,7.1,"young",31,180,105,"m"
2,"TOTAL ABDOMINAL",1,"Con09",1480,1480,1550,1650,1480,1600,0.081,-120,1540,"Con",0,-100,FALSE,FALSE,FALSE,7.5,"young",31,180,105,"m"
2,"TOTAL ABDOMINAL",1,"Con10",1440,1420,1550,1550,1430,1550,0.084,-120,1490,"Con",20,0,FALSE,FALSE,FALSE,7.74,"young",31,180,105,"m"
2,"TOTAL ABDOMINAL",2,"Con01",1700,1680,1650,1800,1690,1725,0.021,-35,1707.5,"Con",20,-150,FALSE,FALSE,FALSE,2.03,"young",31,180,105,"m"
2,"TOTAL ABDOMINAL",2,"Con02",1660,1660,1600,1750,1660,1675,0.009,-15,1667.5,"Con",0,-150,FALSE,FALSE,FALSE,0.9,"young",31,180,105,"m"
2,"TOTAL ABDOMINAL",2,"Con03",1560,1580,1550,1650,1570,1600,0.019,-30,1585,"Con",-20,-100,FALSE,FALSE,FALSE,1.88,"young",31,180,105,"m"
2,"TOTAL ABDOMINAL",2,"Con04",1620,1620,1650,1600,1620,1625,0.003,-5,1622.5,"Con",0,50,FALSE,FALSE,FALSE,0.31,"young",31,180,105,"m"
2,"TOTAL ABDOMINAL",2,"Con05",1520,1520,1600,1550,1520,1575,0.036,-55,1547.5,"Con",0,50,FALSE,FALSE,FALSE,3.49,"young",31,180,105,"m"
2,"TOTAL ABDOMINAL",2,"Con06",1460,1460,1650,1550,1460,1600,0.096,-140,1530,"Con",0,100,FALSE,FALSE,FALSE,8.75,"young",31,180,105,"m"
2,"TOTAL ABDOMINAL",2,"Con07",1520,1480,1650,1700,1500,1675,0.117,-175,1587.5,"Con",40,-50,TRUE,TRUE,FALSE,10.45,"young",31,180,105,"m"
2,"TOTAL ABDOMINAL",2,"Con08",1480,1480,1550,1650,1480,1600,0.081,-120,1540,"Con",0,-100,FALSE,FALSE,FALSE,7.5,"young",31,180,105,"m"
2,"TOTAL ABDOMINAL",2,"Con09",1460,1440,1550,1500,1450,1525,0.052,-75,1487.5,"Con",20,50,FALSE,FALSE,FALSE,4.92,"young",31,180,105,"m"
2,"TOTAL ABDOMINAL",2,"Con10",1440,1460,1600,1550,1450,1575,0.086,-125,1512.5,"Con",-20,50,FALSE,FALSE,FALSE,7.94,"young",31,180,105,"m"
2,"TOTAL ABDOMINAL",1,"Ecc01",2500,2520,2500,2400,2510,2450,0.024,60,2480,"Ecc",-20,100,FALSE,FALSE,FALSE,2.45,"young",31,180,105,"m"
2,"TOTAL ABDOMINAL",1,"Ecc02",2560,2540,2450,2400,2550,2425,0.049,125,2487.5,"Ecc",20,50,FALSE,FALSE,FALSE,5.15,"young",31,180,105,"m"
2,"TOTAL ABDOMINAL",1,"Ecc03",2400,2420,2400,2400,2410,2400,0.004,10,2405,"Ecc",-20,0,FALSE,FALSE,FALSE,0.42,"young",31,180,105,"m"
2,"TOTAL ABDOMINAL",1,"Ecc04",2460,2480,2400,2400,2470,2400,0.028,70,2435,"Ecc",-20,0,FALSE,FALSE,FALSE,2.92,"young",31,180,105,"m"
2,"TOTAL ABDOMINAL",1,"Ecc05",2320,2340,2150,2250,2330,2200,0.056,130,2265,"Ecc",-20,-100,FALSE,FALSE,FALSE,5.91,"young",31,180,105,"m"
2,"TOTAL ABDOMINAL",1,"Ecc06",2260,2240,2100,2100,2250,2100,0.067,150,2175,"Ecc",20,0,TRUE,FALSE,FALSE,7.14,"young",31,180,105,"m"
2,"TOTAL ABDOMINAL",1,"Ecc07",2160,2160,2150,2050,2160,2100,0.028,60,2130,"Ecc",0,100,FALSE,FALSE,FALSE,2.86,"young",31,180,105,"m"
2,"TOTAL ABDOMINAL",1,"Ecc08",2280,2300,2200,2100,2290,2150,0.061,140,2220,"Ecc",-20,100,FALSE,FALSE,FALSE,6.51,"young",31,180,105,"m"
2,"TOTAL ABDOMINAL",1,"Ecc09",2240,2220,2150,2100,2230,2125,0.047,105,2177.5,"Ecc",20,50,FALSE,FALSE,FALSE,4.94,"young",31,180,105,"m"
2,"TOTAL ABDOMINAL",1,"Ecc10",2300,2340,2250,2250,2320,2250,0.03,70,2285,"Ecc",-40,0,FALSE,TRUE,FALSE,3.11,"young",31,180,105,"m"
2,"TOTAL ABDOMINAL",2,"Ecc01",2400,2400,2500,2350,2400,2425,0.01,-25,2412.5,"Ecc",0,150,FALSE,FALSE,FALSE,1.03,"young",31,180,105,"m"
2,"TOTAL ABDOMINAL",2,"Ecc02",2240,2220,2300,2150,2230,2225,0.002,5,2227.5,"Ecc",20,150,FALSE,FALSE,FALSE,0.22,"young",31,180,105,"m"
2,"TOTAL ABDOMINAL",2,"Ecc03",2260,2280,2200,2200,2270,2200,0.031,70,2235,"Ecc",-20,0,FALSE,FALSE,FALSE,3.18,"young",31,180,105,"m"
2,"TOTAL ABDOMINAL",2,"Ecc04",2100,2080,2050,2150,2090,2100,0.005,-10,2095,"Ecc",20,-100,FALSE,FALSE,FALSE,0.48,"young",31,180,105,"m"
2,"TOTAL ABDOMINAL",2,"Ecc05",2060,2060,1900,1950,2060,1925,0.066,135,1992.5,"Ecc",0,-50,FALSE,FALSE,FALSE,7.01,"young",31,180,105,"m"
2,"TOTAL ABDOMINAL",2,"Ecc06",2080,2100,1900,1950,2090,1925,0.079,165,2007.5,"Ecc",-20,-50,TRUE,FALSE,FALSE,8.57,"young",31,180,105,"m"
2,"TOTAL ABDOMINAL",2,"Ecc07",2180,2220,2100,2000,2200,2050,0.068,150,2125,"Ecc",-40,100,TRUE,TRUE,FALSE,7.32,"young",31,180,105,"m"
2,"TOTAL ABDOMINAL",2,"Ecc08",2080,2060,2000,1950,2070,1975,0.046,95,2022.5,"Ecc",20,50,FALSE,FALSE,FALSE,4.81,"young",31,180,105,"m"
2,"TOTAL ABDOMINAL",2,"Ecc09",2240,2260,2150,2250,2250,2200,0.022,50,2225,"Ecc",-20,-100,FALSE,FALSE,FALSE,2.27,"young",31,180,105,"m"
2,"TOTAL ABDOMINAL",2,"Ecc10",2900,2900,2900,2700,2900,2800,0.034,100,2850,"Ecc",0,200,FALSE,FALSE,TRUE,3.57,"young",31,180,105,"m"
2,"TOTAL ABDOMINAL",1,"Rep01",4120,4140,4050,4150,4130,4100,0.007,30,4115,"Rep",-20,-100,FALSE,FALSE,FALSE,0.73,"young",31,180,105,"m"
2,"TOTAL ABDOMINAL",1,"Rep02",4200,4160,4150,4200,4180,4175,0.001,5,4177.5,"Rep",40,-50,FALSE,FALSE,FALSE,0.12,"young",31,180,105,"m"
2,"TOTAL ABDOMINAL",1,"Rep03",3940,3960,4000,4000,3950,4000,0.013,-50,3975,"Rep",-20,0,FALSE,FALSE,FALSE,1.25,"young",31,180,105,"m"
2,"TOTAL ABDOMINAL",1,"Rep04",3880,3900,3850,3850,3890,3850,0.01,40,3870,"Rep",-20,0,FALSE,FALSE,FALSE,1.04,"young",31,180,105,"m"
2,"TOTAL ABDOMINAL",1,"Rep05",3800,3800,3750,3850,3800,3800,0,0,3800,"Rep",0,-100,FALSE,FALSE,FALSE,0,"young",31,180,105,"m"
2,"TOTAL ABDOMINAL",1,"Rep06",3820,3800,3850,3750,3810,3800,0.003,10,3805,"Rep",20,100,FALSE,FALSE,FALSE,0.26,"young",31,180,105,"m"
2,"TOTAL ABDOMINAL",1,"Rep07",3740,3740,3800,3750,3740,3775,0.009,-35,3757.5,"Rep",0,50,FALSE,FALSE,FALSE,0.93,"young",31,180,105,"m"
2,"TOTAL ABDOMINAL",1,"Rep08",3720,3740,3700,3700,3730,3700,0.008,30,3715,"Rep",-20,0,FALSE,FALSE,FALSE,0.81,"young",31,180,105,"m"
2,"TOTAL ABDOMINAL",1,"Rep09",3720,3700,3700,3750,3710,3725,0.004,-15,3717.5,"Rep",20,-50,FALSE,FALSE,FALSE,0.4,"young",31,180,105,"m"
2,"TOTAL ABDOMINAL",1,"Rep10",3740,3760,3800,3800,3750,3800,0.013,-50,3775,"Rep",-20,0,FALSE,FALSE,FALSE,1.32,"young",31,180,105,"m"
2,"TOTAL ABDOMINAL",2,"Rep01",4100,4080,4150,4150,4090,4150,0.015,-60,4120,"Rep",20,0,FALSE,FALSE,FALSE,1.45,"young",31,180,105,"m"
2,"TOTAL ABDOMINAL",2,"Rep02",3900,3880,3900,3900,3890,3900,0.003,-10,3895,"Rep",20,0,FALSE,FALSE,FALSE,0.26,"young",31,180,105,"m"
2,"TOTAL ABDOMINAL",2,"Rep03",3820,3860,3750,3850,3840,3800,0.01,40,3820,"Rep",-40,-100,FALSE,FALSE,FALSE,1.05,"young",31,180,105,"m"
2,"TOTAL ABDOMINAL",2,"Rep04",3720,3700,3700,3750,3710,3725,0.004,-15,3717.5,"Rep",20,-50,FALSE,FALSE,FALSE,0.4,"young",31,180,105,"m"
2,"TOTAL ABDOMINAL",2,"Rep05",3580,3580,3500,3500,3580,3500,0.022,80,3540,"Rep",0,0,FALSE,FALSE,FALSE,2.29,"young",31,180,105,"m"
2,"TOTAL ABDOMINAL",2,"Rep06",3540,3560,3550,3500,3550,3525,0.007,25,3537.5,"Rep",-20,50,FALSE,FALSE,FALSE,0.71,"young",31,180,105,"m"
2,"TOTAL ABDOMINAL",2,"Rep07",3700,3700,3750,3700,3700,3725,0.007,-25,3712.5,"Rep",0,50,FALSE,FALSE,FALSE,0.67,"young",31,180,105,"m"
2,"TOTAL ABDOMINAL",2,"Rep08",3560,3540,3550,3600,3550,3575,0.007,-25,3562.5,"Rep",20,-50,FALSE,FALSE,FALSE,0.7,"young",31,180,105,"m"
2,"TOTAL ABDOMINAL",2,"Rep09",3700,3700,3700,3750,3700,3725,0.007,-25,3712.5,"Rep",0,-50,FALSE,FALSE,FALSE,0.67,"young",31,180,105,"m"
2,"TOTAL ABDOMINAL",2,"Rep10",4340,4360,4500,4250,4350,4375,0.006,-25,4362.5,"Rep",-20,250,FALSE,FALSE,TRUE,0.57,"young",31,180,105,"m"
2,"TOTAL ABDOMINAL",1,"TuT",38680,38700,38650,38800,38690,38725,0.001,-35,38707.5,"TuT",-20,-150,FALSE,FALSE,FALSE,0.09,"young",31,180,105,"m"
2,"TOTAL ABDOMINAL",2,"TuT",37960,37960,38050,37950,37960,38000,0.001,-40,37980,"TuT",0,100,FALSE,FALSE,FALSE,0.11,"young",31,180,105,"m"
2,"VERTICAL TRACTION",1,"Con01",1520,1480,1250,1650,1500,1450,0.033,50,1475,"Con",40,-400,FALSE,FALSE,TRUE,3.45,"young",31,180,105,"m"
2,"VERTICAL TRACTION",1,"Con02",1180,1180,1250,1250,1180,1250,0.059,-70,1215,"Con",0,0,FALSE,FALSE,FALSE,5.6,"young",31,180,105,"m"
2,"VERTICAL TRACTION",1,"Con03",1140,1140,1200,1150,1140,1175,0.031,-35,1157.5,"Con",0,50,FALSE,FALSE,FALSE,2.98,"young",31,180,105,"m"
2,"VERTICAL TRACTION",1,"Con04",1160,1160,1250,1250,1160,1250,0.078,-90,1205,"Con",0,0,FALSE,FALSE,FALSE,7.2,"young",31,180,105,"m"
2,"VERTICAL TRACTION",1,"Con05",1220,1240,1300,1300,1230,1300,0.057,-70,1265,"Con",-20,0,FALSE,FALSE,FALSE,5.38,"young",31,180,105,"m"
2,"VERTICAL TRACTION",1,"Con06",1240,1200,1300,1350,1220,1325,0.086,-105,1272.5,"Con",40,-50,FALSE,FALSE,FALSE,7.92,"young",31,180,105,"m"
2,"VERTICAL TRACTION",1,"Con07",1200,1180,1300,1250,1190,1275,0.071,-85,1232.5,"Con",20,50,FALSE,FALSE,FALSE,6.67,"young",31,180,105,"m"
2,"VERTICAL TRACTION",1,"Con08",1220,1220,1350,1300,1220,1325,0.086,-105,1272.5,"Con",0,50,FALSE,FALSE,FALSE,7.92,"young",31,180,105,"m"
2,"VERTICAL TRACTION",1,"Con09",1160,1140,1250,1300,1150,1275,0.109,-125,1212.5,"Con",20,-50,FALSE,FALSE,FALSE,9.8,"young",31,180,105,"m"
2,"VERTICAL TRACTION",1,"Con10",1180,1220,1400,1350,1200,1375,0.146,-175,1287.5,"Con",-40,50,FALSE,FALSE,FALSE,12.73,"young",31,180,105,"m"
2,"VERTICAL TRACTION",2,"Con01",1220,1220,1400,1400,1220,1400,0.148,-180,1310,"Con",0,0,FALSE,FALSE,FALSE,12.86,"young",31,180,105,"m"
2,"VERTICAL TRACTION",2,"Con02",1120,1140,1200,1150,1130,1175,0.04,-45,1152.5,"Con",-20,50,FALSE,FALSE,FALSE,3.83,"young",31,180,105,"m"
2,"VERTICAL TRACTION",2,"Con03",1100,1060,1200,1100,1080,1150,0.065,-70,1115,"Con",40,100,FALSE,FALSE,FALSE,6.09,"young",31,180,105,"m"
2,"VERTICAL TRACTION",2,"Con04",1040,1080,1100,1100,1060,1100,0.038,-40,1080,"Con",-40,0,FALSE,FALSE,FALSE,3.64,"young",31,180,105,"m"
2,"VERTICAL TRACTION",2,"Con05",1100,1120,1150,1200,1110,1175,0.059,-65,1142.5,"Con",-20,-50,FALSE,FALSE,FALSE,5.53,"young",31,180,105,"m"
2,"VERTICAL TRACTION",2,"Con06",1160,1180,1200,1250,1170,1225,0.047,-55,1197.5,"Con",-20,-50,FALSE,FALSE,FALSE,4.49,"young",31,180,105,"m"
2,"VERTICAL TRACTION",2,"Con07",1120,1120,1250,1250,1120,1250,0.116,-130,1185,"Con",0,0,FALSE,FALSE,FALSE,10.4,"young",31,180,105,"m"
2,"VERTICAL TRACTION",2,"Con08",1080,1080,1150,1200,1080,1175,0.088,-95,1127.5,"Con",0,-50,FALSE,FALSE,FALSE,8.09,"young",31,180,105,"m"
2,"VERTICAL TRACTION",2,"Con09",1020,1040,1150,1250,1030,1200,0.165,-170,1115,"Con",-20,-100,FALSE,FALSE,FALSE,14.17,"young",31,180,105,"m"
2,"VERTICAL TRACTION",2,"Con10",1080,1060,1300,1250,1070,1275,0.192,-205,1172.5,"Con",20,50,FALSE,FALSE,FALSE,16.08,"young",31,180,105,"m"
2,"VERTICAL TRACTION",1,"Ecc01",4460,4480,4450,4400,4470,4425,0.01,45,4447.5,"Ecc",-20,50,FALSE,FALSE,FALSE,1.02,"young",31,180,105,"m"
2,"VERTICAL TRACTION",1,"Ecc02",3420,3440,3350,3400,3430,3375,0.016,55,3402.5,"Ecc",-20,-50,FALSE,FALSE,FALSE,1.63,"young",31,180,105,"m"
2,"VERTICAL TRACTION",1,"Ecc03",2560,2560,2500,2500,2560,2500,0.023,60,2530,"Ecc",0,0,FALSE,FALSE,FALSE,2.4,"young",31,180,105,"m"
2,"VERTICAL TRACTION",1,"Ecc04",2320,2300,2200,2250,2310,2225,0.037,85,2267.5,"Ecc",20,-50,FALSE,FALSE,FALSE,3.82,"young",31,180,105,"m"
2,"VERTICAL TRACTION",1,"Ecc05",2260,2280,2200,2150,2270,2175,0.042,95,2222.5,"Ecc",-20,50,FALSE,FALSE,FALSE,4.37,"young",31,180,105,"m"
2,"VERTICAL TRACTION",1,"Ecc06",1980,2000,1900,1900,1990,1900,0.045,90,1945,"Ecc",-20,0,FALSE,FALSE,FALSE,4.74,"young",31,180,105,"m"
2,"VERTICAL TRACTION",1,"Ecc07",2180,2180,2050,2100,2180,2075,0.048,105,2127.5,"Ecc",0,-50,FALSE,FALSE,FALSE,5.06,"young",31,180,105,"m"
2,"VERTICAL TRACTION",1,"Ecc08",2040,2060,1950,1950,2050,1950,0.049,100,2000,"Ecc",-20,0,FALSE,FALSE,FALSE,5.13,"young",31,180,105,"m"
2,"VERTICAL TRACTION",1,"Ecc09",2020,2020,1850,1850,2020,1850,0.084,170,1935,"Ecc",0,0,FALSE,FALSE,FALSE,9.19,"young",31,180,105,"m"
2,"VERTICAL TRACTION",1,"Ecc10",3100,3100,3050,2450,3100,2750,0.113,350,2925,"Ecc",0,600,TRUE,FALSE,TRUE,12.73,"young",31,180,105,"m"
2,"VERTICAL TRACTION",2,"Ecc01",2760,2760,2650,2700,2760,2675,0.031,85,2717.5,"Ecc",0,-50,FALSE,FALSE,FALSE,3.18,"young",31,180,105,"m"
2,"VERTICAL TRACTION",2,"Ecc02",2480,2480,2400,2450,2480,2425,0.022,55,2452.5,"Ecc",0,-50,FALSE,FALSE,FALSE,2.27,"young",31,180,105,"m"
2,"VERTICAL TRACTION",2,"Ecc03",2220,2220,2150,2200,2220,2175,0.02,45,2197.5,"Ecc",0,-50,FALSE,FALSE,FALSE,2.07,"young",31,180,105,"m"
2,"VERTICAL TRACTION",2,"Ecc04",2000,1980,1950,1900,1990,1925,0.033,65,1957.5,"Ecc",20,50,FALSE,FALSE,FALSE,3.38,"young",31,180,105,"m"
2,"VERTICAL TRACTION",2,"Ecc05",1840,1800,1800,1750,1820,1775,0.025,45,1797.5,"Ecc",40,50,FALSE,FALSE,FALSE,2.54,"young",31,180,105,"m"
2,"VERTICAL TRACTION",2,"Ecc06",1800,1800,1700,1700,1800,1700,0.056,100,1750,"Ecc",0,0,FALSE,FALSE,FALSE,5.88,"young",31,180,105,"m"
2,"VERTICAL TRACTION",2,"Ecc07",1940,1920,1850,1800,1930,1825,0.054,105,1877.5,"Ecc",20,50,FALSE,FALSE,FALSE,5.75,"young",31,180,105,"m"
2,"VERTICAL TRACTION",2,"Ecc08",2220,2240,2100,2050,2230,2075,0.07,155,2152.5,"Ecc",-20,50,FALSE,FALSE,FALSE,7.47,"young",31,180,105,"m"
2,"VERTICAL TRACTION",2,"Ecc09",2060,2040,1900,1850,2050,1875,0.085,175,1962.5,"Ecc",20,50,FALSE,FALSE,FALSE,9.33,"young",31,180,105,"m"
2,"VERTICAL TRACTION",2,"Ecc10",2940,2960,2900,2300,2950,2600,0.119,350,2775,"Ecc",-20,600,TRUE,FALSE,TRUE,13.46,"young",31,180,105,"m"
2,"VERTICAL TRACTION",1,"Rep01",5980,5960,5700,6050,5970,5875,0.016,95,5922.5,"Rep",20,-350,FALSE,FALSE,TRUE,1.62,"young",31,180,105,"m"
2,"VERTICAL TRACTION",1,"Rep02",4600,4620,4600,4650,4610,4625,0.003,-15,4617.5,"Rep",-20,-50,FALSE,FALSE,FALSE,0.32,"young",31,180,105,"m"
2,"VERTICAL TRACTION",1,"Rep03",3700,3700,3700,3650,3700,3675,0.007,25,3687.5,"Rep",0,50,FALSE,FALSE,FALSE,0.68,"young",31,180,105,"m"
2,"VERTICAL TRACTION",1,"Rep04",3480,3460,3450,3500,3470,3475,0.001,-5,3472.5,"Rep",20,-50,FALSE,FALSE,FALSE,0.14,"young",31,180,105,"m"
2,"VERTICAL TRACTION",1,"Rep05",3480,3520,3500,3450,3500,3475,0.007,25,3487.5,"Rep",-40,50,FALSE,FALSE,FALSE,0.72,"young",31,180,105,"m"
2,"VERTICAL TRACTION",1,"Rep06",3220,3200,3200,3250,3210,3225,0.005,-15,3217.5,"Rep",20,-50,FALSE,FALSE,FALSE,0.47,"young",31,180,105,"m"
2,"VERTICAL TRACTION",1,"Rep07",3380,3360,3350,3350,3370,3350,0.006,20,3360,"Rep",20,0,FALSE,FALSE,FALSE,0.6,"young",31,180,105,"m"
2,"VERTICAL TRACTION",1,"Rep08",3260,3280,3300,3250,3270,3275,0.002,-5,3272.5,"Rep",-20,50,FALSE,FALSE,FALSE,0.15,"young",31,180,105,"m"
2,"VERTICAL TRACTION",1,"Rep09",3180,3160,3100,3150,3170,3125,0.014,45,3147.5,"Rep",20,-50,FALSE,FALSE,FALSE,1.44,"young",31,180,105,"m"
2,"VERTICAL TRACTION",1,"Rep10",4280,4320,4450,3800,4300,4125,0.041,175,4212.5,"Rep",-40,650,TRUE,FALSE,TRUE,4.24,"young",31,180,105,"m"
2,"VERTICAL TRACTION",2,"Rep01",3980,3980,4050,4100,3980,4075,0.024,-95,4027.5,"Rep",0,-50,FALSE,FALSE,FALSE,2.33,"young",31,180,105,"m"
2,"VERTICAL TRACTION",2,"Rep02",3600,3620,3600,3600,3610,3600,0.003,10,3605,"Rep",-20,0,FALSE,FALSE,FALSE,0.28,"young",31,180,105,"m"
2,"VERTICAL TRACTION",2,"Rep03",3320,3280,3350,3300,3300,3325,0.008,-25,3312.5,"Rep",40,50,FALSE,FALSE,FALSE,0.75,"young",31,180,105,"m"
2,"VERTICAL TRACTION",2,"Rep04",3040,3060,3050,3000,3050,3025,0.008,25,3037.5,"Rep",-20,50,FALSE,FALSE,FALSE,0.83,"young",31,180,105,"m"
2,"VERTICAL TRACTION",2,"Rep05",2940,2920,2950,2950,2930,2950,0.007,-20,2940,"Rep",20,0,FALSE,FALSE,FALSE,0.68,"young",31,180,105,"m"
2,"VERTICAL TRACTION",2,"Rep06",2960,2980,2900,2950,2970,2925,0.015,45,2947.5,"Rep",-20,-50,FALSE,FALSE,FALSE,1.54,"young",31,180,105,"m"
2,"VERTICAL TRACTION",2,"Rep07",3060,3040,3100,3050,3050,3075,0.008,-25,3062.5,"Rep",20,50,FALSE,FALSE,FALSE,0.81,"young",31,180,105,"m"
2,"VERTICAL TRACTION",2,"Rep08",3300,3320,3250,3250,3310,3250,0.018,60,3280,"Rep",-20,0,FALSE,FALSE,FALSE,1.85,"young",31,180,105,"m"
2,"VERTICAL TRACTION",2,"Rep09",3080,3080,3050,3100,3080,3075,0.002,5,3077.5,"Rep",0,-50,FALSE,FALSE,FALSE,0.16,"young",31,180,105,"m"
2,"VERTICAL TRACTION",2,"Rep10",4020,4020,4200,3550,4020,3875,0.036,145,3947.5,"Rep",0,650,TRUE,FALSE,TRUE,3.74,"young",31,180,105,"m"
2,"VERTICAL TRACTION",1,"TuT",38560,38580,38350,38100,38570,38225,0.009,345,38397.5,"TuT",-20,250,FALSE,FALSE,FALSE,0.9,"young",31,180,105,"m"
2,"VERTICAL TRACTION",2,"TuT",33300,33300,33500,32850,33300,33175,0.004,125,33237.5,"TuT",0,650,FALSE,FALSE,FALSE,0.38,"young",31,180,105,"m"
2,"CHEST PRESS",1,"Con01",1620,1640,2500,1650,1630,2075,0.273,-445,1852.5,"Con",-20,850,TRUE,FALSE,TRUE,21.45,"young",31,180,105,"m"
2,"CHEST PRESS",1,"Con02",1420,1460,1500,1650,1440,1575,0.094,-135,1507.5,"Con",-40,-150,FALSE,TRUE,FALSE,8.57,"young",31,180,105,"m"
2,"CHEST PRESS",1,"Con03",1580,1600,1600,1650,1590,1625,0.022,-35,1607.5,"Con",-20,-50,FALSE,FALSE,FALSE,2.15,"young",31,180,105,"m"
2,"CHEST PRESS",1,"Con04",1600,1600,1700,1500,1600,1600,0,0,1600,"Con",0,200,FALSE,FALSE,FALSE,0,"young",31,180,105,"m"
2,"CHEST PRESS",1,"Con05",1740,1700,2000,1850,1720,1925,0.119,-205,1822.5,"Con",40,150,FALSE,TRUE,FALSE,10.65,"young",31,180,105,"m"
2,"CHEST PRESS",1,"Con06",1780,1760,1900,1950,1770,1925,0.088,-155,1847.5,"Con",20,-50,FALSE,FALSE,FALSE,8.05,"young",31,180,105,"m"
2,"CHEST PRESS",1,"Con07",1620,1640,1800,1750,1630,1775,0.089,-145,1702.5,"Con",-20,50,FALSE,FALSE,FALSE,8.17,"young",31,180,105,"m"
2,"CHEST PRESS",1,"Con08",1700,1660,1750,1850,1680,1800,0.071,-120,1740,"Con",40,-100,FALSE,TRUE,FALSE,6.67,"young",31,180,105,"m"
2,"CHEST PRESS",1,"Con09",1860,1860,1900,2100,1860,2000,0.075,-140,1930,"Con",0,-200,FALSE,FALSE,FALSE,7,"young",31,180,105,"m"
2,"CHEST PRESS",1,"Con10",1860,1880,2200,2350,1870,2275,0.217,-405,2072.5,"Con",-20,-150,TRUE,FALSE,FALSE,17.8,"young",31,180,105,"m"
2,"CHEST PRESS",2,"Con01",1540,1560,1650,1650,1550,1650,0.065,-100,1600,"Con",-20,0,FALSE,FALSE,FALSE,6.06,"young",31,180,105,"m"
2,"CHEST PRESS",2,"Con02",1500,1500,1450,1500,1500,1475,0.017,25,1487.5,"Con",0,-50,FALSE,FALSE,FALSE,1.69,"young",31,180,105,"m"
2,"CHEST PRESS",2,"Con03",1520,1520,1450,1500,1520,1475,0.03,45,1497.5,"Con",0,-50,FALSE,FALSE,FALSE,3.05,"young",31,180,105,"m"
2,"CHEST PRESS",2,"Con04",1420,1420,1450,1450,1420,1450,0.021,-30,1435,"Con",0,0,FALSE,FALSE,FALSE,2.07,"young",31,180,105,"m"
2,"CHEST PRESS",2,"Con05",1480,1500,1600,1500,1490,1550,0.04,-60,1520,"Con",-20,100,FALSE,FALSE,FALSE,3.87,"young",31,180,105,"m"
2,"CHEST PRESS",2,"Con06",1560,1580,1750,1600,1570,1675,0.067,-105,1622.5,"Con",-20,150,FALSE,FALSE,FALSE,6.27,"young",31,180,105,"m"
2,"CHEST PRESS",2,"Con07",1620,1640,1850,1650,1630,1750,0.074,-120,1690,"Con",-20,200,FALSE,FALSE,FALSE,6.86,"young",31,180,105,"m"
2,"CHEST PRESS",2,"Con08",1420,1440,1550,1550,1430,1550,0.084,-120,1490,"Con",-20,0,FALSE,FALSE,FALSE,7.74,"young",31,180,105,"m"
2,"CHEST PRESS",2,"Con09",1520,1540,1600,1800,1530,1700,0.111,-170,1615,"Con",-20,-200,FALSE,FALSE,FALSE,10,"young",31,180,105,"m"
2,"CHEST PRESS",2,"Con10",1480,1500,1600,1750,1490,1675,0.124,-185,1582.5,"Con",-20,-150,FALSE,FALSE,FALSE,11.04,"young",31,180,105,"m"
2,"CHEST PRESS",1,"Ecc01",4540,4540,4450,4500,4540,4475,0.014,65,4507.5,"Ecc",0,-50,FALSE,FALSE,FALSE,1.45,"young",31,180,105,"m"
2,"CHEST PRESS",1,"Ecc02",6260,6220,6250,6050,6240,6150,0.014,90,6195,"Ecc",40,200,FALSE,TRUE,FALSE,1.46,"young",31,180,105,"m"
2,"CHEST PRESS",1,"Ecc03",4640,4620,4600,4600,4630,4600,0.006,30,4615,"Ecc",20,0,FALSE,FALSE,FALSE,0.65,"young",31,180,105,"m"
2,"CHEST PRESS",1,"Ecc04",4540,4540,4350,4650,4540,4500,0.009,40,4520,"Ecc",0,-300,FALSE,FALSE,TRUE,0.89,"young",31,180,105,"m"
2,"CHEST PRESS",1,"Ecc05",4140,4160,3850,3950,4150,3900,0.06,250,4025,"Ecc",-20,-100,FALSE,FALSE,FALSE,6.41,"young",31,180,105,"m"
2,"CHEST PRESS",1,"Ecc06",4400,4440,4300,4250,4420,4275,0.033,145,4347.5,"Ecc",-40,50,FALSE,TRUE,FALSE,3.39,"young",31,180,105,"m"
2,"CHEST PRESS",1,"Ecc07",4000,3980,3900,3850,3990,3875,0.029,115,3932.5,"Ecc",20,50,FALSE,FALSE,FALSE,2.97,"young",31,180,105,"m"
2,"CHEST PRESS",1,"Ecc08",3480,3500,3450,3300,3490,3375,0.033,115,3432.5,"Ecc",-20,150,FALSE,FALSE,FALSE,3.41,"young",31,180,105,"m"
2,"CHEST PRESS",1,"Ecc09",3280,3300,3100,3000,3290,3050,0.073,240,3170,"Ecc",-20,100,FALSE,FALSE,FALSE,7.87,"young",31,180,105,"m"
2,"CHEST PRESS",1,"Ecc10",5320,5300,5150,4950,5310,5050,0.049,260,5180,"Ecc",20,200,FALSE,FALSE,FALSE,5.15,"young",31,180,105,"m"
2,"CHEST PRESS",2,"Ecc01",3860,3860,3900,3850,3860,3875,0.004,-15,3867.5,"Ecc",0,50,FALSE,FALSE,FALSE,0.39,"young",31,180,105,"m"
2,"CHEST PRESS",2,"Ecc02",3180,3200,3250,3200,3190,3225,0.011,-35,3207.5,"Ecc",-20,50,FALSE,FALSE,FALSE,1.09,"young",31,180,105,"m"
2,"CHEST PRESS",2,"Ecc03",2860,2840,2900,2850,2850,2875,0.009,-25,2862.5,"Ecc",20,50,FALSE,FALSE,FALSE,0.87,"young",31,180,105,"m"
2,"CHEST PRESS",2,"Ecc04",2800,2800,2750,2800,2800,2775,0.009,25,2787.5,"Ecc",0,-50,FALSE,FALSE,FALSE,0.9,"young",31,180,105,"m"
2,"CHEST PRESS",2,"Ecc05",2660,2640,2500,2600,2650,2550,0.038,100,2600,"Ecc",20,-100,FALSE,FALSE,FALSE,3.92,"young",31,180,105,"m"
2,"CHEST PRESS",2,"Ecc06",2520,2500,2300,2500,2510,2400,0.044,110,2455,"Ecc",20,-200,FALSE,FALSE,FALSE,4.58,"young",31,180,105,"m"
2,"CHEST PRESS",2,"Ecc07",2720,2700,2500,2650,2710,2575,0.05,135,2642.5,"Ecc",20,-150,FALSE,FALSE,FALSE,5.24,"young",31,180,105,"m"
2,"CHEST PRESS",2,"Ecc08",2600,2580,2550,2400,2590,2475,0.044,115,2532.5,"Ecc",20,150,FALSE,FALSE,FALSE,4.65,"young",31,180,105,"m"
2,"CHEST PRESS",2,"Ecc09",2440,2420,2350,2150,2430,2250,0.074,180,2340,"Ecc",20,200,FALSE,FALSE,FALSE,8,"young",31,180,105,"m"
2,"CHEST PRESS",2,"Ecc10",3780,3780,3750,3700,3780,3725,0.015,55,3752.5,"Ecc",0,50,FALSE,FALSE,FALSE,1.48,"young",31,180,105,"m"
2,"CHEST PRESS",1,"Rep01",6160,6180,6950,6150,6170,6550,0.062,-380,6360,"Rep",-20,800,TRUE,FALSE,TRUE,5.8,"young",31,180,105,"m"
2,"CHEST PRESS",1,"Rep02",7680,7680,7750,7700,7680,7725,0.006,-45,7702.5,"Rep",0,50,FALSE,FALSE,FALSE,0.58,"young",31,180,105,"m"
2,"CHEST PRESS",1,"Rep03",6220,6220,6200,6250,6220,6225,0.001,-5,6222.5,"Rep",0,-50,FALSE,FALSE,FALSE,0.08,"young",31,180,105,"m"
2,"CHEST PRESS",1,"Rep04",6140,6140,6050,6150,6140,6100,0.007,40,6120,"Rep",0,-100,FALSE,FALSE,FALSE,0.66,"young",31,180,105,"m"
2,"CHEST PRESS",1,"Rep05",5880,5860,5850,5800,5870,5825,0.008,45,5847.5,"Rep",20,50,FALSE,FALSE,FALSE,0.77,"young",31,180,105,"m"
2,"CHEST PRESS",1,"Rep06",6180,6200,6200,6200,6190,6200,0.002,-10,6195,"Rep",-20,0,FALSE,FALSE,FALSE,0.16,"young",31,180,105,"m"
2,"CHEST PRESS",1,"Rep07",5620,5620,5700,5600,5620,5650,0.005,-30,5635,"Rep",0,100,FALSE,FALSE,FALSE,0.53,"young",31,180,105,"m"
2,"CHEST PRESS",1,"Rep08",5180,5160,5200,5150,5170,5175,0.001,-5,5172.5,"Rep",20,50,FALSE,FALSE,FALSE,0.1,"young",31,180,105,"m"
2,"CHEST PRESS",1,"Rep09",5140,5160,5000,5100,5150,5050,0.019,100,5100,"Rep",-20,-100,FALSE,FALSE,FALSE,1.98,"young",31,180,105,"m"
2,"CHEST PRESS",1,"Rep10",7180,7180,7350,7300,7180,7325,0.02,-145,7252.5,"Rep",0,50,TRUE,FALSE,FALSE,1.98,"young",31,180,105,"m"
2,"CHEST PRESS",2,"Rep01",5400,5420,5550,5500,5410,5525,0.021,-115,5467.5,"Rep",-20,50,FALSE,FALSE,FALSE,2.08,"young",31,180,105,"m"
2,"CHEST PRESS",2,"Rep02",4680,4700,4700,4700,4690,4700,0.002,-10,4695,"Rep",-20,0,FALSE,FALSE,FALSE,0.21,"young",31,180,105,"m"
2,"CHEST PRESS",2,"Rep03",4380,4360,4350,4350,4370,4350,0.005,20,4360,"Rep",20,0,FALSE,FALSE,FALSE,0.46,"young",31,180,105,"m"
2,"CHEST PRESS",2,"Rep04",4220,4220,4200,4250,4220,4225,0.001,-5,4222.5,"Rep",0,-50,FALSE,FALSE,FALSE,0.12,"young",31,180,105,"m"
2,"CHEST PRESS",2,"Rep05",4140,4140,4100,4100,4140,4100,0.01,40,4120,"Rep",0,0,FALSE,FALSE,FALSE,0.98,"young",31,180,105,"m"
2,"CHEST PRESS",2,"Rep06",4080,4080,4050,4100,4080,4075,0.001,5,4077.5,"Rep",0,-50,FALSE,FALSE,FALSE,0.12,"young",31,180,105,"m"
2,"CHEST PRESS",2,"Rep07",4340,4340,4350,4300,4340,4325,0.003,15,4332.5,"Rep",0,50,FALSE,FALSE,FALSE,0.35,"young",31,180,105,"m"
2,"CHEST PRESS",2,"Rep08",4020,4020,4100,3950,4020,4025,0.001,-5,4022.5,"Rep",0,150,FALSE,FALSE,FALSE,0.12,"young",31,180,105,"m"
2,"CHEST PRESS",2,"Rep09",3960,3960,3950,3950,3960,3950,0.003,10,3955,"Rep",0,0,FALSE,FALSE,FALSE,0.25,"young",31,180,105,"m"
2,"CHEST PRESS",2,"Rep10",5260,5280,5350,5450,5270,5400,0.025,-130,5335,"Rep",-20,-100,FALSE,FALSE,FALSE,2.41,"young",31,180,105,"m"
2,"CHEST PRESS",1,"TuT",61380,61400,62250,61400,61390,61825,0.007,-435,61607.5,"TuT",-20,850,FALSE,FALSE,FALSE,0.7,"young",31,180,105,"m"
2,"CHEST PRESS",2,"TuT",44480,44520,44700,44650,44500,44675,0.004,-175,44587.5,"TuT",-40,50,FALSE,FALSE,FALSE,0.39,"young",31,180,105,"m"
3,"LEG PRESS",1,"Con01",1440,1460,1650,1700,1450,1675,0.155,-225,1562.5,"Con",-20,-50,FALSE,FALSE,FALSE,13.43,"young",29,165,62,"f"
3,"LEG PRESS",1,"Con02",860,880,1050,1000,870,1025,0.178,-155,947.5,"Con",-20,50,FALSE,FALSE,FALSE,15.12,"young",29,165,62,"f"
3,"LEG PRESS",1,"Con03",920,920,1200,1050,920,1125,0.223,-205,1022.5,"Con",0,150,FALSE,FALSE,FALSE,18.22,"young",29,165,62,"f"
3,"LEG PRESS",1,"Con04",900,920,1100,1000,910,1050,0.154,-140,980,"Con",-20,100,FALSE,FALSE,FALSE,13.33,"young",29,165,62,"f"
3,"LEG PRESS",1,"Con05",940,960,1050,1050,950,1050,0.105,-100,1000,"Con",-20,0,FALSE,FALSE,FALSE,9.52,"young",29,165,62,"f"
3,"LEG PRESS",1,"Con06",820,840,1000,1050,830,1025,0.235,-195,927.5,"Con",-20,-50,FALSE,FALSE,FALSE,19.02,"young",29,165,62,"f"
3,"LEG PRESS",1,"Con07",880,900,1100,1550,890,1325,0.489,-435,1107.5,"Con",-20,-450,TRUE,FALSE,TRUE,32.83,"young",29,165,62,"f"
3,"LEG PRESS",1,"Con08",880,920,1750,2000,900,1875,1.083,-975,1387.5,"Con",-40,-250,TRUE,FALSE,TRUE,52,"young",29,165,62,"f"
3,"LEG PRESS",1,"Con09",900,900,1950,2050,900,2000,1.222,-1100,1450,"Con",0,-100,TRUE,FALSE,FALSE,55,"young",29,165,62,"f"
3,"LEG PRESS",1,"Con10",960,980,1750,1800,970,1775,0.83,-805,1372.5,"Con",-20,-50,TRUE,FALSE,FALSE,45.35,"young",29,165,62,"f"
3,"LEG PRESS",2,"Con01",1200,1220,1350,1400,1210,1375,0.136,-165,1292.5,"Con",-20,-50,FALSE,FALSE,FALSE,12,"young",29,165,62,"f"
3,"LEG PRESS",2,"Con02",1000,1020,1100,1100,1010,1100,0.089,-90,1055,"Con",-20,0,FALSE,FALSE,FALSE,8.18,"young",29,165,62,"f"
3,"LEG PRESS",2,"Con03",1060,1080,1200,1100,1070,1150,0.075,-80,1110,"Con",-20,100,FALSE,FALSE,FALSE,6.96,"young",29,165,62,"f"
3,"LEG PRESS",2,"Con04",1020,1020,1150,1150,1020,1150,0.127,-130,1085,"Con",0,0,FALSE,FALSE,FALSE,11.3,"young",29,165,62,"f"
3,"LEG PRESS",2,"Con05",1000,1060,1150,1150,1030,1150,0.117,-120,1090,"Con",-60,0,FALSE,FALSE,FALSE,10.43,"young",29,165,62,"f"
3,"LEG PRESS",2,"Con06",1000,1040,1250,1250,1020,1250,0.225,-230,1135,"Con",-40,0,FALSE,FALSE,FALSE,18.4,"young",29,165,62,"f"
3,"LEG PRESS",2,"Con07",1040,1060,1250,1650,1050,1450,0.381,-400,1250,"Con",-20,-400,TRUE,FALSE,TRUE,27.59,"young",29,165,62,"f"
3,"LEG PRESS",2,"Con08",1020,1020,1650,1600,1020,1625,0.593,-605,1322.5,"Con",0,50,TRUE,FALSE,FALSE,37.23,"young",29,165,62,"f"
3,"LEG PRESS",2,"Con09",1080,1100,2050,2100,1090,2075,0.904,-985,1582.5,"Con",-20,-50,TRUE,FALSE,FALSE,47.47,"young",29,165,62,"f"
3,"LEG PRESS",2,"Con10",920,940,1600,1650,930,1625,0.747,-695,1277.5,"Con",-20,-50,TRUE,FALSE,FALSE,42.77,"young",29,165,62,"f"
3,"LEG PRESS",1,"Ecc01",2500,2460,2350,2400,2480,2375,0.042,105,2427.5,"Ecc",40,-50,FALSE,FALSE,FALSE,4.42,"young",29,165,62,"f"
3,"LEG PRESS",1,"Ecc02",2420,2400,2150,2250,2410,2200,0.087,210,2305,"Ecc",20,-100,FALSE,FALSE,FALSE,9.55,"young",29,165,62,"f"
3,"LEG PRESS",1,"Ecc03",2600,2600,2350,2500,2600,2425,0.067,175,2512.5,"Ecc",0,-150,FALSE,FALSE,FALSE,7.22,"young",29,165,62,"f"
3,"LEG PRESS",1,"Ecc04",2340,2320,2200,2250,2330,2225,0.045,105,2277.5,"Ecc",20,-50,FALSE,FALSE,FALSE,4.72,"young",29,165,62,"f"
3,"LEG PRESS",1,"Ecc05",2520,2500,2400,2350,2510,2375,0.054,135,2442.5,"Ecc",20,50,FALSE,FALSE,FALSE,5.68,"young",29,165,62,"f"
3,"LEG PRESS",1,"Ecc06",2360,2340,2150,2100,2350,2125,0.096,225,2237.5,"Ecc",20,50,FALSE,FALSE,FALSE,10.59,"young",29,165,62,"f"
3,"LEG PRESS",1,"Ecc07",2400,2380,2100,1650,2390,1875,0.215,515,2132.5,"Ecc",20,450,TRUE,FALSE,TRUE,27.47,"young",29,165,62,"f"
3,"LEG PRESS",1,"Ecc08",2660,2640,1700,1400,2650,1550,0.415,1100,2100,"Ecc",20,300,TRUE,FALSE,TRUE,70.97,"young",29,165,62,"f"
3,"LEG PRESS",1,"Ecc09",2600,2580,1450,1400,2590,1425,0.45,1165,2007.5,"Ecc",20,50,TRUE,FALSE,FALSE,81.75,"young",29,165,62,"f"
3,"LEG PRESS",1,"Ecc10",1940,1940,1550,1500,1940,1525,0.214,415,1732.5,"Ecc",0,50,TRUE,FALSE,FALSE,27.21,"young",29,165,62,"f"
3,"LEG PRESS",2,"Ecc01",2480,2460,2400,2350,2470,2375,0.038,95,2422.5,"Ecc",20,50,FALSE,FALSE,FALSE,4,"young",29,165,62,"f"
3,"LEG PRESS",2,"Ecc02",2480,2460,2350,2450,2470,2400,0.028,70,2435,"Ecc",20,-100,FALSE,FALSE,FALSE,2.92,"young",29,165,62,"f"
3,"LEG PRESS",2,"Ecc03",2340,2340,2200,2250,2340,2225,0.049,115,2282.5,"Ecc",0,-50,FALSE,FALSE,FALSE,5.17,"young",29,165,62,"f"
3,"LEG PRESS",2,"Ecc04",2400,2360,2300,2250,2380,2275,0.044,105,2327.5,"Ecc",40,50,FALSE,FALSE,FALSE,4.62,"young",29,165,62,"f"
3,"LEG PRESS",2,"Ecc05",2280,2220,2050,2100,2250,2075,0.078,175,2162.5,"Ecc",60,-50,FALSE,FALSE,FALSE,8.43,"young",29,165,62,"f"
3,"LEG PRESS",2,"Ecc06",2320,2300,2100,2050,2310,2075,0.102,235,2192.5,"Ecc",20,50,FALSE,FALSE,FALSE,11.33,"young",29,165,62,"f"
3,"LEG PRESS",2,"Ecc07",2220,2220,1950,1600,2220,1775,0.2,445,1997.5,"Ecc",0,350,TRUE,FALSE,TRUE,25.07,"young",29,165,62,"f"
3,"LEG PRESS",2,"Ecc08",2260,2240,1550,1550,2250,1550,0.311,700,1900,"Ecc",20,0,TRUE,FALSE,FALSE,45.16,"young",29,165,62,"f"
3,"LEG PRESS",2,"Ecc09",2540,2520,1450,1350,2530,1400,0.447,1130,1965,"Ecc",20,100,TRUE,FALSE,FALSE,80.71,"young",29,165,62,"f"
3,"LEG PRESS",2,"Ecc10",1480,1460,1150,1250,1470,1200,0.184,270,1335,"Ecc",20,-100,FALSE,FALSE,FALSE,22.5,"young",29,165,62,"f"
3,"LEG PRESS",1,"Rep01",3940,3920,4000,4100,3930,4050,0.031,-120,3990,"Rep",20,-100,TRUE,FALSE,TRUE,2.96,"young",29,165,62,"f"
3,"LEG PRESS",1,"Rep02",3280,3280,3200,3250,3280,3225,0.017,55,3252.5,"Rep",0,-50,FALSE,FALSE,FALSE,1.71,"young",29,165,62,"f"
3,"LEG PRESS",1,"Rep03",3520,3520,3550,3550,3520,3550,0.009,-30,3535,"Rep",0,0,FALSE,FALSE,FALSE,0.85,"young",29,165,62,"f"
3,"LEG PRESS",1,"Rep04",3240,3240,3300,3250,3240,3275,0.011,-35,3257.5,"Rep",0,50,FALSE,FALSE,FALSE,1.07,"young",29,165,62,"f"
3,"LEG PRESS",1,"Rep05",3460,3460,3450,3400,3460,3425,0.01,35,3442.5,"Rep",0,50,FALSE,FALSE,FALSE,1.02,"young",29,165,62,"f"
3,"LEG PRESS",1,"Rep06",3180,3180,3150,3150,3180,3150,0.009,30,3165,"Rep",0,0,FALSE,FALSE,FALSE,0.95,"young",29,165,62,"f"
3,"LEG PRESS",1,"Rep07",3280,3280,3200,3200,3280,3200,0.024,80,3240,"Rep",0,0,FALSE,FALSE,FALSE,2.5,"young",29,165,62,"f"
3,"LEG PRESS",1,"Rep08",3540,3560,3450,3400,3550,3425,0.035,125,3487.5,"Rep",-20,50,TRUE,FALSE,FALSE,3.65,"young",29,165,62,"f"
3,"LEG PRESS",1,"Rep09",3500,3480,3400,3450,3490,3425,0.019,65,3457.5,"Rep",20,-50,FALSE,FALSE,FALSE,1.9,"young",29,165,62,"f"
3,"LEG PRESS",1,"Rep10",2900,2920,3300,3300,2910,3300,0.134,-390,3105,"Rep",-20,0,TRUE,FALSE,FALSE,11.82,"young",29,165,62,"f"
3,"LEG PRESS",2,"Rep01",3680,3680,3750,3750,3680,3750,0.019,-70,3715,"Rep",0,0,FALSE,FALSE,FALSE,1.87,"young",29,165,62,"f"
3,"LEG PRESS",2,"Rep02",3480,3480,3450,3550,3480,3500,0.006,-20,3490,"Rep",0,-100,FALSE,FALSE,TRUE,0.57,"young",29,165,62,"f"
3,"LEG PRESS",2,"Rep03",3400,3420,3400,3350,3410,3375,0.01,35,3392.5,"Rep",-20,50,FALSE,FALSE,FALSE,1.04,"young",29,165,62,"f"
3,"LEG PRESS",2,"Rep04",3420,3380,3450,3400,3400,3425,0.007,-25,3412.5,"Rep",40,50,FALSE,FALSE,FALSE,0.73,"young",29,165,62,"f"
3,"LEG PRESS",2,"Rep05",3280,3280,3200,3250,3280,3225,0.017,55,3252.5,"Rep",0,-50,FALSE,FALSE,FALSE,1.71,"young",29,165,62,"f"
3,"LEG PRESS",2,"Rep06",3320,3340,3350,3300,3330,3325,0.002,5,3327.5,"Rep",-20,50,FALSE,FALSE,FALSE,0.15,"young",29,165,62,"f"
3,"LEG PRESS",2,"Rep07",3260,3280,3200,3250,3270,3225,0.014,45,3247.5,"Rep",-20,-50,FALSE,FALSE,FALSE,1.4,"young",29,165,62,"f"
3,"LEG PRESS",2,"Rep08",3280,3260,3200,3150,3270,3175,0.029,95,3222.5,"Rep",20,50,FALSE,FALSE,FALSE,2.99,"young",29,165,62,"f"
3,"LEG PRESS",2,"Rep09",3620,3620,3500,3450,3620,3475,0.04,145,3547.5,"Rep",0,50,TRUE,FALSE,FALSE,4.17,"young",29,165,62,"f"
3,"LEG PRESS",2,"Rep10",2400,2400,2750,2900,2400,2825,0.177,-425,2612.5,"Rep",0,-150,TRUE,FALSE,TRUE,15.04,"young",29,165,62,"f"
3,"LEG PRESS",1,"TuT",33840,33840,34000,34050,33840,34025,0.005,-185,33932.5,"TuT",0,-50,FALSE,FALSE,FALSE,0.54,"young",29,165,62,"f"
3,"LEG PRESS",2,"TuT",33140,33140,33250,33350,33140,33300,0.005,-160,33220,"TuT",0,-100,FALSE,FALSE,FALSE,0.48,"young",29,165,62,"f"
3,"LEG EXTENSION",1,"Con01",1340,1380,1550,1450,1360,1500,0.103,-140,1430,"Con",-40,100,FALSE,TRUE,FALSE,9.33,"young",29,165,62,"f"
3,"LEG EXTENSION",1,"Con02",1080,1080,1150,1150,1080,1150,0.065,-70,1115,"Con",0,0,FALSE,FALSE,FALSE,6.09,"young",29,165,62,"f"
3,"LEG EXTENSION",1,"Con03",1040,1040,1100,1100,1040,1100,0.058,-60,1070,"Con",0,0,FALSE,FALSE,FALSE,5.45,"young",29,165,62,"f"
3,"LEG EXTENSION",1,"Con04",1000,1020,1100,1100,1010,1100,0.089,-90,1055,"Con",-20,0,FALSE,FALSE,FALSE,8.18,"young",29,165,62,"f"
3,"LEG EXTENSION",1,"Con05",1040,1020,1100,1100,1030,1100,0.068,-70,1065,"Con",20,0,FALSE,FALSE,FALSE,6.36,"young",29,165,62,"f"
3,"LEG EXTENSION",1,"Con06",1020,1020,1100,1100,1020,1100,0.078,-80,1060,"Con",0,0,FALSE,FALSE,FALSE,7.27,"young",29,165,62,"f"
3,"LEG EXTENSION",1,"Con07",1020,1040,1100,1100,1030,1100,0.068,-70,1065,"Con",-20,0,FALSE,FALSE,FALSE,6.36,"young",29,165,62,"f"
3,"LEG EXTENSION",1,"Con08",960,960,1100,1100,960,1100,0.146,-140,1030,"Con",0,0,FALSE,FALSE,FALSE,12.73,"young",29,165,62,"f"
3,"LEG EXTENSION",1,"Con09",1020,1040,1150,1200,1030,1175,0.141,-145,1102.5,"Con",-20,-50,FALSE,FALSE,FALSE,12.34,"young",29,165,62,"f"
3,"LEG EXTENSION",1,"Con10",1100,1080,1200,1300,1090,1250,0.147,-160,1170,"Con",20,-100,FALSE,FALSE,FALSE,12.8,"young",29,165,62,"f"
3,"LEG EXTENSION",2,"Con01",1140,1180,1300,1350,1160,1325,0.142,-165,1242.5,"Con",-40,-50,FALSE,TRUE,FALSE,12.45,"young",29,165,62,"f"
3,"LEG EXTENSION",2,"Con02",1020,1020,1050,1000,1020,1025,0.005,-5,1022.5,"Con",0,50,FALSE,FALSE,FALSE,0.49,"young",29,165,62,"f"
3,"LEG EXTENSION",2,"Con03",1000,1020,1050,1050,1010,1050,0.04,-40,1030,"Con",-20,0,FALSE,FALSE,FALSE,3.81,"young",29,165,62,"f"
3,"LEG EXTENSION",2,"Con04",1040,1040,1100,1100,1040,1100,0.058,-60,1070,"Con",0,0,FALSE,FALSE,FALSE,5.45,"young",29,165,62,"f"
3,"LEG EXTENSION",2,"Con05",960,940,1050,1000,950,1025,0.079,-75,987.5,"Con",20,50,FALSE,FALSE,FALSE,7.32,"young",29,165,62,"f"
3,"LEG EXTENSION",2,"Con06",1060,1060,1150,1150,1060,1150,0.085,-90,1105,"Con",0,0,FALSE,FALSE,FALSE,7.83,"young",29,165,62,"f"
3,"LEG EXTENSION",2,"Con07",1040,1020,1150,1150,1030,1150,0.117,-120,1090,"Con",20,0,FALSE,FALSE,FALSE,10.43,"young",29,165,62,"f"
3,"LEG EXTENSION",2,"Con08",1040,1060,1200,1150,1050,1175,0.119,-125,1112.5,"Con",-20,50,FALSE,FALSE,FALSE,10.64,"young",29,165,62,"f"
3,"LEG EXTENSION",2,"Con09",960,940,1050,1100,950,1075,0.132,-125,1012.5,"Con",20,-50,FALSE,FALSE,FALSE,11.63,"young",29,165,62,"f"
3,"LEG EXTENSION",2,"Con10",940,940,1150,1150,940,1150,0.223,-210,1045,"Con",0,0,TRUE,FALSE,FALSE,18.26,"young",29,165,62,"f"
3,"LEG EXTENSION",1,"Ecc01",2500,2500,2450,2450,2500,2450,0.02,50,2475,"Ecc",0,0,FALSE,FALSE,FALSE,2.04,"young",29,165,62,"f"
3,"LEG EXTENSION",1,"Ecc02",2140,2120,2050,2050,2130,2050,0.038,80,2090,"Ecc",20,0,FALSE,FALSE,FALSE,3.9,"young",29,165,62,"f"
3,"LEG EXTENSION",1,"Ecc03",2100,2100,2050,2050,2100,2050,0.024,50,2075,"Ecc",0,0,FALSE,FALSE,FALSE,2.44,"young",29,165,62,"f"
3,"LEG EXTENSION",1,"Ecc04",1980,2000,1900,1900,1990,1900,0.045,90,1945,"Ecc",-20,0,FALSE,FALSE,FALSE,4.74,"young",29,165,62,"f"
3,"LEG EXTENSION",1,"Ecc05",2140,2120,2050,2050,2130,2050,0.038,80,2090,"Ecc",20,0,FALSE,FALSE,FALSE,3.9,"young",29,165,62,"f"
3,"LEG EXTENSION",1,"Ecc06",2020,2020,1950,1950,2020,1950,0.035,70,1985,"Ecc",0,0,FALSE,FALSE,FALSE,3.59,"young",29,165,62,"f"
3,"LEG EXTENSION",1,"Ecc07",2080,2060,1950,1950,2070,1950,0.058,120,2010,"Ecc",20,0,FALSE,FALSE,FALSE,6.15,"young",29,165,62,"f"
3,"LEG EXTENSION",1,"Ecc08",2020,2020,1900,1900,2020,1900,0.059,120,1960,"Ecc",0,0,FALSE,FALSE,FALSE,6.32,"young",29,165,62,"f"
3,"LEG EXTENSION",1,"Ecc09",1860,1880,1750,1650,1870,1700,0.091,170,1785,"Ecc",-20,100,FALSE,FALSE,FALSE,10,"young",29,165,62,"f"
3,"LEG EXTENSION",1,"Ecc10",2220,2180,2200,2200,2200,2200,0,0,2200,"Ecc",40,0,FALSE,TRUE,FALSE,0,"young",29,165,62,"f"
3,"LEG EXTENSION",2,"Ecc01",1640,1640,1600,1600,1640,1600,0.024,40,1620,"Ecc",0,0,FALSE,FALSE,FALSE,2.5,"young",29,165,62,"f"
3,"LEG EXTENSION",2,"Ecc02",1660,1640,1600,1650,1650,1625,0.015,25,1637.5,"Ecc",20,-50,FALSE,FALSE,FALSE,1.54,"young",29,165,62,"f"
3,"LEG EXTENSION",2,"Ecc03",1720,1720,1650,1650,1720,1650,0.041,70,1685,"Ecc",0,0,FALSE,FALSE,FALSE,4.24,"young",29,165,62,"f"
3,"LEG EXTENSION",2,"Ecc04",1560,1560,1500,1500,1560,1500,0.038,60,1530,"Ecc",0,0,FALSE,FALSE,FALSE,4,"young",29,165,62,"f"
3,"LEG EXTENSION",2,"Ecc05",1640,1660,1550,1600,1650,1575,0.045,75,1612.5,"Ecc",-20,-50,FALSE,FALSE,FALSE,4.76,"young",29,165,62,"f"
3,"LEG EXTENSION",2,"Ecc06",1720,1720,1600,1600,1720,1600,0.07,120,1660,"Ecc",0,0,FALSE,FALSE,FALSE,7.5,"young",29,165,62,"f"
3,"LEG EXTENSION",2,"Ecc07",1880,1880,1750,1750,1880,1750,0.069,130,1815,"Ecc",0,0,FALSE,FALSE,FALSE,7.43,"young",29,165,62,"f"
3,"LEG EXTENSION",2,"Ecc08",1600,1600,1500,1500,1600,1500,0.062,100,1550,"Ecc",0,0,FALSE,FALSE,FALSE,6.67,"young",29,165,62,"f"
3,"LEG EXTENSION",2,"Ecc09",1980,2000,1800,1750,1990,1775,0.108,215,1882.5,"Ecc",-20,50,TRUE,FALSE,FALSE,12.11,"young",29,165,62,"f"
3,"LEG EXTENSION",2,"Ecc10",1980,1960,1950,2000,1970,1975,0.003,-5,1972.5,"Ecc",20,-50,FALSE,FALSE,FALSE,0.25,"young",29,165,62,"f"
3,"LEG EXTENSION",1,"Rep01",3840,3880,4000,3900,3860,3950,0.023,-90,3905,"Rep",-40,100,FALSE,FALSE,FALSE,2.28,"young",29,165,62,"f"
3,"LEG EXTENSION",1,"Rep02",3220,3200,3200,3200,3210,3200,0.003,10,3205,"Rep",20,0,FALSE,FALSE,FALSE,0.31,"young",29,165,62,"f"
3,"LEG EXTENSION",1,"Rep03",3140,3140,3150,3150,3140,3150,0.003,-10,3145,"Rep",0,0,FALSE,FALSE,FALSE,0.32,"young",29,165,62,"f"
3,"LEG EXTENSION",1,"Rep04",2980,3020,3000,3000,3000,3000,0,0,3000,"Rep",-40,0,FALSE,FALSE,FALSE,0,"young",29,165,62,"f"
3,"LEG EXTENSION",1,"Rep05",3180,3140,3150,3150,3160,3150,0.003,10,3155,"Rep",40,0,FALSE,FALSE,FALSE,0.32,"young",29,165,62,"f"
3,"LEG EXTENSION",1,"Rep06",3040,3040,3050,3050,3040,3050,0.003,-10,3045,"Rep",0,0,FALSE,FALSE,FALSE,0.33,"young",29,165,62,"f"
3,"LEG EXTENSION",1,"Rep07",3100,3100,3050,3050,3100,3050,0.016,50,3075,"Rep",0,0,FALSE,FALSE,FALSE,1.64,"young",29,165,62,"f"
3,"LEG EXTENSION",1,"Rep08",2980,2980,3000,3000,2980,3000,0.007,-20,2990,"Rep",0,0,FALSE,FALSE,FALSE,0.67,"young",29,165,62,"f"
3,"LEG EXTENSION",1,"Rep09",2880,2920,2900,2850,2900,2875,0.009,25,2887.5,"Rep",-40,50,FALSE,FALSE,FALSE,0.87,"young",29,165,62,"f"
3,"LEG EXTENSION",1,"Rep10",3320,3260,3400,3500,3290,3450,0.049,-160,3370,"Rep",60,-100,TRUE,FALSE,FALSE,4.64,"young",29,165,62,"f"
3,"LEG EXTENSION",2,"Rep01",2780,2820,2900,2950,2800,2925,0.045,-125,2862.5,"Rep",-40,-50,TRUE,FALSE,FALSE,4.27,"young",29,165,62,"f"
3,"LEG EXTENSION",2,"Rep02",2680,2660,2650,2650,2670,2650,0.007,20,2660,"Rep",20,0,FALSE,FALSE,FALSE,0.75,"young",29,165,62,"f"
3,"LEG EXTENSION",2,"Rep03",2720,2740,2700,2700,2730,2700,0.011,30,2715,"Rep",-20,0,FALSE,FALSE,FALSE,1.11,"young",29,165,62,"f"
3,"LEG EXTENSION",2,"Rep04",2600,2600,2600,2600,2600,2600,0,0,2600,"Rep",0,0,FALSE,FALSE,FALSE,0,"young",29,165,62,"f"
3,"LEG EXTENSION",2,"Rep05",2600,2600,2600,2600,2600,2600,0,0,2600,"Rep",0,0,FALSE,FALSE,FALSE,0,"young",29,165,62,"f"
3,"LEG EXTENSION",2,"Rep06",2780,2780,2750,2750,2780,2750,0.011,30,2765,"Rep",0,0,FALSE,FALSE,FALSE,1.09,"young",29,165,62,"f"
3,"LEG EXTENSION",2,"Rep07",2920,2900,2900,2900,2910,2900,0.003,10,2905,"Rep",20,0,FALSE,FALSE,FALSE,0.34,"young",29,165,62,"f"
3,"LEG EXTENSION",2,"Rep08",2640,2660,2700,2650,2650,2675,0.009,-25,2662.5,"Rep",-20,50,FALSE,FALSE,FALSE,0.93,"young",29,165,62,"f"
3,"LEG EXTENSION",2,"Rep09",2940,2940,2850,2850,2940,2850,0.031,90,2895,"Rep",0,0,FALSE,FALSE,FALSE,3.16,"young",29,165,62,"f"
3,"LEG EXTENSION",2,"Rep10",2920,2900,3100,3150,2910,3125,0.074,-215,3017.5,"Rep",20,-50,TRUE,FALSE,FALSE,6.88,"young",29,165,62,"f"
3,"LEG EXTENSION",1,"TuT",31680,31680,31900,31850,31680,31875,0.006,-195,31777.5,"TuT",0,50,TRUE,FALSE,FALSE,0.61,"young",29,165,62,"f"
3,"LEG EXTENSION",2,"TuT",27580,27600,27750,27800,27590,27775,0.007,-185,27682.5,"TuT",-20,-50,TRUE,FALSE,FALSE,0.67,"young",29,165,62,"f"
3,"LEG CURL",1,"Con01",1640,1640,1700,1550,1640,1625,0.009,15,1632.5,"Con",0,150,FALSE,FALSE,FALSE,0.92,"young",29,165,62,"f"
3,"LEG CURL",1,"Con02",1460,1480,1550,1500,1470,1525,0.037,-55,1497.5,"Con",-20,50,FALSE,FALSE,FALSE,3.61,"young",29,165,62,"f"
3,"LEG CURL",1,"Con03",1200,1220,1150,1200,1210,1175,0.029,35,1192.5,"Con",-20,-50,FALSE,FALSE,FALSE,2.98,"young",29,165,62,"f"
3,"LEG CURL",1,"Con04",1240,1260,1200,1250,1250,1225,0.02,25,1237.5,"Con",-20,-50,FALSE,FALSE,FALSE,2.04,"young",29,165,62,"f"
3,"LEG CURL",1,"Con05",1180,1220,1200,1300,1200,1250,0.042,-50,1225,"Con",-40,-100,FALSE,FALSE,FALSE,4,"young",29,165,62,"f"
3,"LEG CURL",1,"Con06",1240,1240,1400,1400,1240,1400,0.129,-160,1320,"Con",0,0,FALSE,FALSE,FALSE,11.43,"young",29,165,62,"f"
3,"LEG CURL",1,"Con07",1240,1240,1350,1400,1240,1375,0.109,-135,1307.5,"Con",0,-50,FALSE,FALSE,FALSE,9.82,"young",29,165,62,"f"
3,"LEG CURL",1,"Con08",1260,1280,1400,1400,1270,1400,0.102,-130,1335,"Con",-20,0,FALSE,FALSE,FALSE,9.29,"young",29,165,62,"f"
3,"LEG CURL",1,"Con09",1180,1240,1400,1350,1210,1375,0.136,-165,1292.5,"Con",-60,50,FALSE,FALSE,FALSE,12,"young",29,165,62,"f"
3,"LEG CURL",1,"Con10",1320,1320,1550,1500,1320,1525,0.155,-205,1422.5,"Con",0,50,FALSE,FALSE,FALSE,13.44,"young",29,165,62,"f"
3,"LEG CURL",2,"Con01",1440,1420,1500,1400,1430,1450,0.014,-20,1440,"Con",20,100,FALSE,FALSE,FALSE,1.38,"young",29,165,62,"f"
3,"LEG CURL",2,"Con02",1360,1420,1450,1450,1390,1450,0.043,-60,1420,"Con",-60,0,FALSE,FALSE,FALSE,4.14,"young",29,165,62,"f"
3,"LEG CURL",2,"Con03",1380,1420,1450,1450,1400,1450,0.036,-50,1425,"Con",-40,0,FALSE,FALSE,FALSE,3.45,"young",29,165,62,"f"
3,"LEG CURL",2,"Con04",1220,1220,1250,1250,1220,1250,0.025,-30,1235,"Con",0,0,FALSE,FALSE,FALSE,2.4,"young",29,165,62,"f"
3,"LEG CURL",2,"Con05",1180,1200,1200,1200,1190,1200,0.008,-10,1195,"Con",-20,0,FALSE,FALSE,FALSE,0.83,"young",29,165,62,"f"
3,"LEG CURL",2,"Con06",1200,1200,1250,1200,1200,1225,0.021,-25,1212.5,"Con",0,50,FALSE,FALSE,FALSE,2.04,"young",29,165,62,"f"
3,"LEG CURL",2,"Con07",1100,1120,1150,1150,1110,1150,0.036,-40,1130,"Con",-20,0,FALSE,FALSE,FALSE,3.48,"young",29,165,62,"f"
3,"LEG CURL",2,"Con08",1140,1140,1200,1150,1140,1175,0.031,-35,1157.5,"Con",0,50,FALSE,FALSE,FALSE,2.98,"young",29,165,62,"f"
3,"LEG CURL",2,"Con09",1360,1360,2250,2200,1360,2225,0.636,-865,1792.5,"Con",0,50,TRUE,FALSE,FALSE,38.88,"young",29,165,62,"f"
3,"LEG CURL",2,"Con10",1180,1200,1800,2300,1190,2050,0.723,-860,1620,"Con",-20,-500,TRUE,FALSE,TRUE,41.95,"young",29,165,62,"f"
3,"LEG CURL",1,"Ecc01",2120,2100,2000,2050,2110,2025,0.04,85,2067.5,"Ecc",20,-50,FALSE,FALSE,FALSE,4.2,"young",29,165,62,"f"
3,"LEG CURL",1,"Ecc02",2140,2120,2150,2150,2130,2150,0.009,-20,2140,"Ecc",20,0,FALSE,FALSE,FALSE,0.93,"young",29,165,62,"f"
3,"LEG CURL",1,"Ecc03",2340,2320,2400,2350,2330,2375,0.019,-45,2352.5,"Ecc",20,50,FALSE,FALSE,FALSE,1.89,"young",29,165,62,"f"
3,"LEG CURL",1,"Ecc04",2300,2260,2300,2200,2280,2250,0.013,30,2265,"Ecc",40,100,FALSE,FALSE,FALSE,1.33,"young",29,165,62,"f"
3,"LEG CURL",1,"Ecc05",2300,2300,2200,2150,2300,2175,0.054,125,2237.5,"Ecc",0,50,FALSE,FALSE,FALSE,5.75,"young",29,165,62,"f"
3,"LEG CURL",1,"Ecc06",2600,2600,2450,2450,2600,2450,0.058,150,2525,"Ecc",0,0,FALSE,FALSE,FALSE,6.12,"young",29,165,62,"f"
3,"LEG CURL",1,"Ecc07",2460,2440,2350,2300,2450,2325,0.051,125,2387.5,"Ecc",20,50,FALSE,FALSE,FALSE,5.38,"young",29,165,62,"f"
3,"LEG CURL",1,"Ecc08",2340,2300,2150,2200,2320,2175,0.062,145,2247.5,"Ecc",40,-50,FALSE,FALSE,FALSE,6.67,"young",29,165,62,"f"
3,"LEG CURL",1,"Ecc09",2540,2520,2300,2350,2530,2325,0.081,205,2427.5,"Ecc",20,-50,FALSE,FALSE,FALSE,8.82,"young",29,165,62,"f"
3,"LEG CURL",1,"Ecc10",2240,2220,1950,2150,2230,2050,0.081,180,2140,"Ecc",20,-200,FALSE,FALSE,TRUE,8.78,"young",29,165,62,"f"
3,"LEG CURL",2,"Ecc01",1980,1920,1900,1900,1950,1900,0.026,50,1925,"Ecc",60,0,FALSE,FALSE,FALSE,2.63,"young",29,165,62,"f"
3,"LEG CURL",2,"Ecc02",1940,1900,1850,1850,1920,1850,0.036,70,1885,"Ecc",40,0,FALSE,FALSE,FALSE,3.78,"young",29,165,62,"f"
3,"LEG CURL",2,"Ecc03",2060,2060,2050,2050,2060,2050,0.005,10,2055,"Ecc",0,0,FALSE,FALSE,FALSE,0.49,"young",29,165,62,"f"
3,"LEG CURL",2,"Ecc04",1860,1840,1850,1850,1850,1850,0,0,1850,"Ecc",20,0,FALSE,FALSE,FALSE,0,"young",29,165,62,"f"
3,"LEG CURL",2,"Ecc05",2140,2140,2100,2100,2140,2100,0.019,40,2120,"Ecc",0,0,FALSE,FALSE,FALSE,1.9,"young",29,165,62,"f"
3,"LEG CURL",2,"Ecc06",2120,2100,2050,2100,2110,2075,0.017,35,2092.5,"Ecc",20,-50,FALSE,FALSE,FALSE,1.69,"young",29,165,62,"f"
3,"LEG CURL",2,"Ecc07",1960,1960,1950,1950,1960,1950,0.005,10,1955,"Ecc",0,0,FALSE,FALSE,FALSE,0.51,"young",29,165,62,"f"
3,"LEG CURL",2,"Ecc08",2100,2100,1250,1400,2100,1325,0.369,775,1712.5,"Ecc",0,-150,TRUE,FALSE,FALSE,58.49,"young",29,165,62,"f"
3,"LEG CURL",2,"Ecc09",2400,2380,1750,1200,2390,1475,0.383,915,1932.5,"Ecc",20,550,TRUE,FALSE,TRUE,62.03,"young",29,165,62,"f"
3,"LEG CURL",2,"Ecc10",2500,2480,2450,2450,2490,2450,0.016,40,2470,"Ecc",20,0,FALSE,FALSE,FALSE,1.63,"young",29,165,62,"f"
3,"LEG CURL",1,"Rep01",3760,3740,3700,3600,3750,3650,0.027,100,3700,"Rep",20,100,FALSE,FALSE,FALSE,2.74,"young",29,165,62,"f"
3,"LEG CURL",1,"Rep02",3600,3600,3700,3650,3600,3675,0.021,-75,3637.5,"Rep",0,50,FALSE,FALSE,FALSE,2.04,"young",29,165,62,"f"
3,"LEG CURL",1,"Rep03",3540,3540,3550,3550,3540,3550,0.003,-10,3545,"Rep",0,0,FALSE,FALSE,FALSE,0.28,"young",29,165,62,"f"
3,"LEG CURL",1,"Rep04",3540,3520,3500,3450,3530,3475,0.016,55,3502.5,"Rep",20,50,FALSE,FALSE,FALSE,1.58,"young",29,165,62,"f"
3,"LEG CURL",1,"Rep05",3480,3520,3400,3450,3500,3425,0.021,75,3462.5,"Rep",-40,-50,FALSE,FALSE,FALSE,2.19,"young",29,165,62,"f"
3,"LEG CURL",1,"Rep06",3840,3840,3850,3850,3840,3850,0.003,-10,3845,"Rep",0,0,FALSE,FALSE,FALSE,0.26,"young",29,165,62,"f"
3,"LEG CURL",1,"Rep07",3700,3680,3700,3700,3690,3700,0.003,-10,3695,"Rep",20,0,FALSE,FALSE,FALSE,0.27,"young",29,165,62,"f"
3,"LEG CURL",1,"Rep08",3600,3580,3550,3600,3590,3575,0.004,15,3582.5,"Rep",20,-50,FALSE,FALSE,FALSE,0.42,"young",29,165,62,"f"
3,"LEG CURL",1,"Rep09",3720,3760,3700,3700,3740,3700,0.011,40,3720,"Rep",-40,0,FALSE,FALSE,FALSE,1.08,"young",29,165,62,"f"
3,"LEG CURL",1,"Rep10",3560,3540,3500,3650,3550,3575,0.007,-25,3562.5,"Rep",20,-150,FALSE,FALSE,FALSE,0.7,"young",29,165,62,"f"
3,"LEG CURL",2,"Rep01",3420,3340,3400,3300,3380,3350,0.009,30,3365,"Rep",80,100,FALSE,TRUE,FALSE,0.9,"young",29,165,62,"f"
3,"LEG CURL",2,"Rep02",3300,3320,3300,3300,3310,3300,0.003,10,3305,"Rep",-20,0,FALSE,FALSE,FALSE,0.3,"young",29,165,62,"f"
3,"LEG CURL",2,"Rep03",3440,3480,3500,3500,3460,3500,0.012,-40,3480,"Rep",-40,0,FALSE,FALSE,FALSE,1.14,"young",29,165,62,"f"
3,"LEG CURL",2,"Rep04",3080,3060,3100,3100,3070,3100,0.01,-30,3085,"Rep",20,0,FALSE,FALSE,FALSE,0.97,"young",29,165,62,"f"
3,"LEG CURL",2,"Rep05",3320,3340,3300,3300,3330,3300,0.009,30,3315,"Rep",-20,0,FALSE,FALSE,FALSE,0.91,"young",29,165,62,"f"
3,"LEG CURL",2,"Rep06",3320,3300,3300,3300,3310,3300,0.003,10,3305,"Rep",20,0,FALSE,FALSE,FALSE,0.3,"young",29,165,62,"f"
3,"LEG CURL",2,"Rep07",3060,3080,3100,3100,3070,3100,0.01,-30,3085,"Rep",-20,0,FALSE,FALSE,FALSE,0.97,"young",29,165,62,"f"
3,"LEG CURL",2,"Rep08",3240,3240,2450,2550,3240,2500,0.228,740,2870,"Rep",0,-100,TRUE,FALSE,FALSE,29.6,"young",29,165,62,"f"
3,"LEG CURL",2,"Rep09",3760,3740,4000,3400,3750,3700,0.013,50,3725,"Rep",20,600,FALSE,FALSE,TRUE,1.35,"young",29,165,62,"f"
3,"LEG CURL",2,"Rep10",3680,3680,4250,4750,3680,4500,0.223,-820,4090,"Rep",0,-500,TRUE,FALSE,TRUE,18.22,"young",29,165,62,"f"
3,"LEG CURL",1,"TuT",36340,36320,36150,36200,36330,36175,0.004,155,36252.5,"TuT",20,-50,FALSE,FALSE,FALSE,0.43,"young",29,165,62,"f"
3,"LEG CURL",2,"TuT",33620,33580,33700,33600,33600,33650,0.001,-50,33625,"TuT",40,100,FALSE,TRUE,FALSE,0.15,"young",29,165,62,"f"
3,"ABDUCTOR",1,"Con01",960,1000,1200,900,980,1050,0.071,-70,1015,"Con",-40,300,FALSE,TRUE,TRUE,6.67,"young",29,165,62,"f"
3,"ABDUCTOR",1,"Con02",820,820,900,900,820,900,0.098,-80,860,"Con",0,0,FALSE,FALSE,FALSE,8.89,"young",29,165,62,"f"
3,"ABDUCTOR",1,"Con03",840,880,950,950,860,950,0.105,-90,905,"Con",-40,0,FALSE,TRUE,FALSE,9.47,"young",29,165,62,"f"
3,"ABDUCTOR",1,"Con04",760,780,950,850,770,900,0.169,-130,835,"Con",-20,100,FALSE,FALSE,FALSE,14.44,"young",29,165,62,"f"
3,"ABDUCTOR",1,"Con05",800,840,900,900,820,900,0.098,-80,860,"Con",-40,0,FALSE,TRUE,FALSE,8.89,"young",29,165,62,"f"
3,"ABDUCTOR",1,"Con06",780,800,900,850,790,875,0.108,-85,832.5,"Con",-20,50,FALSE,FALSE,FALSE,9.71,"young",29,165,62,"f"
3,"ABDUCTOR",1,"Con07",820,840,950,1000,830,975,0.175,-145,902.5,"Con",-20,-50,FALSE,FALSE,FALSE,14.87,"young",29,165,62,"f"
3,"ABDUCTOR",1,"Con08",760,780,1000,1050,770,1025,0.331,-255,897.5,"Con",-20,-50,FALSE,FALSE,FALSE,24.88,"young",29,165,62,"f"
3,"ABDUCTOR",1,"Con09",820,840,1050,1100,830,1075,0.295,-245,952.5,"Con",-20,-50,FALSE,FALSE,FALSE,22.79,"young",29,165,62,"f"
3,"ABDUCTOR",1,"Con10",780,800,1100,950,790,1025,0.297,-235,907.5,"Con",-20,150,FALSE,FALSE,FALSE,22.93,"young",29,165,62,"f"
3,"ABDUCTOR",2,"Con01",800,800,900,950,800,925,0.156,-125,862.5,"Con",0,-50,FALSE,FALSE,FALSE,13.51,"young",29,165,62,"f"
3,"ABDUCTOR",2,"Con02",800,800,1000,1000,800,1000,0.25,-200,900,"Con",0,0,FALSE,FALSE,FALSE,20,"young",29,165,62,"f"
3,"ABDUCTOR",2,"Con03",820,860,1000,1000,840,1000,0.19,-160,920,"Con",-40,0,FALSE,TRUE,FALSE,16,"young",29,165,62,"f"
3,"ABDUCTOR",2,"Con04",760,760,850,900,760,875,0.151,-115,817.5,"Con",0,-50,FALSE,FALSE,FALSE,13.14,"young",29,165,62,"f"
3,"ABDUCTOR",2,"Con05",780,840,850,850,810,850,0.049,-40,830,"Con",-60,0,FALSE,TRUE,FALSE,4.71,"young",29,165,62,"f"
3,"ABDUCTOR",2,"Con06",720,760,850,800,740,825,0.115,-85,782.5,"Con",-40,50,FALSE,TRUE,FALSE,10.3,"young",29,165,62,"f"
3,"ABDUCTOR",2,"Con07",760,820,850,900,790,875,0.108,-85,832.5,"Con",-60,-50,FALSE,TRUE,FALSE,9.71,"young",29,165,62,"f"
3,"ABDUCTOR",2,"Con08",780,800,1000,1000,790,1000,0.266,-210,895,"Con",-20,0,FALSE,FALSE,FALSE,21,"young",29,165,62,"f"
3,"ABDUCTOR",2,"Con09",700,740,1050,1150,720,1100,0.528,-380,910,"Con",-40,-100,TRUE,TRUE,FALSE,34.55,"young",29,165,62,"f"
3,"ABDUCTOR",2,"Con10",780,780,1000,1550,780,1275,0.635,-495,1027.5,"Con",0,-550,TRUE,FALSE,TRUE,38.82,"young",29,165,62,"f"
3,"ABDUCTOR",1,"Ecc01",1820,1820,1700,1750,1820,1725,0.052,95,1772.5,"Ecc",0,-50,FALSE,FALSE,FALSE,5.51,"young",29,165,62,"f"
3,"ABDUCTOR",1,"Ecc02",1940,1900,1900,1850,1920,1875,0.023,45,1897.5,"Ecc",40,50,FALSE,TRUE,FALSE,2.4,"young",29,165,62,"f"
3,"ABDUCTOR",1,"Ecc03",2180,2160,1950,2100,2170,2025,0.067,145,2097.5,"Ecc",20,-150,FALSE,FALSE,FALSE,7.16,"young",29,165,62,"f"
3,"ABDUCTOR",1,"Ecc04",2160,2120,2050,2050,2140,2050,0.042,90,2095,"Ecc",40,0,FALSE,TRUE,FALSE,4.39,"young",29,165,62,"f"
3,"ABDUCTOR",1,"Ecc05",2000,2000,1900,1950,2000,1925,0.038,75,1962.5,"Ecc",0,-50,FALSE,FALSE,FALSE,3.9,"young",29,165,62,"f"
3,"ABDUCTOR",1,"Ecc06",2020,1980,1900,1850,2000,1875,0.062,125,1937.5,"Ecc",40,50,FALSE,TRUE,FALSE,6.67,"young",29,165,62,"f"
3,"ABDUCTOR",1,"Ecc07",2160,2140,1950,1900,2150,1925,0.105,225,2037.5,"Ecc",20,50,FALSE,FALSE,FALSE,11.69,"young",29,165,62,"f"
3,"ABDUCTOR",1,"Ecc08",1980,1960,1750,1700,1970,1725,0.124,245,1847.5,"Ecc",20,50,FALSE,FALSE,FALSE,14.2,"young",29,165,62,"f"
3,"ABDUCTOR",1,"Ecc09",2080,2060,1750,1850,2070,1800,0.13,270,1935,"Ecc",20,-100,FALSE,FALSE,FALSE,15,"young",29,165,62,"f"
3,"ABDUCTOR",1,"Ecc10",1580,1580,1600,1800,1580,1700,0.076,-120,1640,"Ecc",0,-200,FALSE,FALSE,FALSE,7.06,"young",29,165,62,"f"
3,"ABDUCTOR",2,"Ecc01",1580,1580,1450,1400,1580,1425,0.098,155,1502.5,"Ecc",0,50,FALSE,FALSE,FALSE,10.88,"young",29,165,62,"f"
3,"ABDUCTOR",2,"Ecc02",1820,1800,1550,1650,1810,1600,0.116,210,1705,"Ecc",20,-100,FALSE,FALSE,FALSE,13.12,"young",29,165,62,"f"
3,"ABDUCTOR",2,"Ecc03",1720,1680,1600,1550,1700,1575,0.074,125,1637.5,"Ecc",40,50,FALSE,TRUE,FALSE,7.94,"young",29,165,62,"f"
3,"ABDUCTOR",2,"Ecc04",1780,1760,1750,1700,1770,1725,0.025,45,1747.5,"Ecc",20,50,FALSE,FALSE,FALSE,2.61,"young",29,165,62,"f"
3,"ABDUCTOR",2,"Ecc05",2020,1980,1900,1950,2000,1925,0.038,75,1962.5,"Ecc",40,-50,FALSE,TRUE,FALSE,3.9,"young",29,165,62,"f"
3,"ABDUCTOR",2,"Ecc06",2020,1960,1900,1900,1990,1900,0.045,90,1945,"Ecc",60,0,FALSE,TRUE,FALSE,4.74,"young",29,165,62,"f"
3,"ABDUCTOR",2,"Ecc07",1700,1680,1550,1500,1690,1525,0.098,165,1607.5,"Ecc",20,50,FALSE,FALSE,FALSE,10.82,"young",29,165,62,"f"
3,"ABDUCTOR",2,"Ecc08",1840,1800,1500,1400,1820,1450,0.203,370,1635,"Ecc",40,100,TRUE,TRUE,FALSE,25.52,"young",29,165,62,"f"
3,"ABDUCTOR",2,"Ecc09",1820,1780,1550,1050,1800,1300,0.278,500,1550,"Ecc",40,500,TRUE,TRUE,TRUE,38.46,"young",29,165,62,"f"
3,"ABDUCTOR",2,"Ecc10",1300,1320,1300,1300,1310,1300,0.008,10,1305,"Ecc",-20,0,FALSE,FALSE,FALSE,0.77,"young",29,165,62,"f"
3,"ABDUCTOR",1,"Rep01",2780,2820,2900,2650,2800,2775,0.009,25,2787.5,"Rep",-40,250,FALSE,FALSE,FALSE,0.9,"young",29,165,62,"f"
3,"ABDUCTOR",1,"Rep02",2760,2720,2800,2750,2740,2775,0.013,-35,2757.5,"Rep",40,50,FALSE,FALSE,FALSE,1.26,"young",29,165,62,"f"
3,"ABDUCTOR",1,"Rep03",3020,3040,2900,3050,3030,2975,0.018,55,3002.5,"Rep",-20,-150,FALSE,FALSE,FALSE,1.85,"young",29,165,62,"f"
3,"ABDUCTOR",1,"Rep04",2920,2900,3000,2900,2910,2950,0.014,-40,2930,"Rep",20,100,FALSE,FALSE,FALSE,1.36,"young",29,165,62,"f"
3,"ABDUCTOR",1,"Rep05",2800,2840,2800,2850,2820,2825,0.002,-5,2822.5,"Rep",-40,-50,FALSE,FALSE,FALSE,0.18,"young",29,165,62,"f"
3,"ABDUCTOR",1,"Rep06",2800,2780,2800,2700,2790,2750,0.014,40,2770,"Rep",20,100,FALSE,FALSE,FALSE,1.45,"young",29,165,62,"f"
3,"ABDUCTOR",1,"Rep07",2980,2980,2900,2900,2980,2900,0.027,80,2940,"Rep",0,0,FALSE,FALSE,FALSE,2.76,"young",29,165,62,"f"
3,"ABDUCTOR",1,"Rep08",2740,2740,2750,2750,2740,2750,0.004,-10,2745,"Rep",0,0,FALSE,FALSE,FALSE,0.36,"young",29,165,62,"f"
3,"ABDUCTOR",1,"Rep09",2900,2900,2800,2950,2900,2875,0.009,25,2887.5,"Rep",0,-150,FALSE,FALSE,FALSE,0.87,"young",29,165,62,"f"
3,"ABDUCTOR",1,"Rep10",2360,2380,2700,2750,2370,2725,0.15,-355,2547.5,"Rep",-20,-50,TRUE,FALSE,FALSE,13.03,"young",29,165,62,"f"
3,"ABDUCTOR",2,"Rep01",2380,2380,2350,2350,2380,2350,0.013,30,2365,"Rep",0,0,FALSE,FALSE,FALSE,1.28,"young",29,165,62,"f"
3,"ABDUCTOR",2,"Rep02",2620,2600,2550,2650,2610,2600,0.004,10,2605,"Rep",20,-100,FALSE,FALSE,FALSE,0.38,"young",29,165,62,"f"
3,"ABDUCTOR",2,"Rep03",2540,2540,2600,2550,2540,2575,0.014,-35,2557.5,"Rep",0,50,FALSE,FALSE,FALSE,1.36,"young",29,165,62,"f"
3,"ABDUCTOR",2,"Rep04",2540,2520,2600,2600,2530,2600,0.028,-70,2565,"Rep",20,0,FALSE,FALSE,FALSE,2.69,"young",29,165,62,"f"
3,"ABDUCTOR",2,"Rep05",2800,2820,2750,2800,2810,2775,0.012,35,2792.5,"Rep",-20,-50,FALSE,FALSE,FALSE,1.26,"young",29,165,62,"f"
3,"ABDUCTOR",2,"Rep06",2740,2720,2750,2700,2730,2725,0.002,5,2727.5,"Rep",20,50,FALSE,FALSE,FALSE,0.18,"young",29,165,62,"f"
3,"ABDUCTOR",2,"Rep07",2460,2500,2400,2400,2480,2400,0.032,80,2440,"Rep",-40,0,FALSE,FALSE,FALSE,3.33,"young",29,165,62,"f"
3,"ABDUCTOR",2,"Rep08",2620,2600,2500,2400,2610,2450,0.061,160,2530,"Rep",20,100,FALSE,FALSE,FALSE,6.53,"young",29,165,62,"f"
3,"ABDUCTOR",2,"Rep09",2520,2520,2600,2200,2520,2400,0.048,120,2460,"Rep",0,400,FALSE,FALSE,TRUE,5,"young",29,165,62,"f"
3,"ABDUCTOR",2,"Rep10",2080,2100,2300,2850,2090,2575,0.232,-485,2332.5,"Rep",-20,-550,TRUE,FALSE,TRUE,18.83,"young",29,165,62,"f"
3,"ABDUCTOR",1,"TuT",28060,28100,28350,28250,28080,28300,0.008,-220,28190,"TuT",-40,100,FALSE,TRUE,FALSE,0.78,"young",29,165,62,"f"
3,"ABDUCTOR",2,"TuT",25300,25300,25400,25500,25300,25450,0.006,-150,25375,"TuT",0,-100,FALSE,FALSE,FALSE,0.59,"young",29,165,62,"f"
3,"ADDUCTOR",1,"Con01",980,940,1150,1000,960,1075,0.12,-115,1017.5,"Con",40,150,FALSE,TRUE,FALSE,10.7,"young",29,165,62,"f"
3,"ADDUCTOR",1,"Con02",880,880,1050,1100,880,1075,0.222,-195,977.5,"Con",0,-50,FALSE,FALSE,FALSE,18.14,"young",29,165,62,"f"
3,"ADDUCTOR",1,"Con03",980,1000,1250,1400,990,1325,0.338,-335,1157.5,"Con",-20,-150,FALSE,FALSE,FALSE,25.28,"young",29,165,62,"f"
3,"ADDUCTOR",1,"Con04",1020,1020,1100,1400,1020,1250,0.225,-230,1135,"Con",0,-300,FALSE,FALSE,FALSE,18.4,"young",29,165,62,"f"
3,"ADDUCTOR",1,"Con05",980,980,1000,950,980,975,0.005,5,977.5,"Con",0,50,FALSE,FALSE,FALSE,0.51,"young",29,165,62,"f"
3,"ADDUCTOR",1,"Con06",960,940,1100,850,950,975,0.026,-25,962.5,"Con",20,250,FALSE,FALSE,FALSE,2.56,"young",29,165,62,"f"
3,"ADDUCTOR",1,"Con07",920,940,1050,950,930,1000,0.075,-70,965,"Con",-20,100,FALSE,FALSE,FALSE,7,"young",29,165,62,"f"
3,"ADDUCTOR",1,"Con08",880,880,1000,1100,880,1050,0.193,-170,965,"Con",0,-100,FALSE,FALSE,FALSE,16.19,"young",29,165,62,"f"
3,"ADDUCTOR",1,"Con09",920,920,1150,1250,920,1200,0.304,-280,1060,"Con",0,-100,FALSE,FALSE,FALSE,23.33,"young",29,165,62,"f"
3,"ADDUCTOR",1,"Con10",940,920,1850,1450,930,1650,0.774,-720,1290,"Con",20,400,TRUE,FALSE,TRUE,43.64,"young",29,165,62,"f"
3,"ADDUCTOR",2,"Con01",940,940,1050,1150,940,1100,0.17,-160,1020,"Con",0,-100,FALSE,FALSE,FALSE,14.55,"young",29,165,62,"f"
3,"ADDUCTOR",2,"Con02",900,880,900,1150,890,1025,0.152,-135,957.5,"Con",20,-250,FALSE,FALSE,FALSE,13.17,"young",29,165,62,"f"
3,"ADDUCTOR",2,"Con03",920,920,900,1050,920,975,0.06,-55,947.5,"Con",0,-150,FALSE,FALSE,FALSE,5.64,"young",29,165,62,"f"
3,"ADDUCTOR",2,"Con04",860,880,850,950,870,900,0.034,-30,885,"Con",-20,-100,FALSE,FALSE,FALSE,3.33,"young",29,165,62,"f"
3,"ADDUCTOR",2,"Con05",840,860,1000,1000,850,1000,0.176,-150,925,"Con",-20,0,FALSE,FALSE,FALSE,15,"young",29,165,62,"f"
3,"ADDUCTOR",2,"Con06",800,820,950,950,810,950,0.173,-140,880,"Con",-20,0,FALSE,FALSE,FALSE,14.74,"young",29,165,62,"f"
3,"ADDUCTOR",2,"Con07",820,840,900,850,830,875,0.054,-45,852.5,"Con",-20,50,FALSE,FALSE,FALSE,5.14,"young",29,165,62,"f"
3,"ADDUCTOR",2,"Con08",820,820,1250,1050,820,1150,0.402,-330,985,"Con",0,200,FALSE,FALSE,FALSE,28.7,"young",29,165,62,"f"
3,"ADDUCTOR",2,"Con09",840,840,1450,1350,840,1400,0.667,-560,1120,"Con",0,100,FALSE,FALSE,FALSE,40,"young",29,165,62,"f"
3,"ADDUCTOR",2,"Con10",860,880,1550,1300,870,1425,0.638,-555,1147.5,"Con",-20,250,FALSE,FALSE,FALSE,38.95,"young",29,165,62,"f"
3,"ADDUCTOR",1,"Ecc01",2160,2160,1950,2000,2160,1975,0.086,185,2067.5,"Ecc",0,-50,FALSE,FALSE,FALSE,9.37,"young",29,165,62,"f"
3,"ADDUCTOR",1,"Ecc02",2020,2020,1800,1750,2020,1775,0.121,245,1897.5,"Ecc",0,50,FALSE,FALSE,FALSE,13.8,"young",29,165,62,"f"
3,"ADDUCTOR",1,"Ecc03",2320,2300,2150,1800,2310,1975,0.145,335,2142.5,"Ecc",20,350,FALSE,FALSE,TRUE,16.96,"young",29,165,62,"f"
3,"ADDUCTOR",1,"Ecc04",2240,2240,2200,2100,2240,2150,0.04,90,2195,"Ecc",0,100,FALSE,FALSE,FALSE,4.19,"young",29,165,62,"f"
3,"ADDUCTOR",1,"Ecc05",1940,1960,1850,2100,1950,1975,0.013,-25,1962.5,"Ecc",-20,-250,FALSE,FALSE,FALSE,1.27,"young",29,165,62,"f"
3,"ADDUCTOR",1,"Ecc06",1680,1680,1500,1700,1680,1600,0.048,80,1640,"Ecc",0,-200,FALSE,FALSE,FALSE,5,"young",29,165,62,"f"
3,"ADDUCTOR",1,"Ecc07",1800,1780,1700,1650,1790,1675,0.064,115,1732.5,"Ecc",20,50,FALSE,FALSE,FALSE,6.87,"young",29,165,62,"f"
3,"ADDUCTOR",1,"Ecc08",1840,1840,1750,1500,1840,1625,0.117,215,1732.5,"Ecc",0,250,FALSE,FALSE,FALSE,13.23,"young",29,165,62,"f"
3,"ADDUCTOR",1,"Ecc09",2100,2120,1200,1700,2110,1450,0.313,660,1780,"Ecc",-20,-500,TRUE,FALSE,TRUE,45.52,"young",29,165,62,"f"
3,"ADDUCTOR",1,"Ecc10",1580,1580,1050,1150,1580,1100,0.304,480,1340,"Ecc",0,-100,FALSE,FALSE,FALSE,43.64,"young",29,165,62,"f"
3,"ADDUCTOR",2,"Ecc01",1840,1820,1650,1550,1830,1600,0.126,230,1715,"Ecc",20,100,FALSE,FALSE,FALSE,14.37,"young",29,165,62,"f"
3,"ADDUCTOR",2,"Ecc02",1700,1700,1700,1500,1700,1600,0.059,100,1650,"Ecc",0,200,FALSE,FALSE,FALSE,6.25,"young",29,165,62,"f"
3,"ADDUCTOR",2,"Ecc03",1720,1720,1800,1650,1720,1725,0.003,-5,1722.5,"Ecc",0,150,FALSE,FALSE,FALSE,0.29,"young",29,165,62,"f"
3,"ADDUCTOR",2,"Ecc04",1760,1720,1650,1600,1740,1625,0.066,115,1682.5,"Ecc",40,50,FALSE,TRUE,FALSE,7.08,"young",29,165,62,"f"
3,"ADDUCTOR",2,"Ecc05",1740,1740,1600,1600,1740,1600,0.08,140,1670,"Ecc",0,0,FALSE,FALSE,FALSE,8.75,"young",29,165,62,"f"
3,"ADDUCTOR",2,"Ecc06",1840,1820,1700,1750,1830,1725,0.057,105,1777.5,"Ecc",20,-50,FALSE,FALSE,FALSE,6.09,"young",29,165,62,"f"
3,"ADDUCTOR",2,"Ecc07",1540,1540,1450,1550,1540,1500,0.026,40,1520,"Ecc",0,-100,FALSE,FALSE,FALSE,2.67,"young",29,165,62,"f"
3,"ADDUCTOR",2,"Ecc08",1820,1800,1000,1250,1810,1125,0.378,685,1467.5,"Ecc",20,-250,TRUE,FALSE,FALSE,60.89,"young",29,165,62,"f"
3,"ADDUCTOR",2,"Ecc09",1860,1840,1150,1350,1850,1250,0.324,600,1550,"Ecc",20,-200,TRUE,FALSE,FALSE,48,"young",29,165,62,"f"
3,"ADDUCTOR",2,"Ecc10",1420,1420,1250,1350,1420,1300,0.085,120,1360,"Ecc",0,-100,FALSE,FALSE,FALSE,9.23,"young",29,165,62,"f"
3,"ADDUCTOR",1,"Rep01",3140,3100,3100,3000,3120,3050,0.022,70,3085,"Rep",40,100,FALSE,FALSE,FALSE,2.3,"young",29,165,62,"f"
3,"ADDUCTOR",1,"Rep02",2900,2900,2850,2850,2900,2850,0.017,50,2875,"Rep",0,0,FALSE,FALSE,FALSE,1.75,"young",29,165,62,"f"
3,"ADDUCTOR",1,"Rep03",3300,3300,3400,3200,3300,3300,0,0,3300,"Rep",0,200,FALSE,FALSE,FALSE,0,"young",29,165,62,"f"
3,"ADDUCTOR",1,"Rep04",3260,3260,3300,3500,3260,3400,0.043,-140,3330,"Rep",0,-200,FALSE,FALSE,FALSE,4.12,"young",29,165,62,"f"
3,"ADDUCTOR",1,"Rep05",2920,2940,2850,3050,2930,2950,0.007,-20,2940,"Rep",-20,-200,FALSE,FALSE,FALSE,0.68,"young",29,165,62,"f"
3,"ADDUCTOR",1,"Rep06",2640,2620,2600,2550,2630,2575,0.021,55,2602.5,"Rep",20,50,FALSE,FALSE,FALSE,2.14,"young",29,165,62,"f"
3,"ADDUCTOR",1,"Rep07",2720,2720,2750,2600,2720,2675,0.017,45,2697.5,"Rep",0,150,FALSE,FALSE,FALSE,1.68,"young",29,165,62,"f"
3,"ADDUCTOR",1,"Rep08",2720,2720,2750,2600,2720,2675,0.017,45,2697.5,"Rep",0,150,FALSE,FALSE,FALSE,1.68,"young",29,165,62,"f"
3,"ADDUCTOR",1,"Rep09",3020,3040,2350,2950,3030,2650,0.125,380,2840,"Rep",-20,-600,TRUE,FALSE,TRUE,14.34,"young",29,165,62,"f"
3,"ADDUCTOR",1,"Rep10",2520,2500,2900,2600,2510,2750,0.096,-240,2630,"Rep",20,300,FALSE,FALSE,TRUE,8.73,"young",29,165,62,"f"
3,"ADDUCTOR",2,"Rep01",2780,2760,2700,2700,2770,2700,0.025,70,2735,"Rep",20,0,FALSE,FALSE,FALSE,2.59,"young",29,165,62,"f"
3,"ADDUCTOR",2,"Rep02",2600,2580,2600,2650,2590,2625,0.014,-35,2607.5,"Rep",20,-50,FALSE,FALSE,FALSE,1.33,"young",29,165,62,"f"
3,"ADDUCTOR",2,"Rep03",2640,2640,2700,2700,2640,2700,0.023,-60,2670,"Rep",0,0,FALSE,FALSE,FALSE,2.22,"young",29,165,62,"f"
3,"ADDUCTOR",2,"Rep04",2620,2600,2500,2550,2610,2525,0.033,85,2567.5,"Rep",20,-50,FALSE,FALSE,FALSE,3.37,"young",29,165,62,"f"
3,"ADDUCTOR",2,"Rep05",2580,2600,2600,2600,2590,2600,0.004,-10,2595,"Rep",-20,0,FALSE,FALSE,FALSE,0.38,"young",29,165,62,"f"
3,"ADDUCTOR",2,"Rep06",2640,2640,2650,2700,2640,2675,0.013,-35,2657.5,"Rep",0,-50,FALSE,FALSE,FALSE,1.31,"young",29,165,62,"f"
3,"ADDUCTOR",2,"Rep07",2360,2380,2350,2400,2370,2375,0.002,-5,2372.5,"Rep",-20,-50,FALSE,FALSE,FALSE,0.21,"young",29,165,62,"f"
3,"ADDUCTOR",2,"Rep08",2640,2620,2250,2300,2630,2275,0.135,355,2452.5,"Rep",20,-50,FALSE,FALSE,FALSE,15.6,"young",29,165,62,"f"
3,"ADDUCTOR",2,"Rep09",2700,2680,2600,2700,2690,2650,0.015,40,2670,"Rep",20,-100,FALSE,FALSE,FALSE,1.51,"young",29,165,62,"f"
3,"ADDUCTOR",2,"Rep10",2280,2300,2800,2650,2290,2725,0.19,-435,2507.5,"Rep",-20,150,TRUE,FALSE,FALSE,15.96,"young",29,165,62,"f"
3,"ADDUCTOR",1,"TuT",29140,29100,28850,28900,29120,28875,0.008,245,28997.5,"TuT",40,-50,FALSE,TRUE,FALSE,0.85,"young",29,165,62,"f"
3,"ADDUCTOR",2,"TuT",25840,25800,25750,25950,25820,25850,0.001,-30,25835,"TuT",40,-200,FALSE,TRUE,FALSE,0.12,"young",29,165,62,"f"
3,"LOWER BACK",1,"Con01",1320,1300,1400,1400,1310,1400,0.069,-90,1355,"Con",20,0,FALSE,FALSE,FALSE,6.43,"young",29,165,62,"f"
3,"LOWER BACK",1,"Con02",1240,1280,1350,1350,1260,1350,0.071,-90,1305,"Con",-40,0,FALSE,TRUE,FALSE,6.67,"young",29,165,62,"f"
3,"LOWER BACK",1,"Con03",1140,1160,1200,1200,1150,1200,0.043,-50,1175,"Con",-20,0,FALSE,FALSE,FALSE,4.17,"young",29,165,62,"f"
3,"LOWER BACK",1,"Con04",1120,1140,1200,1250,1130,1225,0.084,-95,1177.5,"Con",-20,-50,FALSE,FALSE,FALSE,7.76,"young",29,165,62,"f"
3,"LOWER BACK",1,"Con05",1200,1220,1250,1250,1210,1250,0.033,-40,1230,"Con",-20,0,FALSE,FALSE,FALSE,3.2,"young",29,165,62,"f"
3,"LOWER BACK",1,"Con06",1260,1240,1300,1300,1250,1300,0.04,-50,1275,"Con",20,0,FALSE,FALSE,FALSE,3.85,"young",29,165,62,"f"
3,"LOWER BACK",1,"Con07",1100,1140,1200,1250,1120,1225,0.094,-105,1172.5,"Con",-40,-50,FALSE,TRUE,FALSE,8.57,"young",29,165,62,"f"
3,"LOWER BACK",1,"Con08",1140,1160,1300,1300,1150,1300,0.13,-150,1225,"Con",-20,0,FALSE,FALSE,FALSE,11.54,"young",29,165,62,"f"
3,"LOWER BACK",1,"Con09",1200,1200,1400,1350,1200,1375,0.146,-175,1287.5,"Con",0,50,FALSE,FALSE,FALSE,12.73,"young",29,165,62,"f"
3,"LOWER BACK",1,"Con10",1180,1220,1400,1400,1200,1400,0.167,-200,1300,"Con",-40,0,TRUE,TRUE,FALSE,14.29,"young",29,165,62,"f"
3,"LOWER BACK",2,"Con01",1280,1280,1400,1400,1280,1400,0.094,-120,1340,"Con",0,0,FALSE,FALSE,FALSE,8.57,"young",29,165,62,"f"
3,"LOWER BACK",2,"Con02",1160,1200,1300,1250,1180,1275,0.081,-95,1227.5,"Con",-40,50,FALSE,TRUE,FALSE,7.45,"young",29,165,62,"f"
3,"LOWER BACK",2,"Con03",1260,1280,1350,1300,1270,1325,0.043,-55,1297.5,"Con",-20,50,FALSE,FALSE,FALSE,4.15,"young",29,165,62,"f"
3,"LOWER BACK",2,"Con04",1180,1220,1300,1250,1200,1275,0.062,-75,1237.5,"Con",-40,50,FALSE,TRUE,FALSE,5.88,"young",29,165,62,"f"
3,"LOWER BACK",2,"Con05",1220,1200,1300,1250,1210,1275,0.054,-65,1242.5,"Con",20,50,FALSE,FALSE,FALSE,5.1,"young",29,165,62,"f"
3,"LOWER BACK",2,"Con06",1220,1240,1300,1300,1230,1300,0.057,-70,1265,"Con",-20,0,FALSE,FALSE,FALSE,5.38,"young",29,165,62,"f"
3,"LOWER BACK",2,"Con07",1280,1280,1350,1400,1280,1375,0.074,-95,1327.5,"Con",0,-50,FALSE,FALSE,FALSE,6.91,"young",29,165,62,"f"
3,"LOWER BACK",2,"Con08",1220,1240,1300,1350,1230,1325,0.077,-95,1277.5,"Con",-20,-50,FALSE,FALSE,FALSE,7.17,"young",29,165,62,"f"
3,"LOWER BACK",2,"Con09",1240,1260,1400,1400,1250,1400,0.12,-150,1325,"Con",-20,0,FALSE,FALSE,FALSE,10.71,"young",29,165,62,"f"
3,"LOWER BACK",2,"Con10",1220,1240,1400,1450,1230,1425,0.159,-195,1327.5,"Con",-20,-50,TRUE,FALSE,FALSE,13.68,"young",29,165,62,"f"
3,"LOWER BACK",1,"Ecc01",2060,2060,2000,2000,2060,2000,0.029,60,2030,"Ecc",0,0,FALSE,FALSE,FALSE,3,"young",29,165,62,"f"
3,"LOWER BACK",1,"Ecc02",2440,2400,2350,2350,2420,2350,0.029,70,2385,"Ecc",40,0,FALSE,FALSE,FALSE,2.98,"young",29,165,62,"f"
3,"LOWER BACK",1,"Ecc03",2180,2160,2100,2100,2170,2100,0.032,70,2135,"Ecc",20,0,FALSE,FALSE,FALSE,3.33,"young",29,165,62,"f"
3,"LOWER BACK",1,"Ecc04",2300,2280,2250,2200,2290,2225,0.028,65,2257.5,"Ecc",20,50,FALSE,FALSE,FALSE,2.92,"young",29,165,62,"f"
3,"LOWER BACK",1,"Ecc05",2040,2040,2000,2000,2040,2000,0.02,40,2020,"Ecc",0,0,FALSE,FALSE,FALSE,2,"young",29,165,62,"f"
3,"LOWER BACK",1,"Ecc06",2040,2060,2000,1950,2050,1975,0.037,75,2012.5,"Ecc",-20,50,FALSE,FALSE,FALSE,3.8,"young",29,165,62,"f"
3,"LOWER BACK",1,"Ecc07",2200,2140,2050,2050,2170,2050,0.055,120,2110,"Ecc",60,0,FALSE,FALSE,FALSE,5.85,"young",29,165,62,"f"
3,"LOWER BACK",1,"Ecc08",2220,2200,2000,2050,2210,2025,0.084,185,2117.5,"Ecc",20,-50,TRUE,FALSE,FALSE,9.14,"young",29,165,62,"f"
3,"LOWER BACK",1,"Ecc09",2180,2160,1950,1950,2170,1950,0.101,220,2060,"Ecc",20,0,TRUE,FALSE,FALSE,11.28,"young",29,165,62,"f"
3,"LOWER BACK",1,"Ecc10",1900,1920,1900,1950,1910,1925,0.008,-15,1917.5,"Ecc",-20,-50,FALSE,FALSE,FALSE,0.78,"young",29,165,62,"f"
3,"LOWER BACK",2,"Ecc01",2080,2060,1950,2000,2070,1975,0.046,95,2022.5,"Ecc",20,-50,FALSE,FALSE,FALSE,4.81,"young",29,165,62,"f"
3,"LOWER BACK",2,"Ecc02",2280,2240,2150,2200,2260,2175,0.038,85,2217.5,"Ecc",40,-50,FALSE,FALSE,FALSE,3.91,"young",29,165,62,"f"
3,"LOWER BACK",2,"Ecc03",2260,2240,2200,2250,2250,2225,0.011,25,2237.5,"Ecc",20,-50,FALSE,FALSE,FALSE,1.12,"young",29,165,62,"f"
3,"LOWER BACK",2,"Ecc04",2240,2220,2100,2150,2230,2125,0.047,105,2177.5,"Ecc",20,-50,FALSE,FALSE,FALSE,4.94,"young",29,165,62,"f"
3,"LOWER BACK",2,"Ecc05",2140,2140,2100,2100,2140,2100,0.019,40,2120,"Ecc",0,0,FALSE,FALSE,FALSE,1.9,"young",29,165,62,"f"
3,"LOWER BACK",2,"Ecc06",2200,2200,2100,2100,2200,2100,0.045,100,2150,"Ecc",0,0,FALSE,FALSE,FALSE,4.76,"young",29,165,62,"f"
3,"LOWER BACK",2,"Ecc07",2260,2240,2200,2150,2250,2175,0.033,75,2212.5,"Ecc",20,50,FALSE,FALSE,FALSE,3.45,"young",29,165,62,"f"
3,"LOWER BACK",2,"Ecc08",2160,2160,2050,2000,2160,2025,0.062,135,2092.5,"Ecc",0,50,FALSE,FALSE,FALSE,6.67,"young",29,165,62,"f"
3,"LOWER BACK",2,"Ecc09",2220,2200,2050,2000,2210,2025,0.084,185,2117.5,"Ecc",20,50,TRUE,FALSE,FALSE,9.14,"young",29,165,62,"f"
3,"LOWER BACK",2,"Ecc10",1980,1960,1950,1950,1970,1950,0.01,20,1960,"Ecc",20,0,FALSE,FALSE,FALSE,1.03,"young",29,165,62,"f"
3,"LOWER BACK",1,"Rep01",3380,3360,3400,3400,3370,3400,0.009,-30,3385,"Rep",20,0,FALSE,FALSE,FALSE,0.88,"young",29,165,62,"f"
3,"LOWER BACK",1,"Rep02",3680,3680,3700,3700,3680,3700,0.005,-20,3690,"Rep",0,0,FALSE,FALSE,FALSE,0.54,"young",29,165,62,"f"
3,"LOWER BACK",1,"Rep03",3320,3320,3300,3300,3320,3300,0.006,20,3310,"Rep",0,0,FALSE,FALSE,FALSE,0.61,"young",29,165,62,"f"
3,"LOWER BACK",1,"Rep04",3420,3420,3450,3450,3420,3450,0.009,-30,3435,"Rep",0,0,FALSE,FALSE,FALSE,0.87,"young",29,165,62,"f"
3,"LOWER BACK",1,"Rep05",3240,3260,3250,3250,3250,3250,0,0,3250,"Rep",-20,0,FALSE,FALSE,FALSE,0,"young",29,165,62,"f"
3,"LOWER BACK",1,"Rep06",3300,3300,3300,3250,3300,3275,0.008,25,3287.5,"Rep",0,50,FALSE,FALSE,FALSE,0.76,"young",29,165,62,"f"
3,"LOWER BACK",1,"Rep07",3300,3280,3250,3300,3290,3275,0.005,15,3282.5,"Rep",20,-50,FALSE,FALSE,FALSE,0.46,"young",29,165,62,"f"
3,"LOWER BACK",1,"Rep08",3360,3360,3300,3350,3360,3325,0.01,35,3342.5,"Rep",0,-50,FALSE,FALSE,FALSE,1.05,"young",29,165,62,"f"
3,"LOWER BACK",1,"Rep09",3380,3360,3350,3300,3370,3325,0.013,45,3347.5,"Rep",20,50,FALSE,FALSE,FALSE,1.35,"young",29,165,62,"f"
3,"LOWER BACK",1,"Rep10",3080,3140,3300,3350,3110,3325,0.069,-215,3217.5,"Rep",-60,-50,TRUE,FALSE,FALSE,6.47,"young",29,165,62,"f"
3,"LOWER BACK",2,"Rep01",3360,3340,3350,3400,3350,3375,0.007,-25,3362.5,"Rep",20,-50,FALSE,FALSE,FALSE,0.74,"young",29,165,62,"f"
3,"LOWER BACK",2,"Rep02",3440,3440,3450,3450,3440,3450,0.003,-10,3445,"Rep",0,0,FALSE,FALSE,FALSE,0.29,"young",29,165,62,"f"
3,"LOWER BACK",2,"Rep03",3520,3520,3550,3550,3520,3550,0.009,-30,3535,"Rep",0,0,FALSE,FALSE,FALSE,0.85,"young",29,165,62,"f"
3,"LOWER BACK",2,"Rep04",3420,3440,3400,3400,3430,3400,0.009,30,3415,"Rep",-20,0,FALSE,FALSE,FALSE,0.88,"young",29,165,62,"f"
3,"LOWER BACK",2,"Rep05",3360,3340,3400,3350,3350,3375,0.007,-25,3362.5,"Rep",20,50,FALSE,FALSE,FALSE,0.74,"young",29,165,62,"f"
3,"LOWER BACK",2,"Rep06",3420,3440,3400,3400,3430,3400,0.009,30,3415,"Rep",-20,0,FALSE,FALSE,FALSE,0.88,"young",29,165,62,"f"
3,"LOWER BACK",2,"Rep07",3540,3520,3550,3550,3530,3550,0.006,-20,3540,"Rep",20,0,FALSE,FALSE,FALSE,0.56,"young",29,165,62,"f"
3,"LOWER BACK",2,"Rep08",3380,3400,3350,3350,3390,3350,0.012,40,3370,"Rep",-20,0,FALSE,FALSE,FALSE,1.19,"young",29,165,62,"f"
3,"LOWER BACK",2,"Rep09",3460,3460,3450,3400,3460,3425,0.01,35,3442.5,"Rep",0,50,FALSE,FALSE,FALSE,1.02,"young",29,165,62,"f"
3,"LOWER BACK",2,"Rep10",3200,3200,3350,3400,3200,3375,0.055,-175,3287.5,"Rep",0,-50,TRUE,FALSE,FALSE,5.19,"young",29,165,62,"f"
3,"LOWER BACK",1,"TuT",33460,33480,33600,33650,33470,33625,0.005,-155,33547.5,"TuT",-20,-50,FALSE,FALSE,FALSE,0.46,"young",29,165,62,"f"
3,"LOWER BACK",2,"TuT",34100,34100,34250,34250,34100,34250,0.004,-150,34175,"TuT",0,0,FALSE,FALSE,FALSE,0.44,"young",29,165,62,"f"
3,"TOTAL ABDOMINAL",1,"Con01",1160,1160,1150,1150,1160,1150,0.009,10,1155,"Con",0,0,FALSE,FALSE,FALSE,0.87,"young",29,165,62,"f"
3,"TOTAL ABDOMINAL",1,"Con02",1020,1020,1050,1150,1020,1100,0.078,-80,1060,"Con",0,-100,FALSE,FALSE,FALSE,7.27,"young",29,165,62,"f"
3,"TOTAL ABDOMINAL",1,"Con03",1060,1080,1200,1150,1070,1175,0.098,-105,1122.5,"Con",-20,50,FALSE,FALSE,FALSE,8.94,"young",29,165,62,"f"
3,"TOTAL ABDOMINAL",1,"Con04",1040,1040,1200,1150,1040,1175,0.13,-135,1107.5,"Con",0,50,FALSE,FALSE,FALSE,11.49,"young",29,165,62,"f"
3,"TOTAL ABDOMINAL",1,"Con05",1020,1040,1150,1100,1030,1125,0.092,-95,1077.5,"Con",-20,50,FALSE,FALSE,FALSE,8.44,"young",29,165,62,"f"
3,"TOTAL ABDOMINAL",1,"Con06",1060,1080,1150,1200,1070,1175,0.098,-105,1122.5,"Con",-20,-50,FALSE,FALSE,FALSE,8.94,"young",29,165,62,"f"
3,"TOTAL ABDOMINAL",1,"Con07",1060,1100,1200,1150,1080,1175,0.088,-95,1127.5,"Con",-40,50,FALSE,TRUE,FALSE,8.09,"young",29,165,62,"f"
3,"TOTAL ABDOMINAL",1,"Con08",1060,1060,1200,1150,1060,1175,0.108,-115,1117.5,"Con",0,50,FALSE,FALSE,FALSE,9.79,"young",29,165,62,"f"
3,"TOTAL ABDOMINAL",1,"Con09",1020,1040,1100,1150,1030,1125,0.092,-95,1077.5,"Con",-20,-50,FALSE,FALSE,FALSE,8.44,"young",29,165,62,"f"
3,"TOTAL ABDOMINAL",1,"Con10",1160,1160,1150,1350,1160,1250,0.078,-90,1205,"Con",0,-200,FALSE,FALSE,TRUE,7.2,"young",29,165,62,"f"
3,"TOTAL ABDOMINAL",2,"Con01",1020,1020,1100,1050,1020,1075,0.054,-55,1047.5,"Con",0,50,FALSE,FALSE,FALSE,5.12,"young",29,165,62,"f"
3,"TOTAL ABDOMINAL",2,"Con02",1040,1080,950,1100,1060,1025,0.033,35,1042.5,"Con",-40,-150,FALSE,TRUE,FALSE,3.41,"young",29,165,62,"f"
3,"TOTAL ABDOMINAL",2,"Con03",1080,1100,950,1200,1090,1075,0.014,15,1082.5,"Con",-20,-250,FALSE,FALSE,TRUE,1.4,"young",29,165,62,"f"
3,"TOTAL ABDOMINAL",2,"Con04",1180,1220,1150,1400,1200,1275,0.062,-75,1237.5,"Con",-40,-250,FALSE,TRUE,TRUE,5.88,"young",29,165,62,"f"
3,"TOTAL ABDOMINAL",2,"Con05",980,1000,1100,1100,990,1100,0.111,-110,1045,"Con",-20,0,FALSE,FALSE,FALSE,10,"young",29,165,62,"f"
3,"TOTAL ABDOMINAL",2,"Con06",1020,1020,1200,1050,1020,1125,0.103,-105,1072.5,"Con",0,150,FALSE,FALSE,FALSE,9.33,"young",29,165,62,"f"
3,"TOTAL ABDOMINAL",2,"Con07",980,1000,1200,1050,990,1125,0.136,-135,1057.5,"Con",-20,150,FALSE,FALSE,FALSE,12,"young",29,165,62,"f"
3,"TOTAL ABDOMINAL",2,"Con08",1040,1060,1250,1050,1050,1150,0.095,-100,1100,"Con",-20,200,FALSE,FALSE,TRUE,8.7,"young",29,165,62,"f"
3,"TOTAL ABDOMINAL",2,"Con09",1020,1040,1150,1050,1030,1100,0.068,-70,1065,"Con",-20,100,FALSE,FALSE,FALSE,6.36,"young",29,165,62,"f"
3,"TOTAL ABDOMINAL",2,"Con10",1040,1060,1200,1200,1050,1200,0.143,-150,1125,"Con",-20,0,TRUE,FALSE,FALSE,12.5,"young",29,165,62,"f"
3,"TOTAL ABDOMINAL",1,"Ecc01",2160,2140,2150,2050,2150,2100,0.023,50,2125,"Ecc",20,100,FALSE,FALSE,FALSE,2.38,"young",29,165,62,"f"
3,"TOTAL ABDOMINAL",1,"Ecc02",2140,2140,2050,2050,2140,2050,0.042,90,2095,"Ecc",0,0,FALSE,FALSE,FALSE,4.39,"young",29,165,62,"f"
3,"TOTAL ABDOMINAL",1,"Ecc03",2020,2020,1900,1950,2020,1925,0.047,95,1972.5,"Ecc",0,-50,FALSE,FALSE,FALSE,4.94,"young",29,165,62,"f"
3,"TOTAL ABDOMINAL",1,"Ecc04",2100,2100,1950,2000,2100,1975,0.06,125,2037.5,"Ecc",0,-50,FALSE,FALSE,FALSE,6.33,"young",29,165,62,"f"
3,"TOTAL ABDOMINAL",1,"Ecc05",2300,2260,2150,2150,2280,2150,0.057,130,2215,"Ecc",40,0,FALSE,TRUE,FALSE,6.05,"young",29,165,62,"f"
3,"TOTAL ABDOMINAL",1,"Ecc06",2080,2040,2000,2000,2060,2000,0.029,60,2030,"Ecc",40,0,FALSE,TRUE,FALSE,3,"young",29,165,62,"f"
3,"TOTAL ABDOMINAL",1,"Ecc07",2060,2040,1900,1950,2050,1925,0.061,125,1987.5,"Ecc",20,-50,FALSE,FALSE,FALSE,6.49,"young",29,165,62,"f"
3,"TOTAL ABDOMINAL",1,"Ecc08",2000,2000,1900,1900,2000,1900,0.05,100,1950,"Ecc",0,0,FALSE,FALSE,FALSE,5.26,"young",29,165,62,"f"
3,"TOTAL ABDOMINAL",1,"Ecc09",2020,2000,2000,1850,2010,1925,0.042,85,1967.5,"Ecc",20,150,FALSE,FALSE,FALSE,4.42,"young",29,165,62,"f"
3,"TOTAL ABDOMINAL",1,"Ecc10",1720,1740,1700,1650,1730,1675,0.032,55,1702.5,"Ecc",-20,50,FALSE,FALSE,FALSE,3.28,"young",29,165,62,"f"
3,"TOTAL ABDOMINAL",2,"Ecc01",1680,1660,1700,1650,1670,1675,0.003,-5,1672.5,"Ecc",20,50,FALSE,FALSE,FALSE,0.3,"young",29,165,62,"f"
3,"TOTAL ABDOMINAL",2,"Ecc02",1720,1680,1850,1600,1700,1725,0.015,-25,1712.5,"Ecc",40,250,FALSE,TRUE,TRUE,1.45,"young",29,165,62,"f"
3,"TOTAL ABDOMINAL",2,"Ecc03",1640,1600,1750,1450,1620,1600,0.012,20,1610,"Ecc",40,300,FALSE,TRUE,TRUE,1.25,"young",29,165,62,"f"
3,"TOTAL ABDOMINAL",2,"Ecc04",1900,1880,1800,1750,1890,1775,0.061,115,1832.5,"Ecc",20,50,FALSE,FALSE,FALSE,6.48,"young",29,165,62,"f"
3,"TOTAL ABDOMINAL",2,"Ecc05",1840,1840,1650,1800,1840,1725,0.062,115,1782.5,"Ecc",0,-150,FALSE,FALSE,FALSE,6.67,"young",29,165,62,"f"
3,"TOTAL ABDOMINAL",2,"Ecc06",1780,1760,1600,1700,1770,1650,0.068,120,1710,"Ecc",20,-100,FALSE,FALSE,FALSE,7.27,"young",29,165,62,"f"
3,"TOTAL ABDOMINAL",2,"Ecc07",1720,1700,1500,1700,1710,1600,0.064,110,1655,"Ecc",20,-200,FALSE,FALSE,TRUE,6.88,"young",29,165,62,"f"
3,"TOTAL ABDOMINAL",2,"Ecc08",1640,1620,1500,1650,1630,1575,0.034,55,1602.5,"Ecc",20,-150,FALSE,FALSE,FALSE,3.49,"young",29,165,62,"f"
3,"TOTAL ABDOMINAL",2,"Ecc09",1740,1720,1550,1600,1730,1575,0.09,155,1652.5,"Ecc",20,-50,TRUE,FALSE,FALSE,9.84,"young",29,165,62,"f"
3,"TOTAL ABDOMINAL",2,"Ecc10",1240,1240,1200,1200,1240,1200,0.032,40,1220,"Ecc",0,0,FALSE,FALSE,FALSE,3.33,"young",29,165,62,"f"
3,"TOTAL ABDOMINAL",1,"Rep01",3320,3300,3300,3200,3310,3250,0.018,60,3280,"Rep",20,100,FALSE,FALSE,FALSE,1.85,"young",29,165,62,"f"
3,"TOTAL ABDOMINAL",1,"Rep02",3160,3160,3100,3200,3160,3150,0.003,10,3155,"Rep",0,-100,FALSE,FALSE,FALSE,0.32,"young",29,165,62,"f"
3,"TOTAL ABDOMINAL",1,"Rep03",3080,3100,3100,3100,3090,3100,0.003,-10,3095,"Rep",-20,0,FALSE,FALSE,FALSE,0.32,"young",29,165,62,"f"
3,"TOTAL ABDOMINAL",1,"Rep04",3140,3140,3150,3150,3140,3150,0.003,-10,3145,"Rep",0,0,FALSE,FALSE,FALSE,0.32,"young",29,165,62,"f"
3,"TOTAL ABDOMINAL",1,"Rep05",3320,3300,3300,3250,3310,3275,0.011,35,3292.5,"Rep",20,50,FALSE,FALSE,FALSE,1.07,"young",29,165,62,"f"
3,"TOTAL ABDOMINAL",1,"Rep06",3140,3120,3150,3200,3130,3175,0.014,-45,3152.5,"Rep",20,-50,FALSE,FALSE,FALSE,1.42,"young",29,165,62,"f"
3,"TOTAL ABDOMINAL",1,"Rep07",3120,3140,3100,3100,3130,3100,0.01,30,3115,"Rep",-20,0,FALSE,FALSE,FALSE,0.97,"young",29,165,62,"f"
3,"TOTAL ABDOMINAL",1,"Rep08",3060,3060,3100,3050,3060,3075,0.005,-15,3067.5,"Rep",0,50,FALSE,FALSE,FALSE,0.49,"young",29,165,62,"f"
3,"TOTAL ABDOMINAL",1,"Rep09",3040,3040,3100,3000,3040,3050,0.003,-10,3045,"Rep",0,100,FALSE,FALSE,FALSE,0.33,"young",29,165,62,"f"
3,"TOTAL ABDOMINAL",1,"Rep10",2880,2900,2850,3000,2890,2925,0.012,-35,2907.5,"Rep",-20,-150,FALSE,FALSE,FALSE,1.2,"young",29,165,62,"f"
3,"TOTAL ABDOMINAL",2,"Rep01",2700,2680,2800,2700,2690,2750,0.022,-60,2720,"Rep",20,100,FALSE,FALSE,FALSE,2.18,"young",29,165,62,"f"
3,"TOTAL ABDOMINAL",2,"Rep02",2760,2760,2800,2700,2760,2750,0.004,10,2755,"Rep",0,100,FALSE,FALSE,FALSE,0.36,"young",29,165,62,"f"
3,"TOTAL ABDOMINAL",2,"Rep03",2720,2700,2700,2650,2710,2675,0.013,35,2692.5,"Rep",20,50,FALSE,FALSE,FALSE,1.31,"young",29,165,62,"f"
3,"TOTAL ABDOMINAL",2,"Rep04",3080,3100,2950,3150,3090,3050,0.013,40,3070,"Rep",-20,-200,FALSE,FALSE,TRUE,1.31,"young",29,165,62,"f"
3,"TOTAL ABDOMINAL",2,"Rep05",2820,2840,2750,2900,2830,2825,0.002,5,2827.5,"Rep",-20,-150,FALSE,FALSE,FALSE,0.18,"young",29,165,62,"f"
3,"TOTAL ABDOMINAL",2,"Rep06",2800,2780,2800,2750,2790,2775,0.005,15,2782.5,"Rep",20,50,FALSE,FALSE,FALSE,0.54,"young",29,165,62,"f"
3,"TOTAL ABDOMINAL",2,"Rep07",2700,2700,2700,2750,2700,2725,0.009,-25,2712.5,"Rep",0,-50,FALSE,FALSE,FALSE,0.92,"young",29,165,62,"f"
3,"TOTAL ABDOMINAL",2,"Rep08",2680,2680,2750,2700,2680,2725,0.017,-45,2702.5,"Rep",0,50,FALSE,FALSE,FALSE,1.65,"young",29,165,62,"f"
3,"TOTAL ABDOMINAL",2,"Rep09",2760,2760,2700,2650,2760,2675,0.031,85,2717.5,"Rep",0,50,FALSE,FALSE,FALSE,3.18,"young",29,165,62,"f"
3,"TOTAL ABDOMINAL",2,"Rep10",2280,2300,2400,2400,2290,2400,0.048,-110,2345,"Rep",-20,0,FALSE,FALSE,FALSE,4.58,"young",29,165,62,"f"
3,"TOTAL ABDOMINAL",1,"TuT",31260,31260,31250,31250,31260,31250,0,10,31255,"TuT",0,0,FALSE,FALSE,FALSE,0.03,"young",29,165,62,"f"
3,"TOTAL ABDOMINAL",2,"TuT",27300,27300,27350,27350,27300,27350,0.002,-50,27325,"TuT",0,0,FALSE,FALSE,FALSE,0.18,"young",29,165,62,"f"
3,"VERTICAL TRACTION",1,"Con01",1560,1520,1600,1700,1540,1650,0.071,-110,1595,"Con",40,-100,FALSE,FALSE,FALSE,6.67,"young",29,165,62,"f"
3,"VERTICAL TRACTION",1,"Con02",1460,1500,1650,1600,1480,1625,0.098,-145,1552.5,"Con",-40,50,FALSE,FALSE,FALSE,8.92,"young",29,165,62,"f"
3,"VERTICAL TRACTION",1,"Con03",1340,1360,1500,1450,1350,1475,0.093,-125,1412.5,"Con",-20,50,FALSE,FALSE,FALSE,8.47,"young",29,165,62,"f"
3,"VERTICAL TRACTION",1,"Con04",1200,1220,1300,1250,1210,1275,0.054,-65,1242.5,"Con",-20,50,FALSE,FALSE,FALSE,5.1,"young",29,165,62,"f"
3,"VERTICAL TRACTION",1,"Con05",1220,1220,1300,1300,1220,1300,0.066,-80,1260,"Con",0,0,FALSE,FALSE,FALSE,6.15,"young",29,165,62,"f"
3,"VERTICAL TRACTION",1,"Con06",1220,1200,1300,1350,1210,1325,0.095,-115,1267.5,"Con",20,-50,FALSE,FALSE,FALSE,8.68,"young",29,165,62,"f"
3,"VERTICAL TRACTION",1,"Con07",1200,1200,1250,1300,1200,1275,0.062,-75,1237.5,"Con",0,-50,FALSE,FALSE,FALSE,5.88,"young",29,165,62,"f"
3,"VERTICAL TRACTION",1,"Con08",1160,1160,1250,1300,1160,1275,0.099,-115,1217.5,"Con",0,-50,FALSE,FALSE,FALSE,9.02,"young",29,165,62,"f"
3,"VERTICAL TRACTION",1,"Con09",1140,1140,1300,1300,1140,1300,0.14,-160,1220,"Con",0,0,FALSE,FALSE,FALSE,12.31,"young",29,165,62,"f"
3,"VERTICAL TRACTION",1,"Con10",1160,1160,1300,1350,1160,1325,0.142,-165,1242.5,"Con",0,-50,FALSE,FALSE,FALSE,12.45,"young",29,165,62,"f"
3,"VERTICAL TRACTION",2,"Con01",1460,1480,1500,1650,1470,1575,0.071,-105,1522.5,"Con",-20,-150,FALSE,FALSE,FALSE,6.67,"young",29,165,62,"f"
3,"VERTICAL TRACTION",2,"Con02",1380,1380,1500,1500,1380,1500,0.087,-120,1440,"Con",0,0,FALSE,FALSE,FALSE,8,"young",29,165,62,"f"
3,"VERTICAL TRACTION",2,"Con03",1320,1360,1500,1400,1340,1450,0.082,-110,1395,"Con",-40,100,FALSE,FALSE,FALSE,7.59,"young",29,165,62,"f"
3,"VERTICAL TRACTION",2,"Con04",1240,1260,1300,1300,1250,1300,0.04,-50,1275,"Con",-20,0,FALSE,FALSE,FALSE,3.85,"young",29,165,62,"f"
3,"VERTICAL TRACTION",2,"Con05",1180,1200,1300,1300,1190,1300,0.092,-110,1245,"Con",-20,0,FALSE,FALSE,FALSE,8.46,"young",29,165,62,"f"
3,"VERTICAL TRACTION",2,"Con06",1140,1160,1250,1250,1150,1250,0.087,-100,1200,"Con",-20,0,FALSE,FALSE,FALSE,8,"young",29,165,62,"f"
3,"VERTICAL TRACTION",2,"Con07",1140,1160,1250,1300,1150,1275,0.109,-125,1212.5,"Con",-20,-50,FALSE,FALSE,FALSE,9.8,"young",29,165,62,"f"
3,"VERTICAL TRACTION",2,"Con08",1120,1120,1150,1200,1120,1175,0.049,-55,1147.5,"Con",0,-50,FALSE,FALSE,FALSE,4.68,"young",29,165,62,"f"
3,"VERTICAL TRACTION",2,"Con09",1160,1200,1250,1300,1180,1275,0.081,-95,1227.5,"Con",-40,-50,FALSE,FALSE,FALSE,7.45,"young",29,165,62,"f"
3,"VERTICAL TRACTION",2,"Con10",1220,1240,1400,1350,1230,1375,0.118,-145,1302.5,"Con",-20,50,FALSE,FALSE,FALSE,10.55,"young",29,165,62,"f"
3,"VERTICAL TRACTION",1,"Ecc01",2580,2600,2400,2450,2590,2425,0.064,165,2507.5,"Ecc",-20,-50,FALSE,FALSE,FALSE,6.8,"young",29,165,62,"f"
3,"VERTICAL TRACTION",1,"Ecc02",2960,2920,2800,2850,2940,2825,0.039,115,2882.5,"Ecc",40,-50,FALSE,FALSE,FALSE,4.07,"young",29,165,62,"f"
3,"VERTICAL TRACTION",1,"Ecc03",2900,2880,2750,2800,2890,2775,0.04,115,2832.5,"Ecc",20,-50,FALSE,FALSE,FALSE,4.14,"young",29,165,62,"f"
3,"VERTICAL TRACTION",1,"Ecc04",2840,2840,2800,2800,2840,2800,0.014,40,2820,"Ecc",0,0,FALSE,FALSE,FALSE,1.43,"young",29,165,62,"f"
3,"VERTICAL TRACTION",1,"Ecc05",3060,3040,2950,2950,3050,2950,0.033,100,3000,"Ecc",20,0,FALSE,FALSE,FALSE,3.39,"young",29,165,62,"f"
3,"VERTICAL TRACTION",1,"Ecc06",2820,2840,2750,2700,2830,2725,0.037,105,2777.5,"Ecc",-20,50,FALSE,FALSE,FALSE,3.85,"young",29,165,62,"f"
3,"VERTICAL TRACTION",1,"Ecc07",2760,2780,2700,2650,2770,2675,0.034,95,2722.5,"Ecc",-20,50,FALSE,FALSE,FALSE,3.55,"young",29,165,62,"f"
3,"VERTICAL TRACTION",1,"Ecc08",2860,2860,2750,2700,2860,2725,0.047,135,2792.5,"Ecc",0,50,FALSE,FALSE,FALSE,4.95,"young",29,165,62,"f"
3,"VERTICAL TRACTION",1,"Ecc09",2880,2860,2700,2650,2870,2675,0.068,195,2772.5,"Ecc",20,50,FALSE,FALSE,FALSE,7.29,"young",29,165,62,"f"
3,"VERTICAL TRACTION",1,"Ecc10",2920,2960,2800,2800,2940,2800,0.048,140,2870,"Ecc",-40,0,FALSE,FALSE,FALSE,5,"young",29,165,62,"f"
3,"VERTICAL TRACTION",2,"Ecc01",2360,2340,2300,2200,2350,2250,0.043,100,2300,"Ecc",20,100,FALSE,FALSE,FALSE,4.44,"young",29,165,62,"f"
3,"VERTICAL TRACTION",2,"Ecc02",2500,2460,2300,2400,2480,2350,0.052,130,2415,"Ecc",40,-100,FALSE,FALSE,FALSE,5.53,"young",29,165,62,"f"
3,"VERTICAL TRACTION",2,"Ecc03",2480,2460,2350,2400,2470,2375,0.038,95,2422.5,"Ecc",20,-50,FALSE,FALSE,FALSE,4,"young",29,165,62,"f"
3,"VERTICAL TRACTION",2,"Ecc04",2540,2520,2450,2450,2530,2450,0.032,80,2490,"Ecc",20,0,FALSE,FALSE,FALSE,3.27,"young",29,165,62,"f"
3,"VERTICAL TRACTION",2,"Ecc05",2660,2640,2550,2550,2650,2550,0.038,100,2600,"Ecc",20,0,FALSE,FALSE,FALSE,3.92,"young",29,165,62,"f"
3,"VERTICAL TRACTION",2,"Ecc06",2620,2600,2500,2450,2610,2475,0.052,135,2542.5,"Ecc",20,50,FALSE,FALSE,FALSE,5.45,"young",29,165,62,"f"
3,"VERTICAL TRACTION",2,"Ecc07",2400,2400,2350,2300,2400,2325,0.031,75,2362.5,"Ecc",0,50,FALSE,FALSE,FALSE,3.23,"young",29,165,62,"f"
3,"VERTICAL TRACTION",2,"Ecc08",2420,2380,2350,2300,2400,2325,0.031,75,2362.5,"Ecc",40,50,FALSE,FALSE,FALSE,3.23,"young",29,165,62,"f"
3,"VERTICAL TRACTION",2,"Ecc09",2380,2360,2250,2250,2370,2250,0.051,120,2310,"Ecc",20,0,FALSE,FALSE,FALSE,5.33,"young",29,165,62,"f"
3,"VERTICAL TRACTION",2,"Ecc10",2720,2700,2550,2700,2710,2625,0.031,85,2667.5,"Ecc",20,-150,FALSE,FALSE,FALSE,3.24,"young",29,165,62,"f"
3,"VERTICAL TRACTION",1,"Rep01",4140,4120,4000,4150,4130,4075,0.013,55,4102.5,"Rep",20,-150,FALSE,FALSE,FALSE,1.35,"young",29,165,62,"f"
3,"VERTICAL TRACTION",1,"Rep02",4420,4420,4450,4450,4420,4450,0.007,-30,4435,"Rep",0,0,FALSE,FALSE,FALSE,0.67,"young",29,165,62,"f"
3,"VERTICAL TRACTION",1,"Rep03",4240,4240,4250,4250,4240,4250,0.002,-10,4245,"Rep",0,0,FALSE,FALSE,FALSE,0.24,"young",29,165,62,"f"
3,"VERTICAL TRACTION",1,"Rep04",4040,4060,4100,4050,4050,4075,0.006,-25,4062.5,"Rep",-20,50,FALSE,FALSE,FALSE,0.61,"young",29,165,62,"f"
3,"VERTICAL TRACTION",1,"Rep05",4280,4260,4250,4250,4270,4250,0.005,20,4260,"Rep",20,0,FALSE,FALSE,FALSE,0.47,"young",29,165,62,"f"
3,"VERTICAL TRACTION",1,"Rep06",4040,4040,4050,4050,4040,4050,0.002,-10,4045,"Rep",0,0,FALSE,FALSE,FALSE,0.25,"young",29,165,62,"f"
3,"VERTICAL TRACTION",1,"Rep07",3960,3980,3950,3950,3970,3950,0.005,20,3960,"Rep",-20,0,FALSE,FALSE,FALSE,0.51,"young",29,165,62,"f"
3,"VERTICAL TRACTION",1,"Rep08",4020,4020,4000,4000,4020,4000,0.005,20,4010,"Rep",0,0,FALSE,FALSE,FALSE,0.5,"young",29,165,62,"f"
3,"VERTICAL TRACTION",1,"Rep09",4020,4000,4000,3950,4010,3975,0.009,35,3992.5,"Rep",20,50,FALSE,FALSE,FALSE,0.88,"young",29,165,62,"f"
3,"VERTICAL TRACTION",1,"Rep10",4080,4120,4100,4150,4100,4125,0.006,-25,4112.5,"Rep",-40,-50,FALSE,FALSE,FALSE,0.61,"young",29,165,62,"f"
3,"VERTICAL TRACTION",2,"Rep01",3820,3820,3800,3850,3820,3825,0.001,-5,3822.5,"Rep",0,-50,FALSE,FALSE,FALSE,0.13,"young",29,165,62,"f"
3,"VERTICAL TRACTION",2,"Rep02",3880,3840,3800,3900,3860,3850,0.003,10,3855,"Rep",40,-100,FALSE,FALSE,FALSE,0.26,"young",29,165,62,"f"
3,"VERTICAL TRACTION",2,"Rep03",3800,3820,3850,3800,3810,3825,0.004,-15,3817.5,"Rep",-20,50,FALSE,FALSE,FALSE,0.39,"young",29,165,62,"f"
3,"VERTICAL TRACTION",2,"Rep04",3780,3780,3750,3750,3780,3750,0.008,30,3765,"Rep",0,0,FALSE,FALSE,FALSE,0.8,"young",29,165,62,"f"
3,"VERTICAL TRACTION",2,"Rep05",3840,3840,3850,3850,3840,3850,0.003,-10,3845,"Rep",0,0,FALSE,FALSE,FALSE,0.26,"young",29,165,62,"f"
3,"VERTICAL TRACTION",2,"Rep06",3760,3760,3750,3700,3760,3725,0.009,35,3742.5,"Rep",0,50,FALSE,FALSE,FALSE,0.94,"young",29,165,62,"f"
3,"VERTICAL TRACTION",2,"Rep07",3540,3560,3600,3600,3550,3600,0.014,-50,3575,"Rep",-20,0,FALSE,FALSE,FALSE,1.39,"young",29,165,62,"f"
3,"VERTICAL TRACTION",2,"Rep08",3540,3500,3500,3500,3520,3500,0.006,20,3510,"Rep",40,0,FALSE,FALSE,FALSE,0.57,"young",29,165,62,"f"
3,"VERTICAL TRACTION",2,"Rep09",3540,3560,3500,3550,3550,3525,0.007,25,3537.5,"Rep",-20,-50,FALSE,FALSE,FALSE,0.71,"young",29,165,62,"f"
3,"VERTICAL TRACTION",2,"Rep10",3940,3940,3950,4050,3940,4000,0.015,-60,3970,"Rep",0,-100,FALSE,FALSE,FALSE,1.5,"young",29,165,62,"f"
3,"VERTICAL TRACTION",1,"TuT",41240,41260,41150,41250,41250,41200,0.001,50,41225,"TuT",-20,-100,FALSE,FALSE,FALSE,0.12,"young",29,165,62,"f"
3,"VERTICAL TRACTION",2,"TuT",37440,37420,37350,37550,37430,37450,0.001,-20,37440,"TuT",20,-200,FALSE,FALSE,FALSE,0.05,"young",29,165,62,"f"
3,"CHEST PRESS",1,"Con01",1600,1660,1700,1600,1630,1650,0.012,-20,1640,"Con",-60,100,FALSE,TRUE,FALSE,1.21,"young",29,165,62,"f"
3,"CHEST PRESS",1,"Con02",1360,1380,1550,1500,1370,1525,0.113,-155,1447.5,"Con",-20,50,FALSE,FALSE,FALSE,10.16,"young",29,165,62,"f"
3,"CHEST PRESS",1,"Con03",1280,1280,1350,1300,1280,1325,0.035,-45,1302.5,"Con",0,50,FALSE,FALSE,FALSE,3.4,"young",29,165,62,"f"
3,"CHEST PRESS",1,"Con04",1200,1240,1300,1350,1220,1325,0.086,-105,1272.5,"Con",-40,-50,FALSE,TRUE,FALSE,7.92,"young",29,165,62,"f"
3,"CHEST PRESS",1,"Con05",1160,1180,1350,1250,1170,1300,0.111,-130,1235,"Con",-20,100,FALSE,FALSE,FALSE,10,"young",29,165,62,"f"
3,"CHEST PRESS",1,"Con06",1120,1140,1200,1250,1130,1225,0.084,-95,1177.5,"Con",-20,-50,FALSE,FALSE,FALSE,7.76,"young",29,165,62,"f"
3,"CHEST PRESS",1,"Con07",1180,1180,1350,1400,1180,1375,0.165,-195,1277.5,"Con",0,-50,FALSE,FALSE,FALSE,14.18,"young",29,165,62,"f"
3,"CHEST PRESS",1,"Con08",1200,1200,1400,1350,1200,1375,0.146,-175,1287.5,"Con",0,50,FALSE,FALSE,FALSE,12.73,"young",29,165,62,"f"
3,"CHEST PRESS",1,"Con09",1220,1240,1400,1450,1230,1425,0.159,-195,1327.5,"Con",-20,-50,FALSE,FALSE,FALSE,13.68,"young",29,165,62,"f"
3,"CHEST PRESS",1,"Con10",1120,1160,1300,1350,1140,1325,0.162,-185,1232.5,"Con",-40,-50,FALSE,TRUE,FALSE,13.96,"young",29,165,62,"f"
3,"CHEST PRESS",2,"Con01",1560,1560,1600,1600,1560,1600,0.026,-40,1580,"Con",0,0,FALSE,FALSE,FALSE,2.5,"young",29,165,62,"f"
3,"CHEST PRESS",2,"Con02",1320,1340,1500,1450,1330,1475,0.109,-145,1402.5,"Con",-20,50,FALSE,FALSE,FALSE,9.83,"young",29,165,62,"f"
3,"CHEST PRESS",2,"Con03",1280,1300,1450,1400,1290,1425,0.105,-135,1357.5,"Con",-20,50,FALSE,FALSE,FALSE,9.47,"young",29,165,62,"f"
3,"CHEST PRESS",2,"Con04",1300,1320,1400,1350,1310,1375,0.05,-65,1342.5,"Con",-20,50,FALSE,FALSE,FALSE,4.73,"young",29,165,62,"f"
3,"CHEST PRESS",2,"Con05",1320,1320,1400,1350,1320,1375,0.042,-55,1347.5,"Con",0,50,FALSE,FALSE,FALSE,4,"young",29,165,62,"f"
3,"CHEST PRESS",2,"Con06",1280,1340,1400,1400,1310,1400,0.069,-90,1355,"Con",-60,0,FALSE,TRUE,FALSE,6.43,"young",29,165,62,"f"
3,"CHEST PRESS",2,"Con07",1220,1200,1350,1400,1210,1375,0.136,-165,1292.5,"Con",20,-50,FALSE,FALSE,FALSE,12,"young",29,165,62,"f"
3,"CHEST PRESS",2,"Con08",1220,1260,1350,1450,1240,1400,0.129,-160,1320,"Con",-40,-100,FALSE,TRUE,FALSE,11.43,"young",29,165,62,"f"
3,"CHEST PRESS",2,"Con09",1240,1260,1400,1450,1250,1425,0.14,-175,1337.5,"Con",-20,-50,FALSE,FALSE,FALSE,12.28,"young",29,165,62,"f"
3,"CHEST PRESS",2,"Con10",1300,1300,1500,1600,1300,1550,0.192,-250,1425,"Con",0,-100,FALSE,FALSE,FALSE,16.13,"young",29,165,62,"f"
3,"CHEST PRESS",1,"Ecc01",2660,2640,2450,2600,2650,2525,0.047,125,2587.5,"Ecc",20,-150,FALSE,FALSE,FALSE,4.95,"young",29,165,62,"f"
3,"CHEST PRESS",1,"Ecc02",2440,2420,2350,2350,2430,2350,0.033,80,2390,"Ecc",20,0,FALSE,FALSE,FALSE,3.4,"young",29,165,62,"f"
3,"CHEST PRESS",1,"Ecc03",2560,2560,2500,2500,2560,2500,0.023,60,2530,"Ecc",0,0,FALSE,FALSE,FALSE,2.4,"young",29,165,62,"f"
3,"CHEST PRESS",1,"Ecc04",2740,2700,2550,2600,2720,2575,0.053,145,2647.5,"Ecc",40,-50,FALSE,TRUE,FALSE,5.63,"young",29,165,62,"f"
3,"CHEST PRESS",1,"Ecc05",2300,2280,2200,2200,2290,2200,0.039,90,2245,"Ecc",20,0,FALSE,FALSE,FALSE,4.09,"young",29,165,62,"f"
3,"CHEST PRESS",1,"Ecc06",2480,2480,2350,2300,2480,2325,0.062,155,2402.5,"Ecc",0,50,FALSE,FALSE,FALSE,6.67,"young",29,165,62,"f"
3,"CHEST PRESS",1,"Ecc07",2560,2540,2350,2350,2550,2350,0.078,200,2450,"Ecc",20,0,FALSE,FALSE,FALSE,8.51,"young",29,165,62,"f"
3,"CHEST PRESS",1,"Ecc08",2380,2380,2200,2200,2380,2200,0.076,180,2290,"Ecc",0,0,FALSE,FALSE,FALSE,8.18,"young",29,165,62,"f"
3,"CHEST PRESS",1,"Ecc09",2460,2440,2300,2250,2450,2275,0.071,175,2362.5,"Ecc",20,50,FALSE,FALSE,FALSE,7.69,"young",29,165,62,"f"
3,"CHEST PRESS",1,"Ecc10",2340,2320,2250,2950,2330,2600,0.116,-270,2465,"Ecc",20,-700,FALSE,FALSE,TRUE,10.38,"young",29,165,62,"f"
3,"CHEST PRESS",2,"Ecc01",2140,2120,2000,2000,2130,2000,0.061,130,2065,"Ecc",20,0,FALSE,FALSE,FALSE,6.5,"young",29,165,62,"f"
3,"CHEST PRESS",2,"Ecc02",2420,2400,2250,2300,2410,2275,0.056,135,2342.5,"Ecc",20,-50,FALSE,FALSE,FALSE,5.93,"young",29,165,62,"f"
3,"CHEST PRESS",2,"Ecc03",2680,2660,2550,2600,2670,2575,0.036,95,2622.5,"Ecc",20,-50,FALSE,FALSE,FALSE,3.69,"young",29,165,62,"f"
3,"CHEST PRESS",2,"Ecc04",2700,2700,2600,2650,2700,2625,0.028,75,2662.5,"Ecc",0,-50,FALSE,FALSE,FALSE,2.86,"young",29,165,62,"f"
3,"CHEST PRESS",2,"Ecc05",2480,2440,2350,2400,2460,2375,0.035,85,2417.5,"Ecc",40,-50,FALSE,TRUE,FALSE,3.58,"young",29,165,62,"f"
3,"CHEST PRESS",2,"Ecc06",2340,2320,2250,2200,2330,2225,0.045,105,2277.5,"Ecc",20,50,FALSE,FALSE,FALSE,4.72,"young",29,165,62,"f"
3,"CHEST PRESS",2,"Ecc07",2480,2480,2350,2250,2480,2300,0.073,180,2390,"Ecc",0,100,FALSE,FALSE,FALSE,7.83,"young",29,165,62,"f"
3,"CHEST PRESS",2,"Ecc08",2560,2520,2400,2350,2540,2375,0.065,165,2457.5,"Ecc",40,50,FALSE,TRUE,FALSE,6.95,"young",29,165,62,"f"
3,"CHEST PRESS",2,"Ecc09",2280,2280,2100,2000,2280,2050,0.101,230,2165,"Ecc",0,100,FALSE,FALSE,FALSE,11.22,"young",29,165,62,"f"
3,"CHEST PRESS",2,"Ecc10",2080,2100,2050,2050,2090,2050,0.019,40,2070,"Ecc",-20,0,FALSE,FALSE,FALSE,1.95,"young",29,165,62,"f"
3,"CHEST PRESS",1,"Rep01",4260,4300,4150,4200,4280,4175,0.025,105,4227.5,"Rep",-40,-50,FALSE,FALSE,FALSE,2.51,"young",29,165,62,"f"
3,"CHEST PRESS",1,"Rep02",3800,3800,3900,3850,3800,3875,0.02,-75,3837.5,"Rep",0,50,FALSE,FALSE,FALSE,1.94,"young",29,165,62,"f"
3,"CHEST PRESS",1,"Rep03",3840,3840,3850,3800,3840,3825,0.004,15,3832.5,"Rep",0,50,FALSE,FALSE,FALSE,0.39,"young",29,165,62,"f"
3,"CHEST PRESS",1,"Rep04",3940,3940,3850,3950,3940,3900,0.01,40,3920,"Rep",0,-100,FALSE,FALSE,FALSE,1.03,"young",29,165,62,"f"
3,"CHEST PRESS",1,"Rep05",3460,3460,3550,3450,3460,3500,0.012,-40,3480,"Rep",0,100,FALSE,FALSE,FALSE,1.14,"young",29,165,62,"f"
3,"CHEST PRESS",1,"Rep06",3600,3620,3550,3550,3610,3550,0.017,60,3580,"Rep",-20,0,FALSE,FALSE,FALSE,1.69,"young",29,165,62,"f"
3,"CHEST PRESS",1,"Rep07",3740,3720,3700,3750,3730,3725,0.001,5,3727.5,"Rep",20,-50,FALSE,FALSE,FALSE,0.13,"young",29,165,62,"f"
3,"CHEST PRESS",1,"Rep08",3580,3580,3600,3550,3580,3575,0.001,5,3577.5,"Rep",0,50,FALSE,FALSE,FALSE,0.14,"young",29,165,62,"f"
3,"CHEST PRESS",1,"Rep09",3680,3680,3700,3700,3680,3700,0.005,-20,3690,"Rep",0,0,FALSE,FALSE,FALSE,0.54,"young",29,165,62,"f"
3,"CHEST PRESS",1,"Rep10",3460,3480,3550,4300,3470,3925,0.131,-455,3697.5,"Rep",-20,-750,TRUE,FALSE,TRUE,11.59,"young",29,165,62,"f"
3,"CHEST PRESS",2,"Rep01",3700,3680,3600,3600,3690,3600,0.024,90,3645,"Rep",20,0,FALSE,FALSE,FALSE,2.5,"young",29,165,62,"f"
3,"CHEST PRESS",2,"Rep02",3740,3740,3750,3750,3740,3750,0.003,-10,3745,"Rep",0,0,FALSE,FALSE,FALSE,0.27,"young",29,165,62,"f"
3,"CHEST PRESS",2,"Rep03",3960,3960,4000,4000,3960,4000,0.01,-40,3980,"Rep",0,0,FALSE,FALSE,FALSE,1,"young",29,165,62,"f"
3,"CHEST PRESS",2,"Rep04",4000,4020,4000,4000,4010,4000,0.002,10,4005,"Rep",-20,0,FALSE,FALSE,FALSE,0.25,"young",29,165,62,"f"
3,"CHEST PRESS",2,"Rep05",3800,3760,3750,3750,3780,3750,0.008,30,3765,"Rep",40,0,FALSE,FALSE,FALSE,0.8,"young",29,165,62,"f"
3,"CHEST PRESS",2,"Rep06",3620,3660,3650,3600,3640,3625,0.004,15,3632.5,"Rep",-40,50,FALSE,FALSE,FALSE,0.41,"young",29,165,62,"f"
3,"CHEST PRESS",2,"Rep07",3700,3680,3700,3650,3690,3675,0.004,15,3682.5,"Rep",20,50,FALSE,FALSE,FALSE,0.41,"young",29,165,62,"f"
3,"CHEST PRESS",2,"Rep08",3780,3780,3750,3800,3780,3775,0.001,5,3777.5,"Rep",0,-50,FALSE,FALSE,FALSE,0.13,"young",29,165,62,"f"
3,"CHEST PRESS",2,"Rep09",3520,3540,3500,3450,3530,3475,0.016,55,3502.5,"Rep",-20,50,FALSE,FALSE,FALSE,1.58,"young",29,165,62,"f"
3,"CHEST PRESS",2,"Rep10",3380,3400,3550,3650,3390,3600,0.062,-210,3495,"Rep",-20,-100,TRUE,FALSE,FALSE,5.83,"young",29,165,62,"f"
3,"CHEST PRESS",1,"TuT",37360,37420,37400,38100,37390,37750,0.01,-360,37570,"TuT",-60,-700,FALSE,FALSE,FALSE,0.95,"young",29,165,62,"f"
3,"CHEST PRESS",2,"TuT",37200,37220,37250,37250,37210,37250,0.001,-40,37230,"TuT",-20,0,FALSE,FALSE,FALSE,0.11,"young",29,165,62,"f"
4,"LEG PRESS",1,"Con01",1480,1500,1600,1550,1490,1575,0.057,-85,1532.5,"Con",-20,50,FALSE,FALSE,FALSE,5.4,"old",70,173,84,"m"
4,"LEG PRESS",1,"Con02",1200,1220,1200,1200,1210,1200,0.008,10,1205,"Con",-20,0,FALSE,FALSE,FALSE,0.83,"old",70,173,84,"m"
4,"LEG PRESS",1,"Con03",1180,1200,1250,1250,1190,1250,0.05,-60,1220,"Con",-20,0,FALSE,FALSE,FALSE,4.8,"old",70,173,84,"m"
4,"LEG PRESS",1,"Con04",1200,1200,1200,1200,1200,1200,0,0,1200,"Con",0,0,FALSE,FALSE,FALSE,0,"old",70,173,84,"m"
4,"LEG PRESS",1,"Con05",1160,1160,1200,1250,1160,1225,0.056,-65,1192.5,"Con",0,-50,FALSE,FALSE,FALSE,5.31,"old",70,173,84,"m"
4,"LEG PRESS",1,"Con06",1140,1160,1250,1250,1150,1250,0.087,-100,1200,"Con",-20,0,FALSE,FALSE,FALSE,8,"old",70,173,84,"m"
4,"LEG PRESS",1,"Con07",1100,1140,1200,1150,1120,1175,0.049,-55,1147.5,"Con",-40,50,FALSE,FALSE,FALSE,4.68,"old",70,173,84,"m"
4,"LEG PRESS",1,"Con08",1060,1080,1150,1150,1070,1150,0.075,-80,1110,"Con",-20,0,FALSE,FALSE,FALSE,6.96,"old",70,173,84,"m"
4,"LEG PRESS",1,"Con09",1040,1080,1150,1200,1060,1175,0.108,-115,1117.5,"Con",-40,-50,FALSE,FALSE,FALSE,9.79,"old",70,173,84,"m"
4,"LEG PRESS",1,"Con10",1020,1060,1150,1150,1040,1150,0.106,-110,1095,"Con",-40,0,FALSE,FALSE,FALSE,9.57,"old",70,173,84,"m"
4,"LEG PRESS",2,"Con01",1260,1240,1300,1400,1250,1350,0.08,-100,1300,"Con",20,-100,FALSE,FALSE,FALSE,7.41,"old",70,173,84,"m"
4,"LEG PRESS",2,"Con02",1160,1200,1150,1150,1180,1150,0.025,30,1165,"Con",-40,0,FALSE,FALSE,FALSE,2.61,"old",70,173,84,"m"
4,"LEG PRESS",2,"Con03",1180,1180,1200,1200,1180,1200,0.017,-20,1190,"Con",0,0,FALSE,FALSE,FALSE,1.67,"old",70,173,84,"m"
4,"LEG PRESS",2,"Con04",1260,1260,1250,1200,1260,1225,0.028,35,1242.5,"Con",0,50,FALSE,FALSE,FALSE,2.86,"old",70,173,84,"m"
4,"LEG PRESS",2,"Con05",1180,1200,1250,1250,1190,1250,0.05,-60,1220,"Con",-20,0,FALSE,FALSE,FALSE,4.8,"old",70,173,84,"m"
4,"LEG PRESS",2,"Con06",1140,1160,1250,1200,1150,1225,0.065,-75,1187.5,"Con",-20,50,FALSE,FALSE,FALSE,6.12,"old",70,173,84,"m"
4,"LEG PRESS",2,"Con07",1140,1120,1200,1250,1130,1225,0.084,-95,1177.5,"Con",20,-50,FALSE,FALSE,FALSE,7.76,"old",70,173,84,"m"
4,"LEG PRESS",2,"Con08",1100,1060,1200,1200,1080,1200,0.111,-120,1140,"Con",40,0,FALSE,FALSE,FALSE,10,"old",70,173,84,"m"
4,"LEG PRESS",2,"Con09",1080,1100,1250,1250,1090,1250,0.147,-160,1170,"Con",-20,0,FALSE,FALSE,FALSE,12.8,"old",70,173,84,"m"
4,"LEG PRESS",2,"Con10",1040,1000,1150,1150,1020,1150,0.127,-130,1085,"Con",40,0,FALSE,FALSE,FALSE,11.3,"old",70,173,84,"m"
4,"LEG PRESS",1,"Ecc01",1440,1440,1450,1500,1440,1475,0.024,-35,1457.5,"Ecc",0,-50,FALSE,FALSE,FALSE,2.37,"old",70,173,84,"m"
4,"LEG PRESS",1,"Ecc02",1760,1720,1700,1700,1740,1700,0.023,40,1720,"Ecc",40,0,FALSE,FALSE,FALSE,2.35,"old",70,173,84,"m"
4,"LEG PRESS",1,"Ecc03",1540,1520,1500,1500,1530,1500,0.02,30,1515,"Ecc",20,0,FALSE,FALSE,FALSE,2,"old",70,173,84,"m"
4,"LEG PRESS",1,"Ecc04",1440,1440,1400,1400,1440,1400,0.028,40,1420,"Ecc",0,0,FALSE,FALSE,FALSE,2.86,"old",70,173,84,"m"
4,"LEG PRESS",1,"Ecc05",1560,1560,1500,1450,1560,1475,0.054,85,1517.5,"Ecc",0,50,FALSE,FALSE,FALSE,5.76,"old",70,173,84,"m"
4,"LEG PRESS",1,"Ecc06",1460,1440,1350,1400,1450,1375,0.052,75,1412.5,"Ecc",20,-50,FALSE,FALSE,FALSE,5.45,"old",70,173,84,"m"
4,"LEG PRESS",1,"Ecc07",1480,1440,1400,1400,1460,1400,0.041,60,1430,"Ecc",40,0,FALSE,FALSE,FALSE,4.29,"old",70,173,84,"m"
4,"LEG PRESS",1,"Ecc08",1360,1320,1250,1250,1340,1250,0.067,90,1295,"Ecc",40,0,FALSE,FALSE,FALSE,7.2,"old",70,173,84,"m"
4,"LEG PRESS",1,"Ecc09",1500,1480,1400,1350,1490,1375,0.077,115,1432.5,"Ecc",20,50,FALSE,FALSE,FALSE,8.36,"old",70,173,84,"m"
4,"LEG PRESS",1,"Ecc10",2860,2880,2800,2850,2870,2825,0.016,45,2847.5,"Ecc",-20,-50,FALSE,FALSE,FALSE,1.59,"old",70,173,84,"m"
4,"LEG PRESS",2,"Ecc01",1340,1300,1350,1300,1320,1325,0.004,-5,1322.5,"Ecc",40,50,FALSE,FALSE,FALSE,0.38,"old",70,173,84,"m"
4,"LEG PRESS",2,"Ecc02",1420,1420,1400,1450,1420,1425,0.004,-5,1422.5,"Ecc",0,-50,FALSE,FALSE,FALSE,0.35,"old",70,173,84,"m"
4,"LEG PRESS",2,"Ecc03",1380,1380,1400,1400,1380,1400,0.014,-20,1390,"Ecc",0,0,FALSE,FALSE,FALSE,1.43,"old",70,173,84,"m"
4,"LEG PRESS",2,"Ecc04",1520,1500,1450,1500,1510,1475,0.023,35,1492.5,"Ecc",20,-50,FALSE,FALSE,FALSE,2.37,"old",70,173,84,"m"
4,"LEG PRESS",2,"Ecc05",1520,1500,1450,1450,1510,1450,0.04,60,1480,"Ecc",20,0,FALSE,FALSE,FALSE,4.14,"old",70,173,84,"m"
4,"LEG PRESS",2,"Ecc06",1420,1420,1350,1350,1420,1350,0.049,70,1385,"Ecc",0,0,FALSE,FALSE,FALSE,5.19,"old",70,173,84,"m"
4,"LEG PRESS",2,"Ecc07",1480,1500,1400,1350,1490,1375,0.077,115,1432.5,"Ecc",-20,50,FALSE,FALSE,FALSE,8.36,"old",70,173,84,"m"
4,"LEG PRESS",2,"Ecc08",1560,1580,1400,1400,1570,1400,0.108,170,1485,"Ecc",-20,0,FALSE,FALSE,FALSE,12.14,"old",70,173,84,"m"
4,"LEG PRESS",2,"Ecc09",1400,1420,1300,1300,1410,1300,0.078,110,1355,"Ecc",-20,0,FALSE,FALSE,FALSE,8.46,"old",70,173,84,"m"
4,"LEG PRESS",2,"Ecc10",2660,2680,2050,2600,2670,2325,0.129,345,2497.5,"Ecc",-20,-550,TRUE,FALSE,TRUE,14.84,"old",70,173,84,"m"
4,"LEG PRESS",1,"Rep01",2920,2940,3050,3050,2930,3050,0.041,-120,2990,"Rep",-20,0,TRUE,FALSE,FALSE,3.93,"old",70,173,84,"m"
4,"LEG PRESS",1,"Rep02",2960,2940,2900,2900,2950,2900,0.017,50,2925,"Rep",20,0,FALSE,FALSE,FALSE,1.72,"old",70,173,84,"m"
4,"LEG PRESS",1,"Rep03",2720,2720,2750,2750,2720,2750,0.011,-30,2735,"Rep",0,0,FALSE,FALSE,FALSE,1.09,"old",70,173,84,"m"
4,"LEG PRESS",1,"Rep04",2640,2640,2600,2600,2640,2600,0.015,40,2620,"Rep",0,0,FALSE,FALSE,FALSE,1.54,"old",70,173,84,"m"
4,"LEG PRESS",1,"Rep05",2720,2720,2700,2700,2720,2700,0.007,20,2710,"Rep",0,0,FALSE,FALSE,FALSE,0.74,"old",70,173,84,"m"
4,"LEG PRESS",1,"Rep06",2600,2600,2600,2650,2600,2625,0.01,-25,2612.5,"Rep",0,-50,FALSE,FALSE,FALSE,0.95,"old",70,173,84,"m"
4,"LEG PRESS",1,"Rep07",2580,2580,2600,2550,2580,2575,0.002,5,2577.5,"Rep",0,50,FALSE,FALSE,FALSE,0.19,"old",70,173,84,"m"
4,"LEG PRESS",1,"Rep08",2420,2400,2400,2400,2410,2400,0.004,10,2405,"Rep",20,0,FALSE,FALSE,FALSE,0.42,"old",70,173,84,"m"
4,"LEG PRESS",1,"Rep09",2540,2560,2550,2550,2550,2550,0,0,2550,"Rep",-20,0,FALSE,FALSE,FALSE,0,"old",70,173,84,"m"
4,"LEG PRESS",1,"Rep10",3880,3940,3950,4000,3910,3975,0.017,-65,3942.5,"Rep",-60,-50,FALSE,FALSE,FALSE,1.64,"old",70,173,84,"m"
4,"LEG PRESS",2,"Rep01",2600,2540,2650,2700,2570,2675,0.041,-105,2622.5,"Rep",60,-50,FALSE,FALSE,FALSE,3.93,"old",70,173,84,"m"
4,"LEG PRESS",2,"Rep02",2580,2620,2550,2600,2600,2575,0.01,25,2587.5,"Rep",-40,-50,FALSE,FALSE,FALSE,0.97,"old",70,173,84,"m"
4,"LEG PRESS",2,"Rep03",2560,2560,2600,2600,2560,2600,0.016,-40,2580,"Rep",0,0,FALSE,FALSE,FALSE,1.54,"old",70,173,84,"m"
4,"LEG PRESS",2,"Rep04",2780,2760,2700,2700,2770,2700,0.025,70,2735,"Rep",20,0,FALSE,FALSE,FALSE,2.59,"old",70,173,84,"m"
4,"LEG PRESS",2,"Rep05",2700,2700,2700,2700,2700,2700,0,0,2700,"Rep",0,0,FALSE,FALSE,FALSE,0,"old",70,173,84,"m"
4,"LEG PRESS",2,"Rep06",2560,2580,2600,2550,2570,2575,0.002,-5,2572.5,"Rep",-20,50,FALSE,FALSE,FALSE,0.19,"old",70,173,84,"m"
4,"LEG PRESS",2,"Rep07",2620,2620,2600,2600,2620,2600,0.008,20,2610,"Rep",0,0,FALSE,FALSE,FALSE,0.77,"old",70,173,84,"m"
4,"LEG PRESS",2,"Rep08",2660,2640,2600,2600,2650,2600,0.019,50,2625,"Rep",20,0,FALSE,FALSE,FALSE,1.92,"old",70,173,84,"m"
4,"LEG PRESS",2,"Rep09",2480,2520,2550,2550,2500,2550,0.02,-50,2525,"Rep",-40,0,FALSE,FALSE,FALSE,1.96,"old",70,173,84,"m"
4,"LEG PRESS",2,"Rep10",3700,3680,3200,3750,3690,3475,0.058,215,3582.5,"Rep",20,-550,TRUE,FALSE,TRUE,6.19,"old",70,173,84,"m"
4,"LEG PRESS",1,"TuT",27980,28040,28100,28150,28010,28125,0.004,-115,28067.5,"TuT",-60,-50,FALSE,FALSE,FALSE,0.41,"old",70,173,84,"m"
4,"LEG PRESS",2,"TuT",27240,27220,26750,27350,27230,27050,0.007,180,27140,"TuT",20,-600,FALSE,FALSE,TRUE,0.67,"old",70,173,84,"m"
4,"LEG EXTENSION",1,"Con01",2220,2240,1200,1600,2230,1400,0.372,830,1815,"Con",-20,-400,TRUE,FALSE,TRUE,59.29,"old",70,173,84,"m"
4,"LEG EXTENSION",1,"Con02",1180,1200,1200,1300,1190,1250,0.05,-60,1220,"Con",-20,-100,FALSE,FALSE,FALSE,4.8,"old",70,173,84,"m"
4,"LEG EXTENSION",1,"Con03",1180,1200,1100,1200,1190,1150,0.034,40,1170,"Con",-20,-100,FALSE,FALSE,FALSE,3.48,"old",70,173,84,"m"
4,"LEG EXTENSION",1,"Con04",1120,1120,1150,1150,1120,1150,0.027,-30,1135,"Con",0,0,FALSE,FALSE,FALSE,2.61,"old",70,173,84,"m"
4,"LEG EXTENSION",1,"Con05",1100,1080,1150,1100,1090,1125,0.032,-35,1107.5,"Con",20,50,FALSE,FALSE,FALSE,3.11,"old",70,173,84,"m"
4,"LEG EXTENSION",1,"Con06",1160,1160,1250,1250,1160,1250,0.078,-90,1205,"Con",0,0,FALSE,FALSE,FALSE,7.2,"old",70,173,84,"m"
4,"LEG EXTENSION",1,"Con07",1120,1160,1300,1250,1140,1275,0.118,-135,1207.5,"Con",-40,50,FALSE,TRUE,FALSE,10.59,"old",70,173,84,"m"
4,"LEG EXTENSION",1,"Con08",1160,1160,1300,1250,1160,1275,0.099,-115,1217.5,"Con",0,50,FALSE,FALSE,FALSE,9.02,"old",70,173,84,"m"
4,"LEG EXTENSION",1,"Con09",1160,1180,1300,1250,1170,1275,0.09,-105,1222.5,"Con",-20,50,FALSE,FALSE,FALSE,8.24,"old",70,173,84,"m"
4,"LEG EXTENSION",1,"Con10",1080,1100,1250,1200,1090,1225,0.124,-135,1157.5,"Con",-20,50,FALSE,FALSE,FALSE,11.02,"old",70,173,84,"m"
4,"LEG EXTENSION",2,"Con01",1800,1780,1600,1650,1790,1625,0.092,165,1707.5,"Con",20,-50,FALSE,FALSE,FALSE,10.15,"old",70,173,84,"m"
4,"LEG EXTENSION",2,"Con02",1080,1100,1050,1100,1090,1075,0.014,15,1082.5,"Con",-20,-50,FALSE,FALSE,FALSE,1.4,"old",70,173,84,"m"
4,"LEG EXTENSION",2,"Con03",1180,1180,1200,1150,1180,1175,0.004,5,1177.5,"Con",0,50,FALSE,FALSE,FALSE,0.43,"old",70,173,84,"m"
4,"LEG EXTENSION",2,"Con04",1140,1140,1200,1150,1140,1175,0.031,-35,1157.5,"Con",0,50,FALSE,FALSE,FALSE,2.98,"old",70,173,84,"m"
4,"LEG EXTENSION",2,"Con05",1180,1180,1200,1200,1180,1200,0.017,-20,1190,"Con",0,0,FALSE,FALSE,FALSE,1.67,"old",70,173,84,"m"
4,"LEG EXTENSION",2,"Con06",1180,1180,1200,1250,1180,1225,0.038,-45,1202.5,"Con",0,-50,FALSE,FALSE,FALSE,3.67,"old",70,173,84,"m"
4,"LEG EXTENSION",2,"Con07",1160,1180,1200,1250,1170,1225,0.047,-55,1197.5,"Con",-20,-50,FALSE,FALSE,FALSE,4.49,"old",70,173,84,"m"
4,"LEG EXTENSION",2,"Con08",1100,1120,1100,1150,1110,1125,0.014,-15,1117.5,"Con",-20,-50,FALSE,FALSE,FALSE,1.33,"old",70,173,84,"m"
4,"LEG EXTENSION",2,"Con09",1040,1080,1050,1100,1060,1075,0.014,-15,1067.5,"Con",-40,-50,FALSE,TRUE,FALSE,1.4,"old",70,173,84,"m"
4,"LEG EXTENSION",2,"Con10",1040,1040,1150,1100,1040,1125,0.082,-85,1082.5,"Con",0,50,FALSE,FALSE,FALSE,7.56,"old",70,173,84,"m"
4,"LEG EXTENSION",1,"Ecc01",1480,1460,1500,1450,1470,1475,0.003,-5,1472.5,"Ecc",20,50,FALSE,FALSE,FALSE,0.34,"old",70,173,84,"m"
4,"LEG EXTENSION",1,"Ecc02",1600,1580,1650,1550,1590,1600,0.006,-10,1595,"Ecc",20,100,FALSE,FALSE,FALSE,0.62,"old",70,173,84,"m"
4,"LEG EXTENSION",1,"Ecc03",1660,1640,1650,1600,1650,1625,0.015,25,1637.5,"Ecc",20,50,FALSE,FALSE,FALSE,1.54,"old",70,173,84,"m"
4,"LEG EXTENSION",1,"Ecc04",1600,1620,1550,1600,1610,1575,0.022,35,1592.5,"Ecc",-20,-50,FALSE,FALSE,FALSE,2.22,"old",70,173,84,"m"
4,"LEG EXTENSION",1,"Ecc05",1500,1500,1450,1450,1500,1450,0.033,50,1475,"Ecc",0,0,FALSE,FALSE,FALSE,3.45,"old",70,173,84,"m"
4,"LEG EXTENSION",1,"Ecc06",1440,1420,1300,1350,1430,1325,0.073,105,1377.5,"Ecc",20,-50,FALSE,FALSE,FALSE,7.92,"old",70,173,84,"m"
4,"LEG EXTENSION",1,"Ecc07",1520,1500,1350,1400,1510,1375,0.089,135,1442.5,"Ecc",20,-50,FALSE,FALSE,FALSE,9.82,"old",70,173,84,"m"
4,"LEG EXTENSION",1,"Ecc08",1360,1360,1200,1300,1360,1250,0.081,110,1305,"Ecc",0,-100,FALSE,FALSE,FALSE,8.8,"old",70,173,84,"m"
4,"LEG EXTENSION",1,"Ecc09",1380,1340,1250,1250,1360,1250,0.081,110,1305,"Ecc",40,0,FALSE,TRUE,FALSE,8.8,"old",70,173,84,"m"
4,"LEG EXTENSION",1,"Ecc10",2520,2540,2500,2500,2530,2500,0.012,30,2515,"Ecc",-20,0,FALSE,FALSE,FALSE,1.2,"old",70,173,84,"m"
4,"LEG EXTENSION",2,"Ecc01",1260,1280,1350,1300,1270,1325,0.043,-55,1297.5,"Ecc",-20,50,FALSE,FALSE,FALSE,4.15,"old",70,173,84,"m"
4,"LEG EXTENSION",2,"Ecc02",1300,1280,1300,1300,1290,1300,0.008,-10,1295,"Ecc",20,0,FALSE,FALSE,FALSE,0.77,"old",70,173,84,"m"
4,"LEG EXTENSION",2,"Ecc03",1360,1360,1300,1350,1360,1325,0.026,35,1342.5,"Ecc",0,-50,FALSE,FALSE,FALSE,2.64,"old",70,173,84,"m"
4,"LEG EXTENSION",2,"Ecc04",1240,1260,1200,1250,1250,1225,0.02,25,1237.5,"Ecc",-20,-50,FALSE,FALSE,FALSE,2.04,"old",70,173,84,"m"
4,"LEG EXTENSION",2,"Ecc05",1260,1240,1250,1200,1250,1225,0.02,25,1237.5,"Ecc",20,50,FALSE,FALSE,FALSE,2.04,"old",70,173,84,"m"
4,"LEG EXTENSION",2,"Ecc06",1300,1280,1250,1200,1290,1225,0.05,65,1257.5,"Ecc",20,50,FALSE,FALSE,FALSE,5.31,"old",70,173,84,"m"
4,"LEG EXTENSION",2,"Ecc07",1300,1300,1300,1250,1300,1275,0.019,25,1287.5,"Ecc",0,50,FALSE,FALSE,FALSE,1.96,"old",70,173,84,"m"
4,"LEG EXTENSION",2,"Ecc08",1260,1220,1250,1200,1240,1225,0.012,15,1232.5,"Ecc",40,50,FALSE,TRUE,FALSE,1.22,"old",70,173,84,"m"
4,"LEG EXTENSION",2,"Ecc09",1320,1320,1250,1250,1320,1250,0.053,70,1285,"Ecc",0,0,FALSE,FALSE,FALSE,5.6,"old",70,173,84,"m"
4,"LEG EXTENSION",2,"Ecc10",1860,1860,1850,1900,1860,1875,0.008,-15,1867.5,"Ecc",0,-50,FALSE,FALSE,FALSE,0.8,"old",70,173,84,"m"
4,"LEG EXTENSION",1,"Rep01",3700,3700,2700,3050,3700,2875,0.223,825,3287.5,"Rep",0,-350,TRUE,FALSE,TRUE,28.7,"old",70,173,84,"m"
4,"LEG EXTENSION",1,"Rep02",2780,2780,2850,2850,2780,2850,0.025,-70,2815,"Rep",0,0,FALSE,FALSE,FALSE,2.46,"old",70,173,84,"m"
4,"LEG EXTENSION",1,"Rep03",2840,2840,2750,2800,2840,2775,0.023,65,2807.5,"Rep",0,-50,FALSE,FALSE,FALSE,2.34,"old",70,173,84,"m"
4,"LEG EXTENSION",1,"Rep04",2720,2740,2700,2750,2730,2725,0.002,5,2727.5,"Rep",-20,-50,FALSE,FALSE,FALSE,0.18,"old",70,173,84,"m"
4,"LEG EXTENSION",1,"Rep05",2600,2580,2600,2550,2590,2575,0.006,15,2582.5,"Rep",20,50,FALSE,FALSE,FALSE,0.58,"old",70,173,84,"m"
4,"LEG EXTENSION",1,"Rep06",2600,2580,2550,2600,2590,2575,0.006,15,2582.5,"Rep",20,-50,FALSE,FALSE,FALSE,0.58,"old",70,173,84,"m"
4,"LEG EXTENSION",1,"Rep07",2640,2660,2650,2650,2650,2650,0,0,2650,"Rep",-20,0,FALSE,FALSE,FALSE,0,"old",70,173,84,"m"
4,"LEG EXTENSION",1,"Rep08",2520,2520,2500,2550,2520,2525,0.002,-5,2522.5,"Rep",0,-50,FALSE,FALSE,FALSE,0.2,"old",70,173,84,"m"
4,"LEG EXTENSION",1,"Rep09",2540,2520,2550,2500,2530,2525,0.002,5,2527.5,"Rep",20,50,FALSE,FALSE,FALSE,0.2,"old",70,173,84,"m"
4,"LEG EXTENSION",1,"Rep10",3600,3640,3750,3700,3620,3725,0.029,-105,3672.5,"Rep",-40,50,FALSE,FALSE,FALSE,2.82,"old",70,173,84,"m"
4,"LEG EXTENSION",2,"Rep01",3060,3060,2950,2950,3060,2950,0.036,110,3005,"Rep",0,0,TRUE,FALSE,FALSE,3.73,"old",70,173,84,"m"
4,"LEG EXTENSION",2,"Rep02",2380,2380,2350,2400,2380,2375,0.002,5,2377.5,"Rep",0,-50,FALSE,FALSE,FALSE,0.21,"old",70,173,84,"m"
4,"LEG EXTENSION",2,"Rep03",2540,2540,2500,2500,2540,2500,0.016,40,2520,"Rep",0,0,FALSE,FALSE,FALSE,1.6,"old",70,173,84,"m"
4,"LEG EXTENSION",2,"Rep04",2380,2400,2400,2400,2390,2400,0.004,-10,2395,"Rep",-20,0,FALSE,FALSE,FALSE,0.42,"old",70,173,84,"m"
4,"LEG EXTENSION",2,"Rep05",2440,2420,2450,2400,2430,2425,0.002,5,2427.5,"Rep",20,50,FALSE,FALSE,FALSE,0.21,"old",70,173,84,"m"
4,"LEG EXTENSION",2,"Rep06",2480,2460,2450,2450,2470,2450,0.008,20,2460,"Rep",20,0,FALSE,FALSE,FALSE,0.82,"old",70,173,84,"m"
4,"LEG EXTENSION",2,"Rep07",2460,2480,2500,2500,2470,2500,0.012,-30,2485,"Rep",-20,0,FALSE,FALSE,FALSE,1.2,"old",70,173,84,"m"
4,"LEG EXTENSION",2,"Rep08",2360,2340,2350,2350,2350,2350,0,0,2350,"Rep",20,0,FALSE,FALSE,FALSE,0,"old",70,173,84,"m"
4,"LEG EXTENSION",2,"Rep09",2360,2400,2300,2350,2380,2325,0.023,55,2352.5,"Rep",-40,-50,FALSE,FALSE,FALSE,2.37,"old",70,173,84,"m"
4,"LEG EXTENSION",2,"Rep10",2900,2900,3000,3000,2900,3000,0.034,-100,2950,"Rep",0,0,FALSE,FALSE,FALSE,3.33,"old",70,173,84,"m"
4,"LEG EXTENSION",1,"TuT",28540,28560,27600,28000,28550,27800,0.026,750,28175,"TuT",-20,-400,TRUE,FALSE,TRUE,2.7,"old",70,173,84,"m"
4,"LEG EXTENSION",2,"TuT",25360,25380,25250,25300,25370,25275,0.004,95,25322.5,"TuT",-20,-50,FALSE,FALSE,FALSE,0.38,"old",70,173,84,"m"
4,"LEG CURL",1,"Con01",1760,1760,1500,1800,1760,1650,0.062,110,1705,"Con",0,-300,FALSE,FALSE,TRUE,6.67,"old",70,173,84,"m"
4,"LEG CURL",1,"Con02",1100,1080,1050,1100,1090,1075,0.014,15,1082.5,"Con",20,-50,FALSE,FALSE,FALSE,1.4,"old",70,173,84,"m"
4,"LEG CURL",1,"Con03",1580,1580,1350,1500,1580,1425,0.098,155,1502.5,"Con",0,-150,FALSE,FALSE,FALSE,10.88,"old",70,173,84,"m"
4,"LEG CURL",1,"Con04",1860,1840,1650,1800,1850,1725,0.068,125,1787.5,"Con",20,-150,FALSE,FALSE,FALSE,7.25,"old",70,173,84,"m"
4,"LEG CURL",1,"Con05",2020,2040,2000,1950,2030,1975,0.027,55,2002.5,"Con",-20,50,FALSE,FALSE,FALSE,2.78,"old",70,173,84,"m"
4,"LEG CURL",1,"Con06",1680,1740,1750,1700,1710,1725,0.009,-15,1717.5,"Con",-60,50,FALSE,FALSE,FALSE,0.87,"old",70,173,84,"m"
4,"LEG CURL",1,"Con07",1680,1700,1700,1650,1690,1675,0.009,15,1682.5,"Con",-20,50,FALSE,FALSE,FALSE,0.9,"old",70,173,84,"m"
4,"LEG CURL",1,"Con08",1460,1500,1450,1450,1480,1450,0.02,30,1465,"Con",-40,0,FALSE,FALSE,FALSE,2.07,"old",70,173,84,"m"
4,"LEG CURL",1,"Con09",1560,1560,1600,1650,1560,1625,0.042,-65,1592.5,"Con",0,-50,FALSE,FALSE,FALSE,4,"old",70,173,84,"m"
4,"LEG CURL",1,"Con10",1320,1320,1400,1400,1320,1400,0.061,-80,1360,"Con",0,0,FALSE,FALSE,FALSE,5.71,"old",70,173,84,"m"
4,"LEG CURL",2,"Con01",1960,1980,2000,2000,1970,2000,0.015,-30,1985,"Con",-20,0,FALSE,FALSE,FALSE,1.5,"old",70,173,84,"m"
4,"LEG CURL",2,"Con02",1580,1580,1450,1450,1580,1450,0.082,130,1515,"Con",0,0,FALSE,FALSE,FALSE,8.97,"old",70,173,84,"m"
4,"LEG CURL",2,"Con03",1620,1620,1500,1500,1620,1500,0.074,120,1560,"Con",0,0,FALSE,FALSE,FALSE,8,"old",70,173,84,"m"
4,"LEG CURL",2,"Con04",1500,1520,1450,1450,1510,1450,0.04,60,1480,"Con",-20,0,FALSE,FALSE,FALSE,4.14,"old",70,173,84,"m"
4,"LEG CURL",2,"Con05",1600,1620,1550,1550,1610,1550,0.037,60,1580,"Con",-20,0,FALSE,FALSE,FALSE,3.87,"old",70,173,84,"m"
4,"LEG CURL",2,"Con06",1320,1380,1400,1450,1350,1425,0.056,-75,1387.5,"Con",-60,-50,FALSE,FALSE,FALSE,5.26,"old",70,173,84,"m"
4,"LEG CURL",2,"Con07",1480,1480,1450,1450,1480,1450,0.02,30,1465,"Con",0,0,FALSE,FALSE,FALSE,2.07,"old",70,173,84,"m"
4,"LEG CURL",2,"Con08",1160,1120,1200,1200,1140,1200,0.053,-60,1170,"Con",40,0,FALSE,FALSE,FALSE,5,"old",70,173,84,"m"
4,"LEG CURL",2,"Con09",1460,1480,1500,1500,1470,1500,0.02,-30,1485,"Con",-20,0,FALSE,FALSE,FALSE,2,"old",70,173,84,"m"
4,"LEG CURL",2,"Con10",1260,1300,1350,1350,1280,1350,0.055,-70,1315,"Con",-40,0,FALSE,FALSE,FALSE,5.19,"old",70,173,84,"m"
4,"LEG CURL",1,"Ecc01",1500,1520,1500,1450,1510,1475,0.023,35,1492.5,"Ecc",-20,50,FALSE,FALSE,FALSE,2.37,"old",70,173,84,"m"
4,"LEG CURL",1,"Ecc02",1320,1320,1550,1400,1320,1475,0.117,-155,1397.5,"Ecc",0,150,FALSE,FALSE,FALSE,10.51,"old",70,173,84,"m"
4,"LEG CURL",1,"Ecc03",1580,1600,1850,1700,1590,1775,0.116,-185,1682.5,"Ecc",-20,150,FALSE,FALSE,FALSE,10.42,"old",70,173,84,"m"
4,"LEG CURL",1,"Ecc04",1640,1620,1700,1700,1630,1700,0.043,-70,1665,"Ecc",20,0,FALSE,FALSE,FALSE,4.12,"old",70,173,84,"m"
4,"LEG CURL",1,"Ecc05",1600,1560,1550,1600,1580,1575,0.003,5,1577.5,"Ecc",40,-50,FALSE,FALSE,FALSE,0.32,"old",70,173,84,"m"
4,"LEG CURL",1,"Ecc06",1480,1460,1400,1500,1470,1450,0.014,20,1460,"Ecc",20,-100,FALSE,FALSE,FALSE,1.38,"old",70,173,84,"m"
4,"LEG CURL",1,"Ecc07",1600,1560,1600,1600,1580,1600,0.013,-20,1590,"Ecc",40,0,FALSE,FALSE,FALSE,1.25,"old",70,173,84,"m"
4,"LEG CURL",1,"Ecc08",1240,1220,1250,1200,1230,1225,0.004,5,1227.5,"Ecc",20,50,FALSE,FALSE,FALSE,0.41,"old",70,173,84,"m"
4,"LEG CURL",1,"Ecc09",1460,1460,1400,1350,1460,1375,0.058,85,1417.5,"Ecc",0,50,FALSE,FALSE,FALSE,6.18,"old",70,173,84,"m"
4,"LEG CURL",1,"Ecc10",2320,2300,2350,2350,2310,2350,0.017,-40,2330,"Ecc",20,0,FALSE,FALSE,FALSE,1.7,"old",70,173,84,"m"
4,"LEG CURL",2,"Ecc01",1260,1260,1400,1400,1260,1400,0.111,-140,1330,"Ecc",0,0,FALSE,FALSE,FALSE,10,"old",70,173,84,"m"
4,"LEG CURL",2,"Ecc02",1400,1420,1500,1500,1410,1500,0.064,-90,1455,"Ecc",-20,0,FALSE,FALSE,FALSE,6,"old",70,173,84,"m"
4,"LEG CURL",2,"Ecc03",1280,1260,1350,1350,1270,1350,0.063,-80,1310,"Ecc",20,0,FALSE,FALSE,FALSE,5.93,"old",70,173,84,"m"
4,"LEG CURL",2,"Ecc04",1340,1300,1400,1400,1320,1400,0.061,-80,1360,"Ecc",40,0,FALSE,FALSE,FALSE,5.71,"old",70,173,84,"m"
4,"LEG CURL",2,"Ecc05",1580,1560,1500,1450,1570,1475,0.061,95,1522.5,"Ecc",20,50,FALSE,FALSE,FALSE,6.44,"old",70,173,84,"m"
4,"LEG CURL",2,"Ecc06",1400,1360,1450,1450,1380,1450,0.051,-70,1415,"Ecc",40,0,FALSE,FALSE,FALSE,4.83,"old",70,173,84,"m"
4,"LEG CURL",2,"Ecc07",1340,1360,1300,1300,1350,1300,0.037,50,1325,"Ecc",-20,0,FALSE,FALSE,FALSE,3.85,"old",70,173,84,"m"
4,"LEG CURL",2,"Ecc08",1260,1260,1250,1250,1260,1250,0.008,10,1255,"Ecc",0,0,FALSE,FALSE,FALSE,0.8,"old",70,173,84,"m"
4,"LEG CURL",2,"Ecc09",1480,1460,1400,1400,1470,1400,0.048,70,1435,"Ecc",20,0,FALSE,FALSE,FALSE,5,"old",70,173,84,"m"
4,"LEG CURL",2,"Ecc10",2780,2840,2900,2900,2810,2900,0.032,-90,2855,"Ecc",-60,0,FALSE,FALSE,FALSE,3.1,"old",70,173,84,"m"
4,"LEG CURL",1,"Rep01",3260,3280,3000,3250,3270,3125,0.044,145,3197.5,"Rep",-20,-250,FALSE,FALSE,TRUE,4.64,"old",70,173,84,"m"
4,"LEG CURL",1,"Rep02",2420,2400,2600,2500,2410,2550,0.058,-140,2480,"Rep",20,100,FALSE,FALSE,FALSE,5.49,"old",70,173,84,"m"
4,"LEG CURL",1,"Rep03",3160,3180,3200,3200,3170,3200,0.009,-30,3185,"Rep",-20,0,FALSE,FALSE,FALSE,0.94,"old",70,173,84,"m"
4,"LEG CURL",1,"Rep04",3500,3460,3350,3500,3480,3425,0.016,55,3452.5,"Rep",40,-150,FALSE,FALSE,FALSE,1.61,"old",70,173,84,"m"
4,"LEG CURL",1,"Rep05",3620,3600,3550,3550,3610,3550,0.017,60,3580,"Rep",20,0,FALSE,FALSE,FALSE,1.69,"old",70,173,84,"m"
4,"LEG CURL",1,"Rep06",3160,3200,3150,3200,3180,3175,0.002,5,3177.5,"Rep",-40,-50,FALSE,FALSE,FALSE,0.16,"old",70,173,84,"m"
4,"LEG CURL",1,"Rep07",3280,3260,3300,3250,3270,3275,0.002,-5,3272.5,"Rep",20,50,FALSE,FALSE,FALSE,0.15,"old",70,173,84,"m"
4,"LEG CURL",1,"Rep08",2700,2720,2700,2650,2710,2675,0.013,35,2692.5,"Rep",-20,50,FALSE,FALSE,FALSE,1.31,"old",70,173,84,"m"
4,"LEG CURL",1,"Rep09",3020,3020,3000,3000,3020,3000,0.007,20,3010,"Rep",0,0,FALSE,FALSE,FALSE,0.67,"old",70,173,84,"m"
4,"LEG CURL",1,"Rep10",3640,3620,3750,3750,3630,3750,0.033,-120,3690,"Rep",20,0,FALSE,FALSE,FALSE,3.2,"old",70,173,84,"m"
4,"LEG CURL",2,"Rep01",3220,3240,3400,3400,3230,3400,0.053,-170,3315,"Rep",-20,0,TRUE,FALSE,FALSE,5,"old",70,173,84,"m"
4,"LEG CURL",2,"Rep02",2980,3000,2950,2950,2990,2950,0.013,40,2970,"Rep",-20,0,FALSE,FALSE,FALSE,1.36,"old",70,173,84,"m"
4,"LEG CURL",2,"Rep03",2900,2880,2850,2850,2890,2850,0.014,40,2870,"Rep",20,0,FALSE,FALSE,FALSE,1.4,"old",70,173,84,"m"
4,"LEG CURL",2,"Rep04",2840,2820,2850,2850,2830,2850,0.007,-20,2840,"Rep",20,0,FALSE,FALSE,FALSE,0.7,"old",70,173,84,"m"
4,"LEG CURL",2,"Rep05",3180,3180,3050,3000,3180,3025,0.049,155,3102.5,"Rep",0,50,FALSE,FALSE,FALSE,5.12,"old",70,173,84,"m"
4,"LEG CURL",2,"Rep06",2720,2740,2850,2900,2730,2875,0.053,-145,2802.5,"Rep",-20,-50,FALSE,FALSE,FALSE,5.04,"old",70,173,84,"m"
4,"LEG CURL",2,"Rep07",2820,2840,2750,2750,2830,2750,0.028,80,2790,"Rep",-20,0,FALSE,FALSE,FALSE,2.91,"old",70,173,84,"m"
4,"LEG CURL",2,"Rep08",2420,2380,2450,2450,2400,2450,0.021,-50,2425,"Rep",40,0,FALSE,FALSE,FALSE,2.04,"old",70,173,84,"m"
4,"LEG CURL",2,"Rep09",2940,2940,2900,2900,2940,2900,0.014,40,2920,"Rep",0,0,FALSE,FALSE,FALSE,1.38,"old",70,173,84,"m"
4,"LEG CURL",2,"Rep10",4040,4140,4250,4250,4090,4250,0.039,-160,4170,"Rep",-100,0,TRUE,TRUE,FALSE,3.76,"old",70,173,84,"m"
4,"LEG CURL",1,"TuT",31760,31740,31600,31850,31750,31725,0.001,25,31737.5,"TuT",20,-250,FALSE,FALSE,TRUE,0.08,"old",70,173,84,"m"
4,"LEG CURL",2,"TuT",30060,30160,30300,30300,30110,30300,0.006,-190,30205,"TuT",-100,0,FALSE,TRUE,FALSE,0.63,"old",70,173,84,"m"
4,"ABDUCTOR",1,"Con01",1140,1120,1300,1300,1130,1300,0.15,-170,1215,"Con",20,0,FALSE,FALSE,FALSE,13.08,"old",70,173,84,"m"
4,"ABDUCTOR",1,"Con02",980,1000,1050,1050,990,1050,0.061,-60,1020,"Con",-20,0,FALSE,FALSE,FALSE,5.71,"old",70,173,84,"m"
4,"ABDUCTOR",1,"Con03",840,840,950,950,840,950,0.131,-110,895,"Con",0,0,FALSE,FALSE,FALSE,11.58,"old",70,173,84,"m"
4,"ABDUCTOR",1,"Con04",820,820,900,850,820,875,0.067,-55,847.5,"Con",0,50,FALSE,FALSE,FALSE,6.29,"old",70,173,84,"m"
4,"ABDUCTOR",1,"Con05",1000,1040,1050,950,1020,1000,0.02,20,1010,"Con",-40,100,FALSE,TRUE,FALSE,2,"old",70,173,84,"m"
4,"ABDUCTOR",1,"Con06",760,780,900,900,770,900,0.169,-130,835,"Con",-20,0,FALSE,FALSE,FALSE,14.44,"old",70,173,84,"m"
4,"ABDUCTOR",1,"Con07",800,820,1000,1100,810,1050,0.296,-240,930,"Con",-20,-100,FALSE,FALSE,FALSE,22.86,"old",70,173,84,"m"
4,"ABDUCTOR",1,"Con08",760,800,1000,1250,780,1125,0.442,-345,952.5,"Con",-40,-250,TRUE,TRUE,TRUE,30.67,"old",70,173,84,"m"
4,"ABDUCTOR",1,"Con09",880,900,1150,1150,890,1150,0.292,-260,1020,"Con",-20,0,FALSE,FALSE,FALSE,22.61,"old",70,173,84,"m"
4,"ABDUCTOR",1,"Con10",800,820,1050,1000,810,1025,0.265,-215,917.5,"Con",-20,50,FALSE,FALSE,FALSE,20.98,"old",70,173,84,"m"
4,"ABDUCTOR",2,"Con01",980,1020,1100,1400,1000,1250,0.25,-250,1125,"Con",-40,-300,FALSE,TRUE,TRUE,20,"old",70,173,84,"m"
4,"ABDUCTOR",2,"Con02",1020,1080,1250,1000,1050,1125,0.071,-75,1087.5,"Con",-60,250,FALSE,TRUE,TRUE,6.67,"old",70,173,84,"m"
4,"ABDUCTOR",2,"Con03",920,940,1100,1050,930,1075,0.156,-145,1002.5,"Con",-20,50,FALSE,FALSE,FALSE,13.49,"old",70,173,84,"m"
4,"ABDUCTOR",2,"Con04",900,920,1000,950,910,975,0.071,-65,942.5,"Con",-20,50,FALSE,FALSE,FALSE,6.67,"old",70,173,84,"m"
4,"ABDUCTOR",2,"Con05",860,860,1000,1000,860,1000,0.163,-140,930,"Con",0,0,FALSE,FALSE,FALSE,14,"old",70,173,84,"m"
4,"ABDUCTOR",2,"Con06",840,900,1100,1150,870,1125,0.293,-255,997.5,"Con",-60,-50,FALSE,TRUE,FALSE,22.67,"old",70,173,84,"m"
4,"ABDUCTOR",2,"Con07",880,920,1100,1250,900,1175,0.306,-275,1037.5,"Con",-40,-150,FALSE,TRUE,FALSE,23.4,"old",70,173,84,"m"
4,"ABDUCTOR",2,"Con08",740,760,900,1100,750,1000,0.333,-250,875,"Con",-20,-200,FALSE,FALSE,FALSE,25,"old",70,173,84,"m"
4,"ABDUCTOR",2,"Con09",800,820,950,950,810,950,0.173,-140,880,"Con",-20,0,FALSE,FALSE,FALSE,14.74,"old",70,173,84,"m"
4,"ABDUCTOR",2,"Con10",840,860,950,900,850,925,0.088,-75,887.5,"Con",-20,50,FALSE,FALSE,FALSE,8.11,"old",70,173,84,"m"
4,"ABDUCTOR",1,"Ecc01",1280,1280,1250,1200,1280,1225,0.043,55,1252.5,"Ecc",0,50,FALSE,FALSE,FALSE,4.49,"old",70,173,84,"m"
4,"ABDUCTOR",1,"Ecc02",1560,1560,1400,1400,1560,1400,0.103,160,1480,"Ecc",0,0,FALSE,FALSE,FALSE,11.43,"old",70,173,84,"m"
4,"ABDUCTOR",1,"Ecc03",1520,1520,1450,1500,1520,1475,0.03,45,1497.5,"Ecc",0,-50,FALSE,FALSE,FALSE,3.05,"old",70,173,84,"m"
4,"ABDUCTOR",1,"Ecc04",1420,1400,1350,1450,1410,1400,0.007,10,1405,"Ecc",20,-100,FALSE,FALSE,FALSE,0.71,"old",70,173,84,"m"
4,"ABDUCTOR",1,"Ecc05",1540,1500,1450,1450,1520,1450,0.046,70,1485,"Ecc",40,0,FALSE,TRUE,FALSE,4.83,"old",70,173,84,"m"
4,"ABDUCTOR",1,"Ecc06",1580,1560,1400,1350,1570,1375,0.124,195,1472.5,"Ecc",20,50,FALSE,FALSE,FALSE,14.18,"old",70,173,84,"m"
4,"ABDUCTOR",1,"Ecc07",1600,1580,1350,1100,1590,1225,0.23,365,1407.5,"Ecc",20,250,TRUE,FALSE,FALSE,29.8,"old",70,173,84,"m"
4,"ABDUCTOR",1,"Ecc08",1480,1420,1200,1150,1450,1175,0.19,275,1312.5,"Ecc",60,50,FALSE,TRUE,FALSE,23.4,"old",70,173,84,"m"
4,"ABDUCTOR",1,"Ecc09",1420,1420,1200,1250,1420,1225,0.137,195,1322.5,"Ecc",0,-50,FALSE,FALSE,FALSE,15.92,"old",70,173,84,"m"
4,"ABDUCTOR",1,"Ecc10",1980,1980,1950,2100,1980,2025,0.023,-45,2002.5,"Ecc",0,-150,FALSE,FALSE,FALSE,2.22,"old",70,173,84,"m"
4,"ABDUCTOR",2,"Ecc01",1360,1300,1150,1350,1330,1250,0.06,80,1290,"Ecc",60,-200,FALSE,TRUE,FALSE,6.4,"old",70,173,84,"m"
4,"ABDUCTOR",2,"Ecc02",1600,1580,1400,1500,1590,1450,0.088,140,1520,"Ecc",20,-100,FALSE,FALSE,FALSE,9.66,"old",70,173,84,"m"
4,"ABDUCTOR",2,"Ecc03",1560,1520,1450,1500,1540,1475,0.042,65,1507.5,"Ecc",40,-50,FALSE,TRUE,FALSE,4.41,"old",70,173,84,"m"
4,"ABDUCTOR",2,"Ecc04",1560,1560,1400,1450,1560,1425,0.087,135,1492.5,"Ecc",0,-50,FALSE,FALSE,FALSE,9.47,"old",70,173,84,"m"
4,"ABDUCTOR",2,"Ecc05",1400,1380,1200,1150,1390,1175,0.155,215,1282.5,"Ecc",20,50,FALSE,FALSE,FALSE,18.3,"old",70,173,84,"m"
4,"ABDUCTOR",2,"Ecc06",1520,1480,1250,1100,1500,1175,0.217,325,1337.5,"Ecc",40,150,TRUE,TRUE,FALSE,27.66,"old",70,173,84,"m"
4,"ABDUCTOR",2,"Ecc07",1560,1520,1450,1250,1540,1350,0.123,190,1445,"Ecc",40,200,FALSE,TRUE,FALSE,14.07,"old",70,173,84,"m"
4,"ABDUCTOR",2,"Ecc08",1620,1580,1400,1350,1600,1375,0.141,225,1487.5,"Ecc",40,50,FALSE,TRUE,FALSE,16.36,"old",70,173,84,"m"
4,"ABDUCTOR",2,"Ecc09",1440,1440,1350,1400,1440,1375,0.045,65,1407.5,"Ecc",0,-50,FALSE,FALSE,FALSE,4.73,"old",70,173,84,"m"
4,"ABDUCTOR",2,"Ecc10",1940,1940,1900,2050,1940,1975,0.018,-35,1957.5,"Ecc",0,-150,FALSE,FALSE,FALSE,1.77,"old",70,173,84,"m"
4,"ABDUCTOR",1,"Rep01",2420,2400,2550,2500,2410,2525,0.048,-115,2467.5,"Rep",20,50,FALSE,FALSE,FALSE,4.55,"old",70,173,84,"m"
4,"ABDUCTOR",1,"Rep02",2540,2560,2450,2450,2550,2450,0.039,100,2500,"Rep",-20,0,FALSE,FALSE,FALSE,4.08,"old",70,173,84,"m"
4,"ABDUCTOR",1,"Rep03",2360,2360,2400,2450,2360,2425,0.028,-65,2392.5,"Rep",0,-50,FALSE,FALSE,FALSE,2.68,"old",70,173,84,"m"
4,"ABDUCTOR",1,"Rep04",2240,2220,2250,2300,2230,2275,0.02,-45,2252.5,"Rep",20,-50,FALSE,FALSE,FALSE,1.98,"old",70,173,84,"m"
4,"ABDUCTOR",1,"Rep05",2540,2540,2500,2400,2540,2450,0.035,90,2495,"Rep",0,100,FALSE,FALSE,FALSE,3.67,"old",70,173,84,"m"
4,"ABDUCTOR",1,"Rep06",2340,2340,2300,2250,2340,2275,0.028,65,2307.5,"Rep",0,50,FALSE,FALSE,FALSE,2.86,"old",70,173,84,"m"
4,"ABDUCTOR",1,"Rep07",2400,2400,2350,2200,2400,2275,0.052,125,2337.5,"Rep",0,150,FALSE,FALSE,FALSE,5.49,"old",70,173,84,"m"
4,"ABDUCTOR",1,"Rep08",2240,2220,2200,2400,2230,2300,0.031,-70,2265,"Rep",20,-200,FALSE,FALSE,FALSE,3.04,"old",70,173,84,"m"
4,"ABDUCTOR",1,"Rep09",2300,2320,2350,2400,2310,2375,0.028,-65,2342.5,"Rep",-20,-50,FALSE,FALSE,FALSE,2.74,"old",70,173,84,"m"
4,"ABDUCTOR",1,"Rep10",2780,2800,3000,3100,2790,3050,0.093,-260,2920,"Rep",-20,-100,FALSE,FALSE,FALSE,8.52,"old",70,173,84,"m"
4,"ABDUCTOR",2,"Rep01",2340,2320,2250,2750,2330,2500,0.073,-170,2415,"Rep",20,-500,FALSE,FALSE,TRUE,6.8,"old",70,173,84,"m"
4,"ABDUCTOR",2,"Rep02",2620,2660,2650,2500,2640,2575,0.025,65,2607.5,"Rep",-40,150,FALSE,FALSE,FALSE,2.52,"old",70,173,84,"m"
4,"ABDUCTOR",2,"Rep03",2480,2460,2550,2550,2470,2550,0.032,-80,2510,"Rep",20,0,FALSE,FALSE,FALSE,3.14,"old",70,173,84,"m"
4,"ABDUCTOR",2,"Rep04",2460,2480,2400,2400,2470,2400,0.028,70,2435,"Rep",-20,0,FALSE,FALSE,FALSE,2.92,"old",70,173,84,"m"
4,"ABDUCTOR",2,"Rep05",2260,2240,2200,2150,2250,2175,0.033,75,2212.5,"Rep",20,50,FALSE,FALSE,FALSE,3.45,"old",70,173,84,"m"
4,"ABDUCTOR",2,"Rep06",2360,2380,2350,2250,2370,2300,0.03,70,2335,"Rep",-20,100,FALSE,FALSE,FALSE,3.04,"old",70,173,84,"m"
4,"ABDUCTOR",2,"Rep07",2440,2440,2550,2500,2440,2525,0.035,-85,2482.5,"Rep",0,50,FALSE,FALSE,FALSE,3.37,"old",70,173,84,"m"
4,"ABDUCTOR",2,"Rep08",2360,2340,2300,2450,2350,2375,0.011,-25,2362.5,"Rep",20,-150,FALSE,FALSE,FALSE,1.05,"old",70,173,84,"m"
4,"ABDUCTOR",2,"Rep09",2240,2260,2300,2350,2250,2325,0.033,-75,2287.5,"Rep",-20,-50,FALSE,FALSE,FALSE,3.23,"old",70,173,84,"m"
4,"ABDUCTOR",2,"Rep10",2780,2800,2850,2950,2790,2900,0.039,-110,2845,"Rep",-20,-100,FALSE,FALSE,FALSE,3.79,"old",70,173,84,"m"
4,"ABDUCTOR",1,"TuT",24160,24160,24350,24450,24160,24400,0.01,-240,24280,"TuT",0,-100,FALSE,FALSE,FALSE,0.98,"old",70,173,84,"m"
4,"ABDUCTOR",2,"TuT",24340,24380,24400,24850,24360,24625,0.011,-265,24492.5,"TuT",-40,-450,FALSE,TRUE,FALSE,1.08,"old",70,173,84,"m"
4,"ADDUCTOR",1,"Con01",720,720,1050,1300,720,1175,0.632,-455,947.5,"Con",0,-250,FALSE,FALSE,FALSE,38.72,"old",70,173,84,"m"
4,"ADDUCTOR",1,"Con02",980,1020,750,750,1000,750,0.25,250,875,"Con",-40,0,FALSE,TRUE,FALSE,33.33,"old",70,173,84,"m"
4,"ADDUCTOR",1,"Con03",880,860,850,850,870,850,0.023,20,860,"Con",20,0,FALSE,FALSE,FALSE,2.35,"old",70,173,84,"m"
4,"ADDUCTOR",1,"Con04",1100,1120,900,1050,1110,975,0.122,135,1042.5,"Con",-20,-150,FALSE,FALSE,FALSE,13.85,"old",70,173,84,"m"
4,"ADDUCTOR",1,"Con05",880,920,1100,1300,900,1200,0.333,-300,1050,"Con",-40,-200,FALSE,TRUE,FALSE,25,"old",70,173,84,"m"
4,"ADDUCTOR",1,"Con06",820,800,1050,1000,810,1025,0.265,-215,917.5,"Con",20,50,FALSE,FALSE,FALSE,20.98,"old",70,173,84,"m"
4,"ADDUCTOR",1,"Con07",900,920,1100,1050,910,1075,0.181,-165,992.5,"Con",-20,50,FALSE,FALSE,FALSE,15.35,"old",70,173,84,"m"
4,"ADDUCTOR",1,"Con08",1040,1060,1050,850,1050,950,0.095,100,1000,"Con",-20,200,FALSE,FALSE,FALSE,10.53,"old",70,173,84,"m"
4,"ADDUCTOR",1,"Con09",760,800,1100,850,780,975,0.25,-195,877.5,"Con",-40,250,FALSE,TRUE,FALSE,20,"old",70,173,84,"m"
4,"ADDUCTOR",1,"Con10",860,880,1950,1700,870,1825,1.098,-955,1347.5,"Con",-20,250,TRUE,FALSE,FALSE,52.33,"old",70,173,84,"m"
4,"ADDUCTOR",2,"Con01",880,900,1000,0,890,500,0.438,390,695,"Con",-20,1000,FALSE,FALSE,TRUE,78,"old",70,173,84,"m"
4,"ADDUCTOR",2,"Con02",900,900,700,5800,900,3250,2.611,-2350,2075,"Con",0,-5100,TRUE,FALSE,TRUE,72.31,"old",70,173,84,"m"
4,"ADDUCTOR",2,"Con03",940,900,900,1000,920,950,0.033,-30,935,"Con",40,-100,FALSE,TRUE,FALSE,3.16,"old",70,173,84,"m"
4,"ADDUCTOR",2,"Con04",960,1020,800,1100,990,950,0.04,40,970,"Con",-60,-300,FALSE,TRUE,FALSE,4.21,"old",70,173,84,"m"
4,"ADDUCTOR",2,"Con05",900,900,700,850,900,775,0.139,125,837.5,"Con",0,-150,FALSE,FALSE,FALSE,16.13,"old",70,173,84,"m"
4,"ADDUCTOR",2,"Con06",880,900,700,1250,890,975,0.096,-85,932.5,"Con",-20,-550,FALSE,FALSE,TRUE,8.72,"old",70,173,84,"m"
4,"ADDUCTOR",2,"Con07",860,880,1300,800,870,1050,0.207,-180,960,"Con",-20,500,FALSE,FALSE,TRUE,17.14,"old",70,173,84,"m"
4,"ADDUCTOR",2,"Con08",860,880,1450,700,870,1075,0.236,-205,972.5,"Con",-20,750,FALSE,FALSE,TRUE,19.07,"old",70,173,84,"m"
4,"ADDUCTOR",2,"Con09",840,840,1200,900,840,1050,0.25,-210,945,"Con",0,300,FALSE,FALSE,FALSE,20,"old",70,173,84,"m"
4,"ADDUCTOR",2,"Con10",920,940,1250,1250,930,1250,0.344,-320,1090,"Con",-20,0,FALSE,FALSE,FALSE,25.6,"old",70,173,84,"m"
4,"ADDUCTOR",1,"Ecc01",1200,1160,1150,1100,1180,1125,0.047,55,1152.5,"Ecc",40,50,FALSE,TRUE,FALSE,4.89,"old",70,173,84,"m"
4,"ADDUCTOR",1,"Ecc02",1060,1080,1300,1300,1070,1300,0.215,-230,1185,"Ecc",-20,0,FALSE,FALSE,FALSE,17.69,"old",70,173,84,"m"
4,"ADDUCTOR",1,"Ecc03",880,860,1050,1000,870,1025,0.178,-155,947.5,"Ecc",20,50,FALSE,FALSE,FALSE,15.12,"old",70,173,84,"m"
4,"ADDUCTOR",1,"Ecc04",1240,1200,1100,900,1220,1000,0.18,220,1110,"Ecc",40,200,FALSE,TRUE,FALSE,22,"old",70,173,84,"m"
4,"ADDUCTOR",1,"Ecc05",1100,1120,1000,900,1110,950,0.144,160,1030,"Ecc",-20,100,FALSE,FALSE,FALSE,16.84,"old",70,173,84,"m"
4,"ADDUCTOR",1,"Ecc06",1240,1220,850,950,1230,900,0.268,330,1065,"Ecc",20,-100,FALSE,FALSE,FALSE,36.67,"old",70,173,84,"m"
4,"ADDUCTOR",1,"Ecc07",1120,1100,1050,1150,1110,1100,0.009,10,1105,"Ecc",20,-100,FALSE,FALSE,FALSE,0.91,"old",70,173,84,"m"
4,"ADDUCTOR",1,"Ecc08",1100,1100,950,1200,1100,1075,0.023,25,1087.5,"Ecc",0,-250,FALSE,FALSE,FALSE,2.33,"old",70,173,84,"m"
4,"ADDUCTOR",1,"Ecc09",1320,1280,1200,1450,1300,1325,0.019,-25,1312.5,"Ecc",40,-250,FALSE,TRUE,FALSE,1.89,"old",70,173,84,"m"
4,"ADDUCTOR",1,"Ecc10",1980,2000,950,1050,1990,1000,0.497,990,1495,"Ecc",-20,-100,TRUE,FALSE,FALSE,99,"old",70,173,84,"m"
4,"ADDUCTOR",2,"Ecc01",940,940,800,0,940,400,0.574,540,670,"Ecc",0,800,FALSE,FALSE,TRUE,135,"old",70,173,84,"m"
4,"ADDUCTOR",2,"Ecc02",1140,1180,1250,1050,1160,1150,0.009,10,1155,"Ecc",-40,200,FALSE,TRUE,FALSE,0.87,"old",70,173,84,"m"
4,"ADDUCTOR",2,"Ecc03",1020,980,1150,950,1000,1050,0.05,-50,1025,"Ecc",40,200,FALSE,TRUE,FALSE,4.76,"old",70,173,84,"m"
4,"ADDUCTOR",2,"Ecc04",1200,1180,1400,1150,1190,1275,0.071,-85,1232.5,"Ecc",20,250,FALSE,FALSE,FALSE,6.67,"old",70,173,84,"m"
4,"ADDUCTOR",2,"Ecc05",1100,1100,1450,1100,1100,1275,0.159,-175,1187.5,"Ecc",0,350,FALSE,FALSE,TRUE,13.73,"old",70,173,84,"m"
4,"ADDUCTOR",2,"Ecc06",1280,1260,950,850,1270,900,0.291,370,1085,"Ecc",20,100,FALSE,FALSE,FALSE,41.11,"old",70,173,84,"m"
4,"ADDUCTOR",2,"Ecc07",1020,980,500,1300,1000,900,0.1,100,950,"Ecc",40,-800,FALSE,TRUE,TRUE,11.11,"old",70,173,84,"m"
4,"ADDUCTOR",2,"Ecc08",1200,1200,800,1250,1200,1025,0.146,175,1112.5,"Ecc",0,-450,FALSE,FALSE,TRUE,17.07,"old",70,173,84,"m"
4,"ADDUCTOR",2,"Ecc09",1160,1100,800,950,1130,875,0.226,255,1002.5,"Ecc",60,-150,FALSE,TRUE,FALSE,29.14,"old",70,173,84,"m"
4,"ADDUCTOR",2,"Ecc10",1260,1280,1100,1100,1270,1100,0.134,170,1185,"Ecc",-20,0,FALSE,FALSE,FALSE,15.45,"old",70,173,84,"m"
4,"ADDUCTOR",1,"Rep01",1920,1880,2200,2400,1900,2300,0.211,-400,2100,"Rep",40,-200,TRUE,FALSE,FALSE,17.39,"old",70,173,84,"m"
4,"ADDUCTOR",1,"Rep02",2040,2100,2050,2050,2070,2050,0.01,20,2060,"Rep",-60,0,FALSE,FALSE,FALSE,0.98,"old",70,173,84,"m"
4,"ADDUCTOR",1,"Rep03",1760,1720,1900,1850,1740,1875,0.078,-135,1807.5,"Rep",40,50,FALSE,FALSE,FALSE,7.2,"old",70,173,84,"m"
4,"ADDUCTOR",1,"Rep04",2340,2320,2000,1950,2330,1975,0.152,355,2152.5,"Rep",20,50,FALSE,FALSE,FALSE,17.97,"old",70,173,84,"m"
4,"ADDUCTOR",1,"Rep05",1980,2040,2100,2200,2010,2150,0.07,-140,2080,"Rep",-60,-100,FALSE,FALSE,FALSE,6.51,"old",70,173,84,"m"
4,"ADDUCTOR",1,"Rep06",2060,2020,1900,1950,2040,1925,0.056,115,1982.5,"Rep",40,-50,FALSE,FALSE,FALSE,5.97,"old",70,173,84,"m"
4,"ADDUCTOR",1,"Rep07",2020,2020,2150,2200,2020,2175,0.077,-155,2097.5,"Rep",0,-50,FALSE,FALSE,FALSE,7.13,"old",70,173,84,"m"
4,"ADDUCTOR",1,"Rep08",2140,2160,2000,2050,2150,2025,0.058,125,2087.5,"Rep",-20,-50,FALSE,FALSE,FALSE,6.17,"old",70,173,84,"m"
4,"ADDUCTOR",1,"Rep09",2080,2080,2300,2300,2080,2300,0.106,-220,2190,"Rep",0,0,FALSE,FALSE,FALSE,9.57,"old",70,173,84,"m"
4,"ADDUCTOR",1,"Rep10",2840,2880,2900,2750,2860,2825,0.012,35,2842.5,"Rep",-40,150,FALSE,FALSE,FALSE,1.24,"old",70,173,84,"m"
4,"ADDUCTOR",2,"Rep01",1820,1840,1800,0,1830,900,0.508,930,1365,"Rep",-20,1800,TRUE,FALSE,TRUE,103.33,"old",70,173,84,"m"
4,"ADDUCTOR",2,"Rep02",2040,2080,1950,6850,2060,4400,1.136,-2340,3230,"Rep",-40,-4900,TRUE,FALSE,TRUE,53.18,"old",70,173,84,"m"
4,"ADDUCTOR",2,"Rep03",1960,1880,2050,1950,1920,2000,0.042,-80,1960,"Rep",80,100,FALSE,TRUE,FALSE,4,"old",70,173,84,"m"
4,"ADDUCTOR",2,"Rep04",2160,2200,2200,2250,2180,2225,0.021,-45,2202.5,"Rep",-40,-50,FALSE,FALSE,FALSE,2.02,"old",70,173,84,"m"
4,"ADDUCTOR",2,"Rep05",2000,2000,2150,1950,2000,2050,0.025,-50,2025,"Rep",0,200,FALSE,FALSE,FALSE,2.44,"old",70,173,84,"m"
4,"ADDUCTOR",2,"Rep06",2160,2160,1650,2100,2160,1875,0.132,285,2017.5,"Rep",0,-450,FALSE,FALSE,TRUE,15.2,"old",70,173,84,"m"
4,"ADDUCTOR",2,"Rep07",1880,1860,1800,2100,1870,1950,0.043,-80,1910,"Rep",20,-300,FALSE,FALSE,TRUE,4.1,"old",70,173,84,"m"
4,"ADDUCTOR",2,"Rep08",2060,2080,2250,1950,2070,2100,0.014,-30,2085,"Rep",-20,300,FALSE,FALSE,TRUE,1.43,"old",70,173,84,"m"
4,"ADDUCTOR",2,"Rep09",2000,1940,2000,1850,1970,1925,0.023,45,1947.5,"Rep",60,150,FALSE,FALSE,FALSE,2.34,"old",70,173,84,"m"
4,"ADDUCTOR",2,"Rep10",2180,2220,2350,2350,2200,2350,0.068,-150,2275,"Rep",-40,0,FALSE,FALSE,FALSE,6.38,"old",70,173,84,"m"
4,"ADDUCTOR",1,"TuT",21180,21220,21500,21700,21200,21600,0.019,-400,21400,"TuT",-40,-200,FALSE,TRUE,FALSE,1.85,"old",70,173,84,"m"
4,"ADDUCTOR",2,"TuT",20260,20260,20200,23350,20260,21775,0.075,-1515,21017.5,"TuT",0,-3150,TRUE,FALSE,TRUE,6.96,"old",70,173,84,"m"
4,"LOWER BACK",1,"Con01",1480,1520,1450,1450,1500,1450,0.033,50,1475,"Con",-40,0,FALSE,TRUE,FALSE,3.45,"old",70,173,84,"m"
4,"LOWER BACK",1,"Con02",1080,1120,1100,1100,1100,1100,0,0,1100,"Con",-40,0,FALSE,TRUE,FALSE,0,"old",70,173,84,"m"
4,"LOWER BACK",1,"Con03",1140,1160,1300,1250,1150,1275,0.109,-125,1212.5,"Con",-20,50,FALSE,FALSE,FALSE,9.8,"old",70,173,84,"m"
4,"LOWER BACK",1,"Con04",980,1000,1150,1100,990,1125,0.136,-135,1057.5,"Con",-20,50,FALSE,FALSE,FALSE,12,"old",70,173,84,"m"
4,"LOWER BACK",1,"Con05",1060,1100,1200,1200,1080,1200,0.111,-120,1140,"Con",-40,0,FALSE,TRUE,FALSE,10,"old",70,173,84,"m"
4,"LOWER BACK",1,"Con06",1180,1200,1300,1250,1190,1275,0.071,-85,1232.5,"Con",-20,50,FALSE,FALSE,FALSE,6.67,"old",70,173,84,"m"
4,"LOWER BACK",1,"Con07",1160,1200,1300,1300,1180,1300,0.102,-120,1240,"Con",-40,0,FALSE,TRUE,FALSE,9.23,"old",70,173,84,"m"
4,"LOWER BACK",1,"Con08",1120,1140,1200,1300,1130,1250,0.106,-120,1190,"Con",-20,-100,FALSE,FALSE,FALSE,9.6,"old",70,173,84,"m"
4,"LOWER BACK",1,"Con09",1060,1080,1200,1250,1070,1225,0.145,-155,1147.5,"Con",-20,-50,FALSE,FALSE,FALSE,12.65,"old",70,173,84,"m"
4,"LOWER BACK",1,"Con10",1080,1080,1200,1200,1080,1200,0.111,-120,1140,"Con",0,0,FALSE,FALSE,FALSE,10,"old",70,173,84,"m"
4,"LOWER BACK",2,"Con01",1280,1260,1450,1350,1270,1400,0.102,-130,1335,"Con",20,100,FALSE,FALSE,FALSE,9.29,"old",70,173,84,"m"
4,"LOWER BACK",2,"Con02",1080,1080,1100,1100,1080,1100,0.019,-20,1090,"Con",0,0,FALSE,FALSE,FALSE,1.82,"old",70,173,84,"m"
4,"LOWER BACK",2,"Con03",1100,1120,1100,1050,1110,1075,0.032,35,1092.5,"Con",-20,50,FALSE,FALSE,FALSE,3.26,"old",70,173,84,"m"
4,"LOWER BACK",2,"Con04",1120,1160,1150,1200,1140,1175,0.031,-35,1157.5,"Con",-40,-50,FALSE,TRUE,FALSE,2.98,"old",70,173,84,"m"
4,"LOWER BACK",2,"Con05",1180,1200,1250,1250,1190,1250,0.05,-60,1220,"Con",-20,0,FALSE,FALSE,FALSE,4.8,"old",70,173,84,"m"
4,"LOWER BACK",2,"Con06",1080,1120,1250,1250,1100,1250,0.136,-150,1175,"Con",-40,0,FALSE,TRUE,FALSE,12,"old",70,173,84,"m"
4,"LOWER BACK",2,"Con07",1100,1120,1200,1200,1110,1200,0.081,-90,1155,"Con",-20,0,FALSE,FALSE,FALSE,7.5,"old",70,173,84,"m"
4,"LOWER BACK",2,"Con08",1080,1060,1250,1250,1070,1250,0.168,-180,1160,"Con",20,0,FALSE,FALSE,FALSE,14.4,"old",70,173,84,"m"
4,"LOWER BACK",2,"Con09",1100,1120,1250,1300,1110,1275,0.149,-165,1192.5,"Con",-20,-50,FALSE,FALSE,FALSE,12.94,"old",70,173,84,"m"
4,"LOWER BACK",2,"Con10",980,1000,1200,1250,990,1225,0.237,-235,1107.5,"Con",-20,-50,TRUE,FALSE,FALSE,19.18,"old",70,173,84,"m"
4,"LOWER BACK",1,"Ecc01",1560,1540,1600,1550,1550,1575,0.016,-25,1562.5,"Ecc",20,50,FALSE,FALSE,FALSE,1.59,"old",70,173,84,"m"
4,"LOWER BACK",1,"Ecc02",1440,1400,1300,1400,1420,1350,0.049,70,1385,"Ecc",40,-100,FALSE,FALSE,FALSE,5.19,"old",70,173,84,"m"
4,"LOWER BACK",1,"Ecc03",1460,1460,1300,1350,1460,1325,0.092,135,1392.5,"Ecc",0,-50,FALSE,FALSE,FALSE,10.19,"old",70,173,84,"m"
4,"LOWER BACK",1,"Ecc04",1400,1340,1250,1250,1370,1250,0.088,120,1310,"Ecc",60,0,FALSE,FALSE,FALSE,9.6,"old",70,173,84,"m"
4,"LOWER BACK",1,"Ecc05",1560,1540,1450,1500,1550,1475,0.048,75,1512.5,"Ecc",20,-50,FALSE,FALSE,FALSE,5.08,"old",70,173,84,"m"
4,"LOWER BACK",1,"Ecc06",1460,1440,1350,1350,1450,1350,0.069,100,1400,"Ecc",20,0,FALSE,FALSE,FALSE,7.41,"old",70,173,84,"m"
4,"LOWER BACK",1,"Ecc07",1680,1640,1550,1500,1660,1525,0.081,135,1592.5,"Ecc",40,50,FALSE,FALSE,FALSE,8.85,"old",70,173,84,"m"
4,"LOWER BACK",1,"Ecc08",1640,1620,1500,1400,1630,1450,0.11,180,1540,"Ecc",20,100,TRUE,FALSE,FALSE,12.41,"old",70,173,84,"m"
4,"LOWER BACK",1,"Ecc09",1480,1480,1350,1350,1480,1350,0.088,130,1415,"Ecc",0,0,FALSE,FALSE,FALSE,9.63,"old",70,173,84,"m"
4,"LOWER BACK",1,"Ecc10",2300,2320,2250,2400,2310,2325,0.006,-15,2317.5,"Ecc",-20,-150,FALSE,FALSE,FALSE,0.65,"old",70,173,84,"m"
4,"LOWER BACK",2,"Ecc01",1360,1380,1400,1400,1370,1400,0.022,-30,1385,"Ecc",-20,0,FALSE,FALSE,FALSE,2.14,"old",70,173,84,"m"
4,"LOWER BACK",2,"Ecc02",1540,1540,1500,1550,1540,1525,0.01,15,1532.5,"Ecc",0,-50,FALSE,FALSE,FALSE,0.98,"old",70,173,84,"m"
4,"LOWER BACK",2,"Ecc03",1500,1460,1500,1500,1480,1500,0.014,-20,1490,"Ecc",40,0,FALSE,FALSE,FALSE,1.33,"old",70,173,84,"m"
4,"LOWER BACK",2,"Ecc04",1600,1580,1550,1500,1590,1525,0.041,65,1557.5,"Ecc",20,50,FALSE,FALSE,FALSE,4.26,"old",70,173,84,"m"
4,"LOWER BACK",2,"Ecc05",1600,1560,1450,1450,1580,1450,0.082,130,1515,"Ecc",40,0,FALSE,FALSE,FALSE,8.97,"old",70,173,84,"m"
4,"LOWER BACK",2,"Ecc06",1520,1480,1400,1400,1500,1400,0.067,100,1450,"Ecc",40,0,FALSE,FALSE,FALSE,7.14,"old",70,173,84,"m"
4,"LOWER BACK",2,"Ecc07",1540,1540,1400,1400,1540,1400,0.091,140,1470,"Ecc",0,0,FALSE,FALSE,FALSE,10,"old",70,173,84,"m"
4,"LOWER BACK",2,"Ecc08",1440,1440,1300,1300,1440,1300,0.097,140,1370,"Ecc",0,0,FALSE,FALSE,FALSE,10.77,"old",70,173,84,"m"
4,"LOWER BACK",2,"Ecc09",1560,1540,1350,1250,1550,1300,0.161,250,1425,"Ecc",20,100,TRUE,FALSE,FALSE,19.23,"old",70,173,84,"m"
4,"LOWER BACK",2,"Ecc10",2220,2240,2100,2200,2230,2150,0.036,80,2190,"Ecc",-20,-100,FALSE,FALSE,FALSE,3.72,"old",70,173,84,"m"
4,"LOWER BACK",1,"Rep01",3040,3060,3050,3000,3050,3025,0.008,25,3037.5,"Rep",-20,50,FALSE,FALSE,FALSE,0.83,"old",70,173,84,"m"
4,"LOWER BACK",1,"Rep02",2520,2520,2400,2500,2520,2450,0.028,70,2485,"Rep",0,-100,FALSE,FALSE,FALSE,2.86,"old",70,173,84,"m"
4,"LOWER BACK",1,"Rep03",2600,2620,2600,2600,2610,2600,0.004,10,2605,"Rep",-20,0,FALSE,FALSE,FALSE,0.38,"old",70,173,84,"m"
4,"LOWER BACK",1,"Rep04",2380,2340,2400,2350,2360,2375,0.006,-15,2367.5,"Rep",40,50,FALSE,FALSE,FALSE,0.63,"old",70,173,84,"m"
4,"LOWER BACK",1,"Rep05",2620,2640,2650,2700,2630,2675,0.017,-45,2652.5,"Rep",-20,-50,FALSE,FALSE,FALSE,1.68,"old",70,173,84,"m"
4,"LOWER BACK",1,"Rep06",2640,2640,2650,2600,2640,2625,0.006,15,2632.5,"Rep",0,50,FALSE,FALSE,FALSE,0.57,"old",70,173,84,"m"
4,"LOWER BACK",1,"Rep07",2840,2840,2850,2800,2840,2825,0.005,15,2832.5,"Rep",0,50,FALSE,FALSE,FALSE,0.53,"old",70,173,84,"m"
4,"LOWER BACK",1,"Rep08",2760,2760,2700,2700,2760,2700,0.022,60,2730,"Rep",0,0,FALSE,FALSE,FALSE,2.22,"old",70,173,84,"m"
4,"LOWER BACK",1,"Rep09",2540,2560,2550,2600,2550,2575,0.01,-25,2562.5,"Rep",-20,-50,FALSE,FALSE,FALSE,0.97,"old",70,173,84,"m"
4,"LOWER BACK",1,"Rep10",3380,3400,3450,3600,3390,3525,0.04,-135,3457.5,"Rep",-20,-150,TRUE,FALSE,FALSE,3.83,"old",70,173,84,"m"
4,"LOWER BACK",2,"Rep01",2640,2640,2850,2750,2640,2800,0.061,-160,2720,"Rep",0,100,TRUE,FALSE,FALSE,5.71,"old",70,173,84,"m"
4,"LOWER BACK",2,"Rep02",2620,2620,2600,2650,2620,2625,0.002,-5,2622.5,"Rep",0,-50,FALSE,FALSE,FALSE,0.19,"old",70,173,84,"m"
4,"LOWER BACK",2,"Rep03",2600,2580,2600,2550,2590,2575,0.006,15,2582.5,"Rep",20,50,FALSE,FALSE,FALSE,0.58,"old",70,173,84,"m"
4,"LOWER BACK",2,"Rep04",2720,2740,2700,2700,2730,2700,0.011,30,2715,"Rep",-20,0,FALSE,FALSE,FALSE,1.11,"old",70,173,84,"m"
4,"LOWER BACK",2,"Rep05",2780,2760,2700,2700,2770,2700,0.025,70,2735,"Rep",20,0,FALSE,FALSE,FALSE,2.59,"old",70,173,84,"m"
4,"LOWER BACK",2,"Rep06",2600,2600,2650,2650,2600,2650,0.019,-50,2625,"Rep",0,0,FALSE,FALSE,FALSE,1.89,"old",70,173,84,"m"
4,"LOWER BACK",2,"Rep07",2640,2660,2600,2600,2650,2600,0.019,50,2625,"Rep",-20,0,FALSE,FALSE,FALSE,1.92,"old",70,173,84,"m"
4,"LOWER BACK",2,"Rep08",2520,2500,2550,2550,2510,2550,0.016,-40,2530,"Rep",20,0,FALSE,FALSE,FALSE,1.57,"old",70,173,84,"m"
4,"LOWER BACK",2,"Rep09",2660,2660,2600,2550,2660,2575,0.032,85,2617.5,"Rep",0,50,FALSE,FALSE,FALSE,3.3,"old",70,173,84,"m"
4,"LOWER BACK",2,"Rep10",3200,3240,3300,3450,3220,3375,0.048,-155,3297.5,"Rep",-40,-150,TRUE,FALSE,FALSE,4.59,"old",70,173,84,"m"
4,"LOWER BACK",1,"TuT",27320,27380,27300,27450,27350,27375,0.001,-25,27362.5,"TuT",-60,-150,FALSE,FALSE,FALSE,0.09,"old",70,173,84,"m"
4,"LOWER BACK",2,"TuT",26980,27000,27150,27150,26990,27150,0.006,-160,27070,"TuT",-20,0,FALSE,FALSE,FALSE,0.59,"old",70,173,84,"m"
4,"TOTAL ABDOMINAL",1,"Con01",1280,1300,1300,1250,1290,1275,0.012,15,1282.5,"Con",-20,50,FALSE,FALSE,FALSE,1.18,"old",70,173,84,"m"
4,"TOTAL ABDOMINAL",1,"Con02",1080,1120,1100,1150,1100,1125,0.023,-25,1112.5,"Con",-40,-50,FALSE,TRUE,FALSE,2.22,"old",70,173,84,"m"
4,"TOTAL ABDOMINAL",1,"Con03",1080,1080,1150,1150,1080,1150,0.065,-70,1115,"Con",0,0,FALSE,FALSE,FALSE,6.09,"old",70,173,84,"m"
4,"TOTAL ABDOMINAL",1,"Con04",1080,1080,1150,1150,1080,1150,0.065,-70,1115,"Con",0,0,FALSE,FALSE,FALSE,6.09,"old",70,173,84,"m"
4,"TOTAL ABDOMINAL",1,"Con05",1120,1180,1200,1200,1150,1200,0.043,-50,1175,"Con",-60,0,FALSE,TRUE,FALSE,4.17,"old",70,173,84,"m"
4,"TOTAL ABDOMINAL",1,"Con06",1080,1100,1100,1050,1090,1075,0.014,15,1082.5,"Con",-20,50,FALSE,FALSE,FALSE,1.4,"old",70,173,84,"m"
4,"TOTAL ABDOMINAL",1,"Con07",1080,1120,1200,1100,1100,1150,0.045,-50,1125,"Con",-40,100,FALSE,TRUE,FALSE,4.35,"old",70,173,84,"m"
4,"TOTAL ABDOMINAL",1,"Con08",1200,1180,1350,1300,1190,1325,0.113,-135,1257.5,"Con",20,50,FALSE,FALSE,FALSE,10.19,"old",70,173,84,"m"
4,"TOTAL ABDOMINAL",1,"Con09",1120,1140,1250,1250,1130,1250,0.106,-120,1190,"Con",-20,0,FALSE,FALSE,FALSE,9.6,"old",70,173,84,"m"
4,"TOTAL ABDOMINAL",1,"Con10",1100,1140,1150,1200,1120,1175,0.049,-55,1147.5,"Con",-40,-50,FALSE,TRUE,FALSE,4.68,"old",70,173,84,"m"
4,"TOTAL ABDOMINAL",2,"Con01",1160,1180,1200,1350,1170,1275,0.09,-105,1222.5,"Con",-20,-150,FALSE,FALSE,FALSE,8.24,"old",70,173,84,"m"
4,"TOTAL ABDOMINAL",2,"Con02",960,960,1050,1000,960,1025,0.068,-65,992.5,"Con",0,50,FALSE,FALSE,FALSE,6.34,"old",70,173,84,"m"
4,"TOTAL ABDOMINAL",2,"Con03",1120,1100,1250,1150,1110,1200,0.081,-90,1155,"Con",20,100,FALSE,FALSE,FALSE,7.5,"old",70,173,84,"m"
4,"TOTAL ABDOMINAL",2,"Con04",1080,1120,1250,1200,1100,1225,0.114,-125,1162.5,"Con",-40,50,FALSE,TRUE,FALSE,10.2,"old",70,173,84,"m"
4,"TOTAL ABDOMINAL",2,"Con05",980,1000,1150,1150,990,1150,0.162,-160,1070,"Con",-20,0,TRUE,FALSE,FALSE,13.91,"old",70,173,84,"m"
4,"TOTAL ABDOMINAL",2,"Con06",1060,1080,1200,1200,1070,1200,0.121,-130,1135,"Con",-20,0,FALSE,FALSE,FALSE,10.83,"old",70,173,84,"m"
4,"TOTAL ABDOMINAL",2,"Con07",1100,1120,1100,1100,1110,1100,0.009,10,1105,"Con",-20,0,FALSE,FALSE,FALSE,0.91,"old",70,173,84,"m"
4,"TOTAL ABDOMINAL",2,"Con08",1080,1100,1000,1050,1090,1025,0.06,65,1057.5,"Con",-20,-50,FALSE,FALSE,FALSE,6.34,"old",70,173,84,"m"
4,"TOTAL ABDOMINAL",2,"Con09",1100,1100,1150,1200,1100,1175,0.068,-75,1137.5,"Con",0,-50,FALSE,FALSE,FALSE,6.38,"old",70,173,84,"m"
4,"TOTAL ABDOMINAL",2,"Con10",1020,1080,1200,1350,1050,1275,0.214,-225,1162.5,"Con",-60,-150,TRUE,TRUE,FALSE,17.65,"old",70,173,84,"m"
4,"TOTAL ABDOMINAL",1,"Ecc01",1240,1220,1200,1200,1230,1200,0.024,30,1215,"Ecc",20,0,FALSE,FALSE,FALSE,2.5,"old",70,173,84,"m"
4,"TOTAL ABDOMINAL",1,"Ecc02",1280,1240,1300,1250,1260,1275,0.012,-15,1267.5,"Ecc",40,50,FALSE,TRUE,FALSE,1.18,"old",70,173,84,"m"
4,"TOTAL ABDOMINAL",1,"Ecc03",1380,1400,1300,1300,1390,1300,0.065,90,1345,"Ecc",-20,0,FALSE,FALSE,FALSE,6.92,"old",70,173,84,"m"
4,"TOTAL ABDOMINAL",1,"Ecc04",1280,1260,1200,1200,1270,1200,0.055,70,1235,"Ecc",20,0,FALSE,FALSE,FALSE,5.83,"old",70,173,84,"m"
4,"TOTAL ABDOMINAL",1,"Ecc05",1300,1240,1250,1250,1270,1250,0.016,20,1260,"Ecc",60,0,FALSE,TRUE,FALSE,1.6,"old",70,173,84,"m"
4,"TOTAL ABDOMINAL",1,"Ecc06",1340,1300,1250,1350,1320,1300,0.015,20,1310,"Ecc",40,-100,FALSE,TRUE,FALSE,1.54,"old",70,173,84,"m"
4,"TOTAL ABDOMINAL",1,"Ecc07",1300,1320,1200,1250,1310,1225,0.065,85,1267.5,"Ecc",-20,-50,FALSE,FALSE,FALSE,6.94,"old",70,173,84,"m"
4,"TOTAL ABDOMINAL",1,"Ecc08",1320,1300,1100,1200,1310,1150,0.122,160,1230,"Ecc",20,-100,TRUE,FALSE,FALSE,13.91,"old",70,173,84,"m"
4,"TOTAL ABDOMINAL",1,"Ecc09",1300,1280,1250,1200,1290,1225,0.05,65,1257.5,"Ecc",20,50,FALSE,FALSE,FALSE,5.31,"old",70,173,84,"m"
4,"TOTAL ABDOMINAL",1,"Ecc10",1980,1960,2100,2000,1970,2050,0.041,-80,2010,"Ecc",20,100,FALSE,FALSE,FALSE,3.9,"old",70,173,84,"m"
4,"TOTAL ABDOMINAL",2,"Ecc01",1260,1240,1250,1200,1250,1225,0.02,25,1237.5,"Ecc",20,50,FALSE,FALSE,FALSE,2.04,"old",70,173,84,"m"
4,"TOTAL ABDOMINAL",2,"Ecc02",1360,1360,1200,1300,1360,1250,0.081,110,1305,"Ecc",0,-100,FALSE,FALSE,FALSE,8.8,"old",70,173,84,"m"
4,"TOTAL ABDOMINAL",2,"Ecc03",1280,1300,1200,1250,1290,1225,0.05,65,1257.5,"Ecc",-20,-50,FALSE,FALSE,FALSE,5.31,"old",70,173,84,"m"
4,"TOTAL ABDOMINAL",2,"Ecc04",1320,1280,1100,1150,1300,1125,0.135,175,1212.5,"Ecc",40,-50,TRUE,TRUE,FALSE,15.56,"old",70,173,84,"m"
4,"TOTAL ABDOMINAL",2,"Ecc05",1340,1320,1150,1150,1330,1150,0.135,180,1240,"Ecc",20,0,TRUE,FALSE,FALSE,15.65,"old",70,173,84,"m"
4,"TOTAL ABDOMINAL",2,"Ecc06",1260,1240,1250,1200,1250,1225,0.02,25,1237.5,"Ecc",20,50,FALSE,FALSE,FALSE,2.04,"old",70,173,84,"m"
4,"TOTAL ABDOMINAL",2,"Ecc07",1180,1160,1200,1200,1170,1200,0.026,-30,1185,"Ecc",20,0,FALSE,FALSE,FALSE,2.5,"old",70,173,84,"m"
4,"TOTAL ABDOMINAL",2,"Ecc08",1200,1180,1250,1250,1190,1250,0.05,-60,1220,"Ecc",20,0,FALSE,FALSE,FALSE,4.8,"old",70,173,84,"m"
4,"TOTAL ABDOMINAL",2,"Ecc09",1300,1260,1200,1050,1280,1125,0.121,155,1202.5,"Ecc",40,150,TRUE,TRUE,FALSE,13.78,"old",70,173,84,"m"
4,"TOTAL ABDOMINAL",2,"Ecc10",1500,1500,1350,1400,1500,1375,0.083,125,1437.5,"Ecc",0,-50,FALSE,FALSE,FALSE,9.09,"old",70,173,84,"m"
4,"TOTAL ABDOMINAL",1,"Rep01",2520,2520,2500,2450,2520,2475,0.018,45,2497.5,"Rep",0,50,FALSE,FALSE,FALSE,1.82,"old",70,173,84,"m"
4,"TOTAL ABDOMINAL",1,"Rep02",2360,2360,2400,2400,2360,2400,0.017,-40,2380,"Rep",0,0,FALSE,FALSE,FALSE,1.67,"old",70,173,84,"m"
4,"TOTAL ABDOMINAL",1,"Rep03",2460,2480,2450,2450,2470,2450,0.008,20,2460,"Rep",-20,0,FALSE,FALSE,FALSE,0.82,"old",70,173,84,"m"
4,"TOTAL ABDOMINAL",1,"Rep04",2360,2340,2350,2350,2350,2350,0,0,2350,"Rep",20,0,FALSE,FALSE,FALSE,0,"old",70,173,84,"m"
4,"TOTAL ABDOMINAL",1,"Rep05",2420,2420,2450,2450,2420,2450,0.012,-30,2435,"Rep",0,0,FALSE,FALSE,FALSE,1.22,"old",70,173,84,"m"
4,"TOTAL ABDOMINAL",1,"Rep06",2420,2400,2350,2400,2410,2375,0.015,35,2392.5,"Rep",20,-50,FALSE,FALSE,FALSE,1.47,"old",70,173,84,"m"
4,"TOTAL ABDOMINAL",1,"Rep07",2380,2440,2400,2350,2410,2375,0.015,35,2392.5,"Rep",-60,50,FALSE,FALSE,FALSE,1.47,"old",70,173,84,"m"
4,"TOTAL ABDOMINAL",1,"Rep08",2520,2480,2450,2500,2500,2475,0.01,25,2487.5,"Rep",40,-50,FALSE,FALSE,FALSE,1.01,"old",70,173,84,"m"
4,"TOTAL ABDOMINAL",1,"Rep09",2420,2420,2500,2450,2420,2475,0.023,-55,2447.5,"Rep",0,50,FALSE,FALSE,FALSE,2.22,"old",70,173,84,"m"
4,"TOTAL ABDOMINAL",1,"Rep10",3080,3100,3250,3200,3090,3225,0.044,-135,3157.5,"Rep",-20,50,TRUE,FALSE,FALSE,4.19,"old",70,173,84,"m"
4,"TOTAL ABDOMINAL",2,"Rep01",2420,2420,2450,2550,2420,2500,0.033,-80,2460,"Rep",0,-100,FALSE,FALSE,FALSE,3.2,"old",70,173,84,"m"
4,"TOTAL ABDOMINAL",2,"Rep02",2320,2320,2250,2300,2320,2275,0.019,45,2297.5,"Rep",0,-50,FALSE,FALSE,FALSE,1.98,"old",70,173,84,"m"
4,"TOTAL ABDOMINAL",2,"Rep03",2400,2400,2450,2400,2400,2425,0.01,-25,2412.5,"Rep",0,50,FALSE,FALSE,FALSE,1.03,"old",70,173,84,"m"
4,"TOTAL ABDOMINAL",2,"Rep04",2400,2400,2350,2350,2400,2350,0.021,50,2375,"Rep",0,0,FALSE,FALSE,FALSE,2.13,"old",70,173,84,"m"
4,"TOTAL ABDOMINAL",2,"Rep05",2320,2320,2300,2300,2320,2300,0.009,20,2310,"Rep",0,0,FALSE,FALSE,FALSE,0.87,"old",70,173,84,"m"
4,"TOTAL ABDOMINAL",2,"Rep06",2320,2320,2450,2400,2320,2425,0.045,-105,2372.5,"Rep",0,50,FALSE,FALSE,FALSE,4.33,"old",70,173,84,"m"
4,"TOTAL ABDOMINAL",2,"Rep07",2280,2280,2300,2300,2280,2300,0.009,-20,2290,"Rep",0,0,FALSE,FALSE,FALSE,0.87,"old",70,173,84,"m"
4,"TOTAL ABDOMINAL",2,"Rep08",2280,2280,2250,2300,2280,2275,0.002,5,2277.5,"Rep",0,-50,FALSE,FALSE,FALSE,0.22,"old",70,173,84,"m"
4,"TOTAL ABDOMINAL",2,"Rep09",2400,2360,2350,2250,2380,2300,0.034,80,2340,"Rep",40,100,FALSE,FALSE,FALSE,3.48,"old",70,173,84,"m"
4,"TOTAL ABDOMINAL",2,"Rep10",2520,2580,2550,2750,2550,2650,0.039,-100,2600,"Rep",-60,-200,FALSE,FALSE,TRUE,3.77,"old",70,173,84,"m"
4,"TOTAL ABDOMINAL",1,"TuT",24940,24960,25100,25000,24950,25050,0.004,-100,25000,"TuT",-20,100,FALSE,FALSE,FALSE,0.4,"old",70,173,84,"m"
4,"TOTAL ABDOMINAL",2,"TuT",23660,23680,23700,23900,23670,23800,0.005,-130,23735,"TuT",-20,-200,FALSE,FALSE,FALSE,0.55,"old",70,173,84,"m"
4,"VERTICAL TRACTION",1,"Con01",1820,1880,1800,1750,1850,1775,0.041,75,1812.5,"Con",-60,50,FALSE,FALSE,FALSE,4.23,"old",70,173,84,"m"
4,"VERTICAL TRACTION",1,"Con02",1220,1260,1250,1200,1240,1225,0.012,15,1232.5,"Con",-40,50,FALSE,FALSE,FALSE,1.22,"old",70,173,84,"m"
4,"VERTICAL TRACTION",1,"Con03",1180,1180,1200,1150,1180,1175,0.004,5,1177.5,"Con",0,50,FALSE,FALSE,FALSE,0.43,"old",70,173,84,"m"
4,"VERTICAL TRACTION",1,"Con04",1240,1260,1250,1200,1250,1225,0.02,25,1237.5,"Con",-20,50,FALSE,FALSE,FALSE,2.04,"old",70,173,84,"m"
4,"VERTICAL TRACTION",1,"Con05",1120,1180,1150,1200,1150,1175,0.022,-25,1162.5,"Con",-60,-50,FALSE,FALSE,FALSE,2.13,"old",70,173,84,"m"
4,"VERTICAL TRACTION",1,"Con06",1120,1120,1150,1200,1120,1175,0.049,-55,1147.5,"Con",0,-50,FALSE,FALSE,FALSE,4.68,"old",70,173,84,"m"
4,"VERTICAL TRACTION",1,"Con07",1140,1160,1200,1250,1150,1225,0.065,-75,1187.5,"Con",-20,-50,FALSE,FALSE,FALSE,6.12,"old",70,173,84,"m"
4,"VERTICAL TRACTION",1,"Con08",1120,1160,1250,1300,1140,1275,0.118,-135,1207.5,"Con",-40,-50,FALSE,FALSE,FALSE,10.59,"old",70,173,84,"m"
4,"VERTICAL TRACTION",1,"Con09",1060,1120,1200,1250,1090,1225,0.124,-135,1157.5,"Con",-60,-50,FALSE,FALSE,FALSE,11.02,"old",70,173,84,"m"
4,"VERTICAL TRACTION",1,"Con10",1260,1260,1500,1450,1260,1475,0.171,-215,1367.5,"Con",0,50,FALSE,FALSE,FALSE,14.58,"old",70,173,84,"m"
4,"VERTICAL TRACTION",2,"Con01",1400,1420,1500,1450,1410,1475,0.046,-65,1442.5,"Con",-20,50,FALSE,FALSE,FALSE,4.41,"old",70,173,84,"m"
4,"VERTICAL TRACTION",2,"Con02",1220,1220,1250,1200,1220,1225,0.004,-5,1222.5,"Con",0,50,FALSE,FALSE,FALSE,0.41,"old",70,173,84,"m"
4,"VERTICAL TRACTION",2,"Con03",1240,1280,1250,1250,1260,1250,0.008,10,1255,"Con",-40,0,FALSE,FALSE,FALSE,0.8,"old",70,173,84,"m"
4,"VERTICAL TRACTION",2,"Con04",1220,1260,1150,1200,1240,1175,0.052,65,1207.5,"Con",-40,-50,FALSE,FALSE,FALSE,5.53,"old",70,173,84,"m"
4,"VERTICAL TRACTION",2,"Con05",1300,1340,1350,1300,1320,1325,0.004,-5,1322.5,"Con",-40,50,FALSE,FALSE,FALSE,0.38,"old",70,173,84,"m"
4,"VERTICAL TRACTION",2,"Con06",1240,1260,1300,1250,1250,1275,0.02,-25,1262.5,"Con",-20,50,FALSE,FALSE,FALSE,1.96,"old",70,173,84,"m"
4,"VERTICAL TRACTION",2,"Con07",1200,1220,1350,1350,1210,1350,0.116,-140,1280,"Con",-20,0,FALSE,FALSE,FALSE,10.37,"old",70,173,84,"m"
4,"VERTICAL TRACTION",2,"Con08",1100,1120,1200,1250,1110,1225,0.104,-115,1167.5,"Con",-20,-50,FALSE,FALSE,FALSE,9.39,"old",70,173,84,"m"
4,"VERTICAL TRACTION",2,"Con09",1120,1160,1250,1300,1140,1275,0.118,-135,1207.5,"Con",-40,-50,FALSE,FALSE,FALSE,10.59,"old",70,173,84,"m"
4,"VERTICAL TRACTION",2,"Con10",1160,1160,1300,1400,1160,1350,0.164,-190,1255,"Con",0,-100,FALSE,FALSE,FALSE,14.07,"old",70,173,84,"m"
4,"VERTICAL TRACTION",1,"Ecc01",1540,1500,1450,1500,1520,1475,0.03,45,1497.5,"Ecc",40,-50,FALSE,FALSE,FALSE,3.05,"old",70,173,84,"m"
4,"VERTICAL TRACTION",1,"Ecc02",1660,1640,1650,1700,1650,1675,0.015,-25,1662.5,"Ecc",20,-50,FALSE,FALSE,FALSE,1.49,"old",70,173,84,"m"
4,"VERTICAL TRACTION",1,"Ecc03",1620,1620,1600,1650,1620,1625,0.003,-5,1622.5,"Ecc",0,-50,FALSE,FALSE,FALSE,0.31,"old",70,173,84,"m"
4,"VERTICAL TRACTION",1,"Ecc04",1600,1560,1600,1600,1580,1600,0.013,-20,1590,"Ecc",40,0,FALSE,FALSE,FALSE,1.25,"old",70,173,84,"m"
4,"VERTICAL TRACTION",1,"Ecc05",1560,1540,1550,1450,1550,1500,0.032,50,1525,"Ecc",20,100,FALSE,FALSE,FALSE,3.33,"old",70,173,84,"m"
4,"VERTICAL TRACTION",1,"Ecc06",1480,1460,1400,1400,1470,1400,0.048,70,1435,"Ecc",20,0,FALSE,FALSE,FALSE,5,"old",70,173,84,"m"
4,"VERTICAL TRACTION",1,"Ecc07",1460,1440,1400,1300,1450,1350,0.069,100,1400,"Ecc",20,100,FALSE,FALSE,FALSE,7.41,"old",70,173,84,"m"
4,"VERTICAL TRACTION",1,"Ecc08",1400,1340,1250,1200,1370,1225,0.106,145,1297.5,"Ecc",60,50,FALSE,FALSE,FALSE,11.84,"old",70,173,84,"m"
4,"VERTICAL TRACTION",1,"Ecc09",1460,1420,1300,1300,1440,1300,0.097,140,1370,"Ecc",40,0,FALSE,FALSE,FALSE,10.77,"old",70,173,84,"m"
4,"VERTICAL TRACTION",1,"Ecc10",1840,1860,1800,1800,1850,1800,0.027,50,1825,"Ecc",-20,0,FALSE,FALSE,FALSE,2.78,"old",70,173,84,"m"
4,"VERTICAL TRACTION",2,"Ecc01",1520,1520,1450,1500,1520,1475,0.03,45,1497.5,"Ecc",0,-50,FALSE,FALSE,FALSE,3.05,"old",70,173,84,"m"
4,"VERTICAL TRACTION",2,"Ecc02",1680,1640,1650,1650,1660,1650,0.006,10,1655,"Ecc",40,0,FALSE,FALSE,FALSE,0.61,"old",70,173,84,"m"
4,"VERTICAL TRACTION",2,"Ecc03",1600,1580,1650,1650,1590,1650,0.038,-60,1620,"Ecc",20,0,FALSE,FALSE,FALSE,3.64,"old",70,173,84,"m"
4,"VERTICAL TRACTION",2,"Ecc04",1560,1500,1600,1600,1530,1600,0.046,-70,1565,"Ecc",60,0,FALSE,FALSE,FALSE,4.38,"old",70,173,84,"m"
4,"VERTICAL TRACTION",2,"Ecc05",1540,1520,1450,1500,1530,1475,0.036,55,1502.5,"Ecc",20,-50,FALSE,FALSE,FALSE,3.73,"old",70,173,84,"m"
4,"VERTICAL TRACTION",2,"Ecc06",1500,1480,1400,1400,1490,1400,0.06,90,1445,"Ecc",20,0,FALSE,FALSE,FALSE,6.43,"old",70,173,84,"m"
4,"VERTICAL TRACTION",2,"Ecc07",1500,1480,1350,1350,1490,1350,0.094,140,1420,"Ecc",20,0,FALSE,FALSE,FALSE,10.37,"old",70,173,84,"m"
4,"VERTICAL TRACTION",2,"Ecc08",1480,1440,1400,1350,1460,1375,0.058,85,1417.5,"Ecc",40,50,FALSE,FALSE,FALSE,6.18,"old",70,173,84,"m"
4,"VERTICAL TRACTION",2,"Ecc09",1520,1520,1400,1300,1520,1350,0.112,170,1435,"Ecc",0,100,FALSE,FALSE,FALSE,12.59,"old",70,173,84,"m"
4,"VERTICAL TRACTION",2,"Ecc10",2640,2620,2150,3400,2630,2775,0.055,-145,2702.5,"Ecc",20,-1250,FALSE,FALSE,TRUE,5.23,"old",70,173,84,"m"
4,"VERTICAL TRACTION",1,"Rep01",3360,3380,3250,3250,3370,3250,0.036,120,3310,"Rep",-20,0,FALSE,FALSE,FALSE,3.69,"old",70,173,84,"m"
4,"VERTICAL TRACTION",1,"Rep02",2880,2900,2900,2900,2890,2900,0.003,-10,2895,"Rep",-20,0,FALSE,FALSE,FALSE,0.34,"old",70,173,84,"m"
4,"VERTICAL TRACTION",1,"Rep03",2800,2800,2800,2800,2800,2800,0,0,2800,"Rep",0,0,FALSE,FALSE,FALSE,0,"old",70,173,84,"m"
4,"VERTICAL TRACTION",1,"Rep04",2840,2820,2850,2800,2830,2825,0.002,5,2827.5,"Rep",20,50,FALSE,FALSE,FALSE,0.18,"old",70,173,84,"m"
4,"VERTICAL TRACTION",1,"Rep05",2680,2720,2700,2650,2700,2675,0.009,25,2687.5,"Rep",-40,50,FALSE,FALSE,FALSE,0.93,"old",70,173,84,"m"
4,"VERTICAL TRACTION",1,"Rep06",2600,2580,2550,2600,2590,2575,0.006,15,2582.5,"Rep",20,-50,FALSE,FALSE,FALSE,0.58,"old",70,173,84,"m"
4,"VERTICAL TRACTION",1,"Rep07",2600,2600,2600,2550,2600,2575,0.01,25,2587.5,"Rep",0,50,FALSE,FALSE,FALSE,0.97,"old",70,173,84,"m"
4,"VERTICAL TRACTION",1,"Rep08",2520,2500,2500,2500,2510,2500,0.004,10,2505,"Rep",20,0,FALSE,FALSE,FALSE,0.4,"old",70,173,84,"m"
4,"VERTICAL TRACTION",1,"Rep09",2520,2540,2500,2550,2530,2525,0.002,5,2527.5,"Rep",-20,-50,FALSE,FALSE,FALSE,0.2,"old",70,173,84,"m"
4,"VERTICAL TRACTION",1,"Rep10",3100,3120,3300,3250,3110,3275,0.053,-165,3192.5,"Rep",-20,50,TRUE,FALSE,FALSE,5.04,"old",70,173,84,"m"
4,"VERTICAL TRACTION",2,"Rep01",2920,2940,2950,2950,2930,2950,0.007,-20,2940,"Rep",-20,0,FALSE,FALSE,FALSE,0.68,"old",70,173,84,"m"
4,"VERTICAL TRACTION",2,"Rep02",2900,2860,2900,2850,2880,2875,0.002,5,2877.5,"Rep",40,50,FALSE,FALSE,FALSE,0.17,"old",70,173,84,"m"
4,"VERTICAL TRACTION",2,"Rep03",2840,2860,2900,2900,2850,2900,0.018,-50,2875,"Rep",-20,0,FALSE,FALSE,FALSE,1.72,"old",70,173,84,"m"
4,"VERTICAL TRACTION",2,"Rep04",2780,2760,2750,2800,2770,2775,0.002,-5,2772.5,"Rep",20,-50,FALSE,FALSE,FALSE,0.18,"old",70,173,84,"m"
4,"VERTICAL TRACTION",2,"Rep05",2840,2860,2800,2800,2850,2800,0.018,50,2825,"Rep",-20,0,FALSE,FALSE,FALSE,1.79,"old",70,173,84,"m"
4,"VERTICAL TRACTION",2,"Rep06",2740,2740,2700,2650,2740,2675,0.024,65,2707.5,"Rep",0,50,FALSE,FALSE,FALSE,2.43,"old",70,173,84,"m"
4,"VERTICAL TRACTION",2,"Rep07",2700,2700,2700,2700,2700,2700,0,0,2700,"Rep",0,0,FALSE,FALSE,FALSE,0,"old",70,173,84,"m"
4,"VERTICAL TRACTION",2,"Rep08",2580,2560,2600,2600,2570,2600,0.012,-30,2585,"Rep",20,0,FALSE,FALSE,FALSE,1.15,"old",70,173,84,"m"
4,"VERTICAL TRACTION",2,"Rep09",2640,2680,2650,2600,2660,2625,0.013,35,2642.5,"Rep",-40,50,FALSE,FALSE,FALSE,1.33,"old",70,173,84,"m"
4,"VERTICAL TRACTION",2,"Rep10",3800,3780,3450,4800,3790,4125,0.088,-335,3957.5,"Rep",20,-1350,TRUE,FALSE,TRUE,8.12,"old",70,173,84,"m"
4,"VERTICAL TRACTION",1,"TuT",27900,27960,27950,27850,27930,27900,0.001,30,27915,"TuT",-60,100,FALSE,FALSE,FALSE,0.11,"old",70,173,84,"m"
4,"VERTICAL TRACTION",2,"TuT",28740,28740,28400,29650,28740,29025,0.01,-285,28882.5,"TuT",0,-1250,FALSE,FALSE,FALSE,0.98,"old",70,173,84,"m"
4,"CHEST PRESS",1,"Con01",2260,2320,750,2150,2290,1450,0.367,840,1870,"Con",-60,-1400,TRUE,TRUE,TRUE,57.93,"old",70,173,84,"m"
4,"CHEST PRESS",1,"Con02",1500,1540,2400,1400,1520,1900,0.25,-380,1710,"Con",-40,1000,TRUE,TRUE,TRUE,20,"old",70,173,84,"m"
4,"CHEST PRESS",1,"Con03",1340,1360,1550,1350,1350,1450,0.074,-100,1400,"Con",-20,200,FALSE,FALSE,FALSE,6.9,"old",70,173,84,"m"
4,"CHEST PRESS",1,"Con04",1360,1400,1450,1250,1380,1350,0.022,30,1365,"Con",-40,200,FALSE,TRUE,FALSE,2.22,"old",70,173,84,"m"
4,"CHEST PRESS",1,"Con05",1340,1400,1350,1300,1370,1325,0.033,45,1347.5,"Con",-60,50,FALSE,TRUE,FALSE,3.4,"old",70,173,84,"m"
4,"CHEST PRESS",1,"Con06",1400,1400,1350,1450,1400,1400,0,0,1400,"Con",0,-100,FALSE,FALSE,FALSE,0,"old",70,173,84,"m"
4,"CHEST PRESS",1,"Con07",1420,1480,1500,1550,1450,1525,0.052,-75,1487.5,"Con",-60,-50,FALSE,TRUE,FALSE,4.92,"old",70,173,84,"m"
4,"CHEST PRESS",1,"Con08",1400,1400,1500,1500,1400,1500,0.071,-100,1450,"Con",0,0,FALSE,FALSE,FALSE,6.67,"old",70,173,84,"m"
4,"CHEST PRESS",1,"Con09",1300,1320,1400,1500,1310,1450,0.107,-140,1380,"Con",-20,-100,FALSE,FALSE,FALSE,9.66,"old",70,173,84,"m"
4,"CHEST PRESS",1,"Con10",1380,1420,1350,1800,1400,1575,0.125,-175,1487.5,"Con",-40,-450,FALSE,TRUE,TRUE,11.11,"old",70,173,84,"m"
4,"CHEST PRESS",2,"Con01",1400,1420,1350,1400,1410,1375,0.025,35,1392.5,"Con",-20,-50,FALSE,FALSE,FALSE,2.55,"old",70,173,84,"m"
4,"CHEST PRESS",2,"Con02",1200,1200,1150,1250,1200,1200,0,0,1200,"Con",0,-100,FALSE,FALSE,FALSE,0,"old",70,173,84,"m"
4,"CHEST PRESS",2,"Con03",1320,1360,1250,1300,1340,1275,0.049,65,1307.5,"Con",-40,-50,FALSE,TRUE,FALSE,5.1,"old",70,173,84,"m"
4,"CHEST PRESS",2,"Con04",1120,1160,1200,1250,1140,1225,0.075,-85,1182.5,"Con",-40,-50,FALSE,TRUE,FALSE,6.94,"old",70,173,84,"m"
4,"CHEST PRESS",2,"Con05",1200,1240,1150,1200,1220,1175,0.037,45,1197.5,"Con",-40,-50,FALSE,TRUE,FALSE,3.83,"old",70,173,84,"m"
4,"CHEST PRESS",2,"Con06",1040,1060,1150,1150,1050,1150,0.095,-100,1100,"Con",-20,0,FALSE,FALSE,FALSE,8.7,"old",70,173,84,"m"
4,"CHEST PRESS",2,"Con07",1180,1240,1250,1250,1210,1250,0.033,-40,1230,"Con",-60,0,FALSE,TRUE,FALSE,3.2,"old",70,173,84,"m"
4,"CHEST PRESS",2,"Con08",1060,1080,1200,1150,1070,1175,0.098,-105,1122.5,"Con",-20,50,FALSE,FALSE,FALSE,8.94,"old",70,173,84,"m"
4,"CHEST PRESS",2,"Con09",1200,1220,1300,1250,1210,1275,0.054,-65,1242.5,"Con",-20,50,FALSE,FALSE,FALSE,5.1,"old",70,173,84,"m"
4,"CHEST PRESS",2,"Con10",1220,1220,1450,1250,1220,1350,0.107,-130,1285,"Con",0,200,FALSE,FALSE,FALSE,9.63,"old",70,173,84,"m"
4,"CHEST PRESS",1,"Ecc01",1300,1260,850,1400,1280,1125,0.121,155,1202.5,"Ecc",40,-550,FALSE,TRUE,TRUE,13.78,"old",70,173,84,"m"
4,"CHEST PRESS",1,"Ecc02",1580,1580,1200,1650,1580,1425,0.098,155,1502.5,"Ecc",0,-450,FALSE,FALSE,TRUE,10.88,"old",70,173,84,"m"
4,"CHEST PRESS",1,"Ecc03",1660,1600,1500,1700,1630,1600,0.018,30,1615,"Ecc",60,-200,FALSE,TRUE,FALSE,1.88,"old",70,173,84,"m"
4,"CHEST PRESS",1,"Ecc04",1700,1640,1600,1750,1670,1675,0.003,-5,1672.5,"Ecc",60,-150,FALSE,TRUE,FALSE,0.3,"old",70,173,84,"m"
4,"CHEST PRESS",1,"Ecc05",2040,2020,1700,2000,2030,1850,0.089,180,1940,"Ecc",20,-300,FALSE,FALSE,TRUE,9.73,"old",70,173,84,"m"
4,"CHEST PRESS",1,"Ecc06",1600,1580,1950,1550,1590,1750,0.101,-160,1670,"Ecc",20,400,FALSE,FALSE,TRUE,9.14,"old",70,173,84,"m"
4,"CHEST PRESS",1,"Ecc07",1700,1680,1550,1600,1690,1575,0.068,115,1632.5,"Ecc",20,-50,FALSE,FALSE,FALSE,7.3,"old",70,173,84,"m"
4,"CHEST PRESS",1,"Ecc08",1780,1740,1700,1550,1760,1625,0.077,135,1692.5,"Ecc",40,150,FALSE,TRUE,FALSE,8.31,"old",70,173,84,"m"
4,"CHEST PRESS",1,"Ecc09",1640,1640,1700,1350,1640,1525,0.07,115,1582.5,"Ecc",0,350,FALSE,FALSE,TRUE,7.54,"old",70,173,84,"m"
4,"CHEST PRESS",1,"Ecc10",2600,2600,1600,3400,2600,2500,0.038,100,2550,"Ecc",0,-1800,FALSE,FALSE,TRUE,4,"old",70,173,84,"m"
4,"CHEST PRESS",2,"Ecc01",1340,1280,1450,1300,1310,1375,0.05,-65,1342.5,"Ecc",60,150,FALSE,TRUE,FALSE,4.73,"old",70,173,84,"m"
4,"CHEST PRESS",2,"Ecc02",1300,1320,1350,1250,1310,1300,0.008,10,1305,"Ecc",-20,100,FALSE,FALSE,FALSE,0.77,"old",70,173,84,"m"
4,"CHEST PRESS",2,"Ecc03",1360,1320,1350,1350,1340,1350,0.007,-10,1345,"Ecc",40,0,FALSE,TRUE,FALSE,0.74,"old",70,173,84,"m"
4,"CHEST PRESS",2,"Ecc04",1300,1260,1300,1250,1280,1275,0.004,5,1277.5,"Ecc",40,50,FALSE,TRUE,FALSE,0.39,"old",70,173,84,"m"
4,"CHEST PRESS",2,"Ecc05",1360,1340,1350,1300,1350,1325,0.019,25,1337.5,"Ecc",20,50,FALSE,FALSE,FALSE,1.89,"old",70,173,84,"m"
4,"CHEST PRESS",2,"Ecc06",1460,1420,1350,1350,1440,1350,0.062,90,1395,"Ecc",40,0,FALSE,TRUE,FALSE,6.67,"old",70,173,84,"m"
4,"CHEST PRESS",2,"Ecc07",1440,1400,1300,1350,1420,1325,0.067,95,1372.5,"Ecc",40,-50,FALSE,TRUE,FALSE,7.17,"old",70,173,84,"m"
4,"CHEST PRESS",2,"Ecc08",1260,1240,1200,1200,1250,1200,0.04,50,1225,"Ecc",20,0,FALSE,FALSE,FALSE,4.17,"old",70,173,84,"m"
4,"CHEST PRESS",2,"Ecc09",1300,1280,1150,1300,1290,1225,0.05,65,1257.5,"Ecc",20,-150,FALSE,FALSE,FALSE,5.31,"old",70,173,84,"m"
4,"CHEST PRESS",2,"Ecc10",2660,2660,2550,2650,2660,2600,0.023,60,2630,"Ecc",0,-100,FALSE,FALSE,FALSE,2.31,"old",70,173,84,"m"
4,"CHEST PRESS",1,"Rep01",3560,3580,1600,3550,3570,2575,0.279,995,3072.5,"Rep",-20,-1950,TRUE,FALSE,TRUE,38.64,"old",70,173,84,"m"
4,"CHEST PRESS",1,"Rep02",3080,3120,3600,3050,3100,3325,0.073,-225,3212.5,"Rep",-40,550,TRUE,FALSE,TRUE,6.77,"old",70,173,84,"m"
4,"CHEST PRESS",1,"Rep03",3000,2960,3050,3050,2980,3050,0.023,-70,3015,"Rep",40,0,FALSE,FALSE,FALSE,2.3,"old",70,173,84,"m"
4,"CHEST PRESS",1,"Rep04",3060,3040,3050,3000,3050,3025,0.008,25,3037.5,"Rep",20,50,FALSE,FALSE,FALSE,0.83,"old",70,173,84,"m"
4,"CHEST PRESS",1,"Rep05",3380,3420,3050,3300,3400,3175,0.066,225,3287.5,"Rep",-40,-250,TRUE,FALSE,TRUE,7.09,"old",70,173,84,"m"
4,"CHEST PRESS",1,"Rep06",3000,2980,3300,3000,2990,3150,0.054,-160,3070,"Rep",20,300,TRUE,FALSE,TRUE,5.08,"old",70,173,84,"m"
4,"CHEST PRESS",1,"Rep07",3120,3160,3050,3150,3140,3100,0.013,40,3120,"Rep",-40,-100,FALSE,FALSE,FALSE,1.29,"old",70,173,84,"m"
4,"CHEST PRESS",1,"Rep08",3180,3140,3200,3050,3160,3125,0.011,35,3142.5,"Rep",40,150,FALSE,FALSE,FALSE,1.12,"old",70,173,84,"m"
4,"CHEST PRESS",1,"Rep09",2940,2960,3100,2850,2950,2975,0.008,-25,2962.5,"Rep",-20,250,FALSE,FALSE,TRUE,0.84,"old",70,173,84,"m"
4,"CHEST PRESS",1,"Rep10",3980,4020,2950,5200,4000,4075,0.019,-75,4037.5,"Rep",-40,-2250,FALSE,FALSE,TRUE,1.84,"old",70,173,84,"m"
4,"CHEST PRESS",2,"Rep01",2740,2700,2800,2700,2720,2750,0.011,-30,2735,"Rep",40,100,FALSE,FALSE,FALSE,1.09,"old",70,173,84,"m"
4,"CHEST PRESS",2,"Rep02",2500,2520,2500,2500,2510,2500,0.004,10,2505,"Rep",-20,0,FALSE,FALSE,FALSE,0.4,"old",70,173,84,"m"
4,"CHEST PRESS",2,"Rep03",2680,2680,2600,2650,2680,2625,0.021,55,2652.5,"Rep",0,-50,FALSE,FALSE,FALSE,2.1,"old",70,173,84,"m"
4,"CHEST PRESS",2,"Rep04",2420,2420,2500,2500,2420,2500,0.033,-80,2460,"Rep",0,0,FALSE,FALSE,FALSE,3.2,"old",70,173,84,"m"
4,"CHEST PRESS",2,"Rep05",2560,2580,2500,2500,2570,2500,0.027,70,2535,"Rep",-20,0,FALSE,FALSE,FALSE,2.8,"old",70,173,84,"m"
4,"CHEST PRESS",2,"Rep06",2500,2480,2500,2500,2490,2500,0.004,-10,2495,"Rep",20,0,FALSE,FALSE,FALSE,0.4,"old",70,173,84,"m"
4,"CHEST PRESS",2,"Rep07",2620,2640,2550,2600,2630,2575,0.021,55,2602.5,"Rep",-20,-50,FALSE,FALSE,FALSE,2.14,"old",70,173,84,"m"
4,"CHEST PRESS",2,"Rep08",2320,2320,2400,2350,2320,2375,0.024,-55,2347.5,"Rep",0,50,FALSE,FALSE,FALSE,2.32,"old",70,173,84,"m"
4,"CHEST PRESS",2,"Rep09",2500,2500,2450,2550,2500,2500,0,0,2500,"Rep",0,-100,FALSE,FALSE,FALSE,0,"old",70,173,84,"m"
4,"CHEST PRESS",2,"Rep10",3880,3880,4000,3900,3880,3950,0.018,-70,3915,"Rep",0,100,FALSE,FALSE,FALSE,1.77,"old",70,173,84,"m"
4,"CHEST PRESS",1,"TuT",32300,32380,29950,33200,32340,31575,0.024,765,31957.5,"TuT",-80,-3250,FALSE,TRUE,TRUE,2.42,"old",70,173,84,"m"
4,"CHEST PRESS",2,"TuT",26720,26720,26800,26750,26720,26775,0.002,-55,26747.5,"TuT",0,50,FALSE,FALSE,FALSE,0.21,"old",70,173,84,"m"
5,"LEG PRESS",1,"Con01",1720,1780,2250,1600,1750,1925,0.1,-175,1837.5,"Con",-60,650,FALSE,FALSE,TRUE,9.09,"old",69,170,57,"f"
5,"LEG PRESS",1,"Con02",1340,1340,1500,1400,1340,1450,0.082,-110,1395,"Con",0,100,FALSE,FALSE,FALSE,7.59,"old",69,170,57,"f"
5,"LEG PRESS",1,"Con03",1460,1420,1550,1500,1440,1525,0.059,-85,1482.5,"Con",40,50,FALSE,FALSE,FALSE,5.57,"old",69,170,57,"f"
5,"LEG PRESS",1,"Con04",1580,1620,1600,1650,1600,1625,0.016,-25,1612.5,"Con",-40,-50,FALSE,FALSE,FALSE,1.54,"old",69,170,57,"f"
5,"LEG PRESS",1,"Con05",1480,1520,1550,1600,1500,1575,0.05,-75,1537.5,"Con",-40,-50,FALSE,FALSE,FALSE,4.76,"old",69,170,57,"f"
5,"LEG PRESS",1,"Con06",1540,1540,1600,1650,1540,1625,0.055,-85,1582.5,"Con",0,-50,FALSE,FALSE,FALSE,5.23,"old",69,170,57,"f"
5,"LEG PRESS",1,"Con07",1460,1440,1650,1600,1450,1625,0.121,-175,1537.5,"Con",20,50,FALSE,FALSE,FALSE,10.77,"old",69,170,57,"f"
5,"LEG PRESS",1,"Con08",1460,1460,1650,1650,1460,1650,0.13,-190,1555,"Con",0,0,FALSE,FALSE,FALSE,11.52,"old",69,170,57,"f"
5,"LEG PRESS",1,"Con09",1400,1360,1600,1800,1380,1700,0.232,-320,1540,"Con",40,-200,FALSE,FALSE,TRUE,18.82,"old",69,170,57,"f"
5,"LEG PRESS",1,"Con10",1500,1480,1800,1800,1490,1800,0.208,-310,1645,"Con",20,0,FALSE,FALSE,FALSE,17.22,"old",69,170,57,"f"
5,"LEG PRESS",2,"Con01",1640,1660,1850,1750,1650,1800,0.091,-150,1725,"Con",-20,100,FALSE,FALSE,FALSE,8.33,"old",69,170,57,"f"
5,"LEG PRESS",2,"Con02",1280,1300,1400,1350,1290,1375,0.066,-85,1332.5,"Con",-20,50,FALSE,FALSE,FALSE,6.18,"old",69,170,57,"f"
5,"LEG PRESS",2,"Con03",1360,1360,1400,1350,1360,1375,0.011,-15,1367.5,"Con",0,50,FALSE,FALSE,FALSE,1.09,"old",69,170,57,"f"
5,"LEG PRESS",2,"Con04",1320,1320,1400,1400,1320,1400,0.061,-80,1360,"Con",0,0,FALSE,FALSE,FALSE,5.71,"old",69,170,57,"f"
5,"LEG PRESS",2,"Con05",1560,1600,1550,1550,1580,1550,0.019,30,1565,"Con",-40,0,FALSE,FALSE,FALSE,1.94,"old",69,170,57,"f"
5,"LEG PRESS",2,"Con06",1460,1480,1500,1550,1470,1525,0.037,-55,1497.5,"Con",-20,-50,FALSE,FALSE,FALSE,3.61,"old",69,170,57,"f"
5,"LEG PRESS",2,"Con07",1400,1420,1500,1600,1410,1550,0.099,-140,1480,"Con",-20,-100,FALSE,FALSE,FALSE,9.03,"old",69,170,57,"f"
5,"LEG PRESS",2,"Con08",1460,1460,1650,1650,1460,1650,0.13,-190,1555,"Con",0,0,FALSE,FALSE,FALSE,11.52,"old",69,170,57,"f"
5,"LEG PRESS",2,"Con09",1400,1420,1750,1750,1410,1750,0.241,-340,1580,"Con",-20,0,FALSE,FALSE,FALSE,19.43,"old",69,170,57,"f"
5,"LEG PRESS",2,"Con10",1420,1440,1700,1750,1430,1725,0.206,-295,1577.5,"Con",-20,-50,FALSE,FALSE,FALSE,17.1,"old",69,170,57,"f"
5,"LEG PRESS",1,"Ecc01",3600,3560,3450,3500,3580,3475,0.029,105,3527.5,"Ecc",40,-50,FALSE,FALSE,FALSE,3.02,"old",69,170,57,"f"
5,"LEG PRESS",1,"Ecc02",2940,2980,2800,2850,2960,2825,0.046,135,2892.5,"Ecc",-40,-50,FALSE,FALSE,FALSE,4.78,"old",69,170,57,"f"
5,"LEG PRESS",1,"Ecc03",2720,2700,2700,2700,2710,2700,0.004,10,2705,"Ecc",20,0,FALSE,FALSE,FALSE,0.37,"old",69,170,57,"f"
5,"LEG PRESS",1,"Ecc04",2280,2240,2200,2150,2260,2175,0.038,85,2217.5,"Ecc",40,50,FALSE,FALSE,FALSE,3.91,"old",69,170,57,"f"
5,"LEG PRESS",1,"Ecc05",1700,1680,1700,1650,1690,1675,0.009,15,1682.5,"Ecc",20,50,FALSE,FALSE,FALSE,0.9,"old",69,170,57,"f"
5,"LEG PRESS",1,"Ecc06",2140,2180,1950,1950,2160,1950,0.097,210,2055,"Ecc",-40,0,FALSE,FALSE,FALSE,10.77,"old",69,170,57,"f"
5,"LEG PRESS",1,"Ecc07",2560,2560,2400,2400,2560,2400,0.062,160,2480,"Ecc",0,0,FALSE,FALSE,FALSE,6.67,"old",69,170,57,"f"
5,"LEG PRESS",1,"Ecc08",2580,2600,2350,2200,2590,2275,0.122,315,2432.5,"Ecc",-20,150,FALSE,FALSE,FALSE,13.85,"old",69,170,57,"f"
5,"LEG PRESS",1,"Ecc09",2680,2700,2400,2350,2690,2375,0.117,315,2532.5,"Ecc",-20,50,FALSE,FALSE,FALSE,13.26,"old",69,170,57,"f"
5,"LEG PRESS",1,"Ecc10",3100,3100,3000,3000,3100,3000,0.032,100,3050,"Ecc",0,0,FALSE,FALSE,FALSE,3.33,"old",69,170,57,"f"
5,"LEG PRESS",2,"Ecc01",2220,2180,2050,2150,2200,2100,0.045,100,2150,"Ecc",40,-100,FALSE,FALSE,FALSE,4.76,"old",69,170,57,"f"
5,"LEG PRESS",2,"Ecc02",1680,1680,1650,1650,1680,1650,0.018,30,1665,"Ecc",0,0,FALSE,FALSE,FALSE,1.82,"old",69,170,57,"f"
5,"LEG PRESS",2,"Ecc03",1940,1940,1850,1900,1940,1875,0.034,65,1907.5,"Ecc",0,-50,FALSE,FALSE,FALSE,3.47,"old",69,170,57,"f"
5,"LEG PRESS",2,"Ecc04",1860,1840,1850,1850,1850,1850,0,0,1850,"Ecc",20,0,FALSE,FALSE,FALSE,0,"old",69,170,57,"f"
5,"LEG PRESS",2,"Ecc05",2560,2520,2550,2500,2540,2525,0.006,15,2532.5,"Ecc",40,50,FALSE,FALSE,FALSE,0.59,"old",69,170,57,"f"
5,"LEG PRESS",2,"Ecc06",2340,2320,2250,2150,2330,2200,0.056,130,2265,"Ecc",20,100,FALSE,FALSE,FALSE,5.91,"old",69,170,57,"f"
5,"LEG PRESS",2,"Ecc07",2240,2240,2050,2050,2240,2050,0.085,190,2145,"Ecc",0,0,FALSE,FALSE,FALSE,9.27,"old",69,170,57,"f"
5,"LEG PRESS",2,"Ecc08",2220,2200,1900,1900,2210,1900,0.14,310,2055,"Ecc",20,0,FALSE,FALSE,FALSE,16.32,"old",69,170,57,"f"
5,"LEG PRESS",2,"Ecc09",2280,2260,2000,1950,2270,1975,0.13,295,2122.5,"Ecc",20,50,FALSE,FALSE,FALSE,14.94,"old",69,170,57,"f"
5,"LEG PRESS",2,"Ecc10",2720,2720,3200,2700,2720,2950,0.085,-230,2835,"Ecc",0,500,FALSE,FALSE,TRUE,7.8,"old",69,170,57,"f"
5,"LEG PRESS",1,"Rep01",5320,5340,5700,5100,5330,5400,0.013,-70,5365,"Rep",-20,600,FALSE,FALSE,TRUE,1.3,"old",69,170,57,"f"
5,"LEG PRESS",1,"Rep02",4280,4320,4300,4250,4300,4275,0.006,25,4287.5,"Rep",-40,50,FALSE,FALSE,FALSE,0.58,"old",69,170,57,"f"
5,"LEG PRESS",1,"Rep03",4180,4120,4250,4200,4150,4225,0.018,-75,4187.5,"Rep",60,50,FALSE,FALSE,FALSE,1.78,"old",69,170,57,"f"
5,"LEG PRESS",1,"Rep04",3860,3860,3800,3800,3860,3800,0.016,60,3830,"Rep",0,0,FALSE,FALSE,FALSE,1.58,"old",69,170,57,"f"
5,"LEG PRESS",1,"Rep05",3180,3200,3250,3250,3190,3250,0.019,-60,3220,"Rep",-20,0,FALSE,FALSE,FALSE,1.85,"old",69,170,57,"f"
5,"LEG PRESS",1,"Rep06",3680,3720,3550,3600,3700,3575,0.034,125,3637.5,"Rep",-40,-50,TRUE,FALSE,FALSE,3.5,"old",69,170,57,"f"
5,"LEG PRESS",1,"Rep07",4020,4000,4050,4000,4010,4025,0.004,-15,4017.5,"Rep",20,50,FALSE,FALSE,FALSE,0.37,"old",69,170,57,"f"
5,"LEG PRESS",1,"Rep08",4040,4060,4000,3850,4050,3925,0.031,125,3987.5,"Rep",-20,150,TRUE,FALSE,TRUE,3.18,"old",69,170,57,"f"
5,"LEG PRESS",1,"Rep09",4080,4060,4000,4150,4070,4075,0.001,-5,4072.5,"Rep",20,-150,FALSE,FALSE,TRUE,0.12,"old",69,170,57,"f"
5,"LEG PRESS",1,"Rep10",4600,4580,4800,4800,4590,4800,0.046,-210,4695,"Rep",20,0,TRUE,FALSE,FALSE,4.38,"old",69,170,57,"f"
5,"LEG PRESS",2,"Rep01",3860,3840,3900,3900,3850,3900,0.013,-50,3875,"Rep",20,0,FALSE,FALSE,FALSE,1.28,"old",69,170,57,"f"
5,"LEG PRESS",2,"Rep02",2960,2980,3050,3000,2970,3025,0.019,-55,2997.5,"Rep",-20,50,FALSE,FALSE,FALSE,1.82,"old",69,170,57,"f"
5,"LEG PRESS",2,"Rep03",3300,3300,3250,3250,3300,3250,0.015,50,3275,"Rep",0,0,FALSE,FALSE,FALSE,1.54,"old",69,170,57,"f"
5,"LEG PRESS",2,"Rep04",3180,3160,3250,3250,3170,3250,0.025,-80,3210,"Rep",20,0,FALSE,FALSE,FALSE,2.46,"old",69,170,57,"f"
5,"LEG PRESS",2,"Rep05",4120,4120,4100,4050,4120,4075,0.011,45,4097.5,"Rep",0,50,FALSE,FALSE,FALSE,1.1,"old",69,170,57,"f"
5,"LEG PRESS",2,"Rep06",3800,3800,3750,3700,3800,3725,0.02,75,3762.5,"Rep",0,50,FALSE,FALSE,FALSE,2.01,"old",69,170,57,"f"
5,"LEG PRESS",2,"Rep07",3640,3660,3550,3650,3650,3600,0.014,50,3625,"Rep",-20,-100,FALSE,FALSE,TRUE,1.39,"old",69,170,57,"f"
5,"LEG PRESS",2,"Rep08",3680,3660,3550,3550,3670,3550,0.033,120,3610,"Rep",20,0,TRUE,FALSE,FALSE,3.38,"old",69,170,57,"f"
5,"LEG PRESS",2,"Rep09",3680,3680,3750,3700,3680,3725,0.012,-45,3702.5,"Rep",0,50,FALSE,FALSE,FALSE,1.21,"old",69,170,57,"f"
5,"LEG PRESS",2,"Rep10",4140,4160,4900,4450,4150,4675,0.127,-525,4412.5,"Rep",-20,450,TRUE,FALSE,TRUE,11.23,"old",69,170,57,"f"
5,"LEG PRESS",1,"TuT",41240,41260,41700,41000,41250,41350,0.002,-100,41300,"TuT",-20,700,FALSE,FALSE,TRUE,0.24,"old",69,170,57,"f"
5,"LEG PRESS",2,"TuT",36360,36360,37050,36500,36360,36775,0.011,-415,36567.5,"TuT",0,550,FALSE,FALSE,TRUE,1.13,"old",69,170,57,"f"
5,"LEG EXTENSION",1,"Con01",2520,2500,2550,2450,2510,2500,0.004,10,2505,"Con",20,100,FALSE,FALSE,FALSE,0.4,"old",69,170,57,"f"
5,"LEG EXTENSION",1,"Con02",1740,1760,1800,1800,1750,1800,0.029,-50,1775,"Con",-20,0,FALSE,FALSE,FALSE,2.78,"old",69,170,57,"f"
5,"LEG EXTENSION",1,"Con03",1540,1520,1650,1650,1530,1650,0.078,-120,1590,"Con",20,0,FALSE,FALSE,FALSE,7.27,"old",69,170,57,"f"
5,"LEG EXTENSION",1,"Con04",1500,1500,1600,1800,1500,1700,0.133,-200,1600,"Con",0,-200,TRUE,FALSE,TRUE,11.76,"old",69,170,57,"f"
5,"LEG EXTENSION",1,"Con05",1460,1500,1500,1550,1480,1525,0.03,-45,1502.5,"Con",-40,-50,FALSE,TRUE,FALSE,2.95,"old",69,170,57,"f"
5,"LEG EXTENSION",1,"Con06",1460,1500,1500,1500,1480,1500,0.014,-20,1490,"Con",-40,0,FALSE,TRUE,FALSE,1.33,"old",69,170,57,"f"
5,"LEG EXTENSION",1,"Con07",1540,1540,1650,1500,1540,1575,0.023,-35,1557.5,"Con",0,150,FALSE,FALSE,FALSE,2.22,"old",69,170,57,"f"
5,"LEG EXTENSION",1,"Con08",1560,1560,1750,1700,1560,1725,0.106,-165,1642.5,"Con",0,50,FALSE,FALSE,FALSE,9.57,"old",69,170,57,"f"
5,"LEG EXTENSION",1,"Con09",1520,1520,2000,2050,1520,2025,0.332,-505,1772.5,"Con",0,-50,TRUE,FALSE,FALSE,24.94,"old",69,170,57,"f"
5,"LEG EXTENSION",1,"Con10",1340,1380,1750,1950,1360,1850,0.36,-490,1605,"Con",-40,-200,TRUE,TRUE,TRUE,26.49,"old",69,170,57,"f"
5,"LEG EXTENSION",2,"Con01",2200,2220,2200,2100,2210,2150,0.027,60,2180,"Con",-20,100,FALSE,FALSE,FALSE,2.79,"old",69,170,57,"f"
5,"LEG EXTENSION",2,"Con02",1420,1420,1500,1400,1420,1450,0.021,-30,1435,"Con",0,100,FALSE,FALSE,FALSE,2.07,"old",69,170,57,"f"
5,"LEG EXTENSION",2,"Con03",1440,1460,1450,1450,1450,1450,0,0,1450,"Con",-20,0,FALSE,FALSE,FALSE,0,"old",69,170,57,"f"
5,"LEG EXTENSION",2,"Con04",1500,1520,1550,1550,1510,1550,0.026,-40,1530,"Con",-20,0,FALSE,FALSE,FALSE,2.58,"old",69,170,57,"f"
5,"LEG EXTENSION",2,"Con05",1460,1480,1500,1500,1470,1500,0.02,-30,1485,"Con",-20,0,FALSE,FALSE,FALSE,2,"old",69,170,57,"f"
5,"LEG EXTENSION",2,"Con06",1240,1260,1400,1400,1250,1400,0.12,-150,1325,"Con",-20,0,FALSE,FALSE,FALSE,10.71,"old",69,170,57,"f"
5,"LEG EXTENSION",2,"Con07",1420,1440,1650,1600,1430,1625,0.136,-195,1527.5,"Con",-20,50,TRUE,FALSE,FALSE,12,"old",69,170,57,"f"
5,"LEG EXTENSION",2,"Con08",1260,1300,1450,1400,1280,1425,0.113,-145,1352.5,"Con",-40,50,FALSE,TRUE,FALSE,10.18,"old",69,170,57,"f"
5,"LEG EXTENSION",2,"Con09",1300,1280,1450,1450,1290,1450,0.124,-160,1370,"Con",20,0,FALSE,FALSE,FALSE,11.03,"old",69,170,57,"f"
5,"LEG EXTENSION",2,"Con10",1240,1260,1700,1850,1250,1775,0.42,-525,1512.5,"Con",-20,-150,TRUE,FALSE,FALSE,29.58,"old",69,170,57,"f"
5,"LEG EXTENSION",1,"Ecc01",3220,3220,3250,3250,3220,3250,0.009,-30,3235,"Ecc",0,0,FALSE,FALSE,FALSE,0.92,"old",69,170,57,"f"
5,"LEG EXTENSION",1,"Ecc02",2900,2880,2750,2750,2890,2750,0.048,140,2820,"Ecc",20,0,FALSE,FALSE,FALSE,5.09,"old",69,170,57,"f"
5,"LEG EXTENSION",1,"Ecc03",2380,2400,2300,2150,2390,2225,0.069,165,2307.5,"Ecc",-20,150,FALSE,FALSE,FALSE,7.42,"old",69,170,57,"f"
5,"LEG EXTENSION",1,"Ecc04",2540,2500,2500,2400,2520,2450,0.028,70,2485,"Ecc",40,100,FALSE,TRUE,FALSE,2.86,"old",69,170,57,"f"
5,"LEG EXTENSION",1,"Ecc05",2760,2740,2700,2700,2750,2700,0.018,50,2725,"Ecc",20,0,FALSE,FALSE,FALSE,1.85,"old",69,170,57,"f"
5,"LEG EXTENSION",1,"Ecc06",2220,2220,2150,2250,2220,2200,0.009,20,2210,"Ecc",0,-100,FALSE,FALSE,FALSE,0.91,"old",69,170,57,"f"
5,"LEG EXTENSION",1,"Ecc07",2160,2140,1950,2050,2150,2000,0.07,150,2075,"Ecc",20,-100,FALSE,FALSE,FALSE,7.5,"old",69,170,57,"f"
5,"LEG EXTENSION",1,"Ecc08",2120,2120,1700,1700,2120,1700,0.198,420,1910,"Ecc",0,0,TRUE,FALSE,FALSE,24.71,"old",69,170,57,"f"
5,"LEG EXTENSION",1,"Ecc09",2900,2880,2550,2300,2890,2425,0.161,465,2657.5,"Ecc",20,250,TRUE,FALSE,TRUE,19.18,"old",69,170,57,"f"
5,"LEG EXTENSION",1,"Ecc10",4600,4640,2400,4400,4620,3400,0.264,1220,4010,"Ecc",-40,-2000,TRUE,TRUE,TRUE,35.88,"old",69,170,57,"f"
5,"LEG EXTENSION",2,"Ecc01",2800,2800,2750,2800,2800,2775,0.009,25,2787.5,"Ecc",0,-50,FALSE,FALSE,FALSE,0.9,"old",69,170,57,"f"
5,"LEG EXTENSION",2,"Ecc02",2100,2080,2050,2150,2090,2100,0.005,-10,2095,"Ecc",20,-100,FALSE,FALSE,FALSE,0.48,"old",69,170,57,"f"
5,"LEG EXTENSION",2,"Ecc03",2360,2340,2350,2300,2350,2325,0.011,25,2337.5,"Ecc",20,50,FALSE,FALSE,FALSE,1.08,"old",69,170,57,"f"
5,"LEG EXTENSION",2,"Ecc04",2060,2060,2050,2050,2060,2050,0.005,10,2055,"Ecc",0,0,FALSE,FALSE,FALSE,0.49,"old",69,170,57,"f"
5,"LEG EXTENSION",2,"Ecc05",2160,2140,2000,2000,2150,2000,0.07,150,2075,"Ecc",20,0,FALSE,FALSE,FALSE,7.5,"old",69,170,57,"f"
5,"LEG EXTENSION",2,"Ecc06",2180,2140,2050,2050,2160,2050,0.051,110,2105,"Ecc",40,0,FALSE,TRUE,FALSE,5.37,"old",69,170,57,"f"
5,"LEG EXTENSION",2,"Ecc07",2520,2480,2250,2350,2500,2300,0.08,200,2400,"Ecc",40,-100,TRUE,TRUE,FALSE,8.7,"old",69,170,57,"f"
5,"LEG EXTENSION",2,"Ecc08",2180,2200,2050,2050,2190,2050,0.064,140,2120,"Ecc",-20,0,FALSE,FALSE,FALSE,6.83,"old",69,170,57,"f"
5,"LEG EXTENSION",2,"Ecc09",2740,2720,2300,2150,2730,2225,0.185,505,2477.5,"Ecc",20,150,TRUE,FALSE,FALSE,22.7,"old",69,170,57,"f"
5,"LEG EXTENSION",2,"Ecc10",2780,2780,2650,2150,2780,2400,0.137,380,2590,"Ecc",0,500,TRUE,FALSE,TRUE,15.83,"old",69,170,57,"f"
5,"LEG EXTENSION",1,"Rep01",5740,5720,5800,5700,5730,5750,0.003,-20,5740,"Rep",20,100,FALSE,FALSE,FALSE,0.35,"old",69,170,57,"f"
5,"LEG EXTENSION",1,"Rep02",4640,4640,4550,4550,4640,4550,0.019,90,4595,"Rep",0,0,FALSE,FALSE,FALSE,1.98,"old",69,170,57,"f"
5,"LEG EXTENSION",1,"Rep03",3920,3920,3950,3800,3920,3875,0.011,45,3897.5,"Rep",0,150,FALSE,FALSE,FALSE,1.16,"old",69,170,57,"f"
5,"LEG EXTENSION",1,"Rep04",4040,4000,4100,4200,4020,4150,0.032,-130,4085,"Rep",40,-100,TRUE,FALSE,FALSE,3.13,"old",69,170,57,"f"
5,"LEG EXTENSION",1,"Rep05",4220,4240,4200,4250,4230,4225,0.001,5,4227.5,"Rep",-20,-50,FALSE,FALSE,FALSE,0.12,"old",69,170,57,"f"
5,"LEG EXTENSION",1,"Rep06",3680,3720,3650,3750,3700,3700,0,0,3700,"Rep",-40,-100,FALSE,FALSE,FALSE,0,"old",69,170,57,"f"
5,"LEG EXTENSION",1,"Rep07",3700,3680,3600,3550,3690,3575,0.031,115,3632.5,"Rep",20,50,TRUE,FALSE,FALSE,3.22,"old",69,170,57,"f"
5,"LEG EXTENSION",1,"Rep08",3680,3680,3450,3400,3680,3425,0.069,255,3552.5,"Rep",0,50,TRUE,FALSE,FALSE,7.45,"old",69,170,57,"f"
5,"LEG EXTENSION",1,"Rep09",4420,4400,4550,4350,4410,4450,0.009,-40,4430,"Rep",20,200,FALSE,FALSE,TRUE,0.9,"old",69,170,57,"f"
5,"LEG EXTENSION",1,"Rep10",5940,6020,4150,6350,5980,5250,0.122,730,5615,"Rep",-80,-2200,TRUE,TRUE,TRUE,13.9,"old",69,170,57,"f"
5,"LEG EXTENSION",2,"Rep01",5000,5020,4950,4900,5010,4925,0.017,85,4967.5,"Rep",-20,50,FALSE,FALSE,FALSE,1.73,"old",69,170,57,"f"
5,"LEG EXTENSION",2,"Rep02",3520,3500,3550,3550,3510,3550,0.011,-40,3530,"Rep",20,0,FALSE,FALSE,FALSE,1.13,"old",69,170,57,"f"
5,"LEG EXTENSION",2,"Rep03",3800,3800,3800,3750,3800,3775,0.007,25,3787.5,"Rep",0,50,FALSE,FALSE,FALSE,0.66,"old",69,170,57,"f"
5,"LEG EXTENSION",2,"Rep04",3560,3580,3600,3600,3570,3600,0.008,-30,3585,"Rep",-20,0,FALSE,FALSE,FALSE,0.83,"old",69,170,57,"f"
5,"LEG EXTENSION",2,"Rep05",3620,3620,3500,3500,3620,3500,0.033,120,3560,"Rep",0,0,TRUE,FALSE,FALSE,3.43,"old",69,170,57,"f"
5,"LEG EXTENSION",2,"Rep06",3420,3400,3450,3450,3410,3450,0.012,-40,3430,"Rep",20,0,FALSE,FALSE,FALSE,1.16,"old",69,170,57,"f"
5,"LEG EXTENSION",2,"Rep07",3940,3920,3900,3950,3930,3925,0.001,5,3927.5,"Rep",20,-50,FALSE,FALSE,FALSE,0.13,"old",69,170,57,"f"
5,"LEG EXTENSION",2,"Rep08",3440,3500,3500,3450,3470,3475,0.001,-5,3472.5,"Rep",-60,50,FALSE,FALSE,FALSE,0.14,"old",69,170,57,"f"
5,"LEG EXTENSION",2,"Rep09",4040,4000,3750,3600,4020,3675,0.086,345,3847.5,"Rep",40,150,TRUE,FALSE,FALSE,9.39,"old",69,170,57,"f"
5,"LEG EXTENSION",2,"Rep10",4020,4040,4350,4000,4030,4175,0.036,-145,4102.5,"Rep",-20,350,TRUE,FALSE,TRUE,3.47,"old",69,170,57,"f"
5,"LEG EXTENSION",1,"TuT",43980,44020,42000,43900,44000,42950,0.024,1050,43475,"TuT",-40,-1900,TRUE,FALSE,TRUE,2.44,"old",69,170,57,"f"
5,"LEG EXTENSION",2,"TuT",38360,38380,38350,37750,38370,38050,0.008,320,38210,"TuT",-20,600,TRUE,FALSE,TRUE,0.84,"old",69,170,57,"f"
5,"LEG CURL",1,"Con01",3320,3340,2350,2400,3330,2375,0.287,955,2852.5,"Con",-20,-50,TRUE,FALSE,FALSE,40.21,"old",69,170,57,"f"
5,"LEG CURL",1,"Con02",2000,2020,1950,1850,2010,1900,0.055,110,1955,"Con",-20,100,FALSE,FALSE,FALSE,5.79,"old",69,170,57,"f"
5,"LEG CURL",1,"Con03",2000,2000,2000,1850,2000,1925,0.038,75,1962.5,"Con",0,150,FALSE,FALSE,FALSE,3.9,"old",69,170,57,"f"
5,"LEG CURL",1,"Con04",2480,2500,2300,2150,2490,2225,0.106,265,2357.5,"Con",-20,150,TRUE,FALSE,FALSE,11.91,"old",69,170,57,"f"
5,"LEG CURL",1,"Con05",2280,2320,2450,2450,2300,2450,0.065,-150,2375,"Con",-40,0,FALSE,FALSE,FALSE,6.12,"old",69,170,57,"f"
5,"LEG CURL",1,"Con06",2200,2160,2150,2300,2180,2225,0.021,-45,2202.5,"Con",40,-150,FALSE,FALSE,FALSE,2.02,"old",69,170,57,"f"
5,"LEG CURL",1,"Con07",2200,2240,2250,2400,2220,2325,0.047,-105,2272.5,"Con",-40,-150,FALSE,FALSE,FALSE,4.52,"old",69,170,57,"f"
5,"LEG CURL",1,"Con08",2180,2200,2250,2450,2190,2350,0.073,-160,2270,"Con",-20,-200,FALSE,FALSE,TRUE,6.81,"old",69,170,57,"f"
5,"LEG CURL",1,"Con09",1940,1960,2600,2700,1950,2650,0.359,-700,2300,"Con",-20,-100,TRUE,FALSE,FALSE,26.42,"old",69,170,57,"f"
5,"LEG CURL",1,"Con10",2220,2240,3450,3550,2230,3500,0.57,-1270,2865,"Con",-20,-100,TRUE,FALSE,FALSE,36.29,"old",69,170,57,"f"
5,"LEG CURL",2,"Con01",3100,3080,3050,3150,3090,3100,0.003,-10,3095,"Con",20,-100,FALSE,FALSE,FALSE,0.32,"old",69,170,57,"f"
5,"LEG CURL",2,"Con02",2500,2480,2550,2600,2490,2575,0.034,-85,2532.5,"Con",20,-50,FALSE,FALSE,FALSE,3.3,"old",69,170,57,"f"
5,"LEG CURL",2,"Con03",2520,2500,2650,2550,2510,2600,0.036,-90,2555,"Con",20,100,FALSE,FALSE,FALSE,3.46,"old",69,170,57,"f"
5,"LEG CURL",2,"Con04",2060,2000,2050,2000,2030,2025,0.002,5,2027.5,"Con",60,50,FALSE,FALSE,FALSE,0.25,"old",69,170,57,"f"
5,"LEG CURL",2,"Con05",2360,2360,2300,2400,2360,2350,0.004,10,2355,"Con",0,-100,FALSE,FALSE,FALSE,0.43,"old",69,170,57,"f"
5,"LEG CURL",2,"Con06",2400,2440,2500,2750,2420,2625,0.085,-205,2522.5,"Con",-40,-250,FALSE,FALSE,TRUE,7.81,"old",69,170,57,"f"
5,"LEG CURL",2,"Con07",2380,2380,2500,2600,2380,2550,0.071,-170,2465,"Con",0,-100,FALSE,FALSE,FALSE,6.67,"old",69,170,57,"f"
5,"LEG CURL",2,"Con08",2300,2280,2550,2400,2290,2475,0.081,-185,2382.5,"Con",20,150,FALSE,FALSE,FALSE,7.47,"old",69,170,57,"f"
5,"LEG CURL",2,"Con09",2100,2080,2550,2250,2090,2400,0.148,-310,2245,"Con",20,300,TRUE,FALSE,TRUE,12.92,"old",69,170,57,"f"
5,"LEG CURL",2,"Con10",1940,1960,2300,2350,1950,2325,0.192,-375,2137.5,"Con",-20,-50,TRUE,FALSE,FALSE,16.13,"old",69,170,57,"f"
5,"LEG CURL",1,"Ecc01",3140,3140,3000,3050,3140,3025,0.037,115,3082.5,"Ecc",0,-50,FALSE,FALSE,FALSE,3.8,"old",69,170,57,"f"
5,"LEG CURL",1,"Ecc02",2920,2900,3050,3100,2910,3075,0.057,-165,2992.5,"Ecc",20,-50,FALSE,FALSE,FALSE,5.37,"old",69,170,57,"f"
5,"LEG CURL",1,"Ecc03",2160,2160,2400,2700,2160,2550,0.181,-390,2355,"Ecc",0,-300,TRUE,FALSE,TRUE,15.29,"old",69,170,57,"f"
5,"LEG CURL",1,"Ecc04",2560,2540,2450,2450,2550,2450,0.039,100,2500,"Ecc",20,0,FALSE,FALSE,FALSE,4.08,"old",69,170,57,"f"
5,"LEG CURL",1,"Ecc05",2400,2400,2300,2200,2400,2250,0.062,150,2325,"Ecc",0,100,FALSE,FALSE,FALSE,6.67,"old",69,170,57,"f"
5,"LEG CURL",1,"Ecc06",2620,2580,2600,2500,2600,2550,0.019,50,2575,"Ecc",40,100,FALSE,FALSE,FALSE,1.96,"old",69,170,57,"f"
5,"LEG CURL",1,"Ecc07",2400,2380,2500,2250,2390,2375,0.006,15,2382.5,"Ecc",20,250,FALSE,FALSE,TRUE,0.63,"old",69,170,57,"f"
5,"LEG CURL",1,"Ecc08",2540,2520,2050,1950,2530,2000,0.209,530,2265,"Ecc",20,100,TRUE,FALSE,FALSE,26.5,"old",69,170,57,"f"
5,"LEG CURL",1,"Ecc09",2900,2880,1900,1700,2890,1800,0.377,1090,2345,"Ecc",20,200,TRUE,FALSE,TRUE,60.56,"old",69,170,57,"f"
5,"LEG CURL",1,"Ecc10",3580,3540,2950,3000,3560,2975,0.164,585,3267.5,"Ecc",40,-50,TRUE,FALSE,FALSE,19.66,"old",69,170,57,"f"
5,"LEG CURL",2,"Ecc01",2620,2640,2600,2400,2630,2500,0.049,130,2565,"Ecc",-20,200,FALSE,FALSE,TRUE,5.2,"old",69,170,57,"f"
5,"LEG CURL",2,"Ecc02",2460,2480,2300,2450,2470,2375,0.038,95,2422.5,"Ecc",-20,-150,FALSE,FALSE,FALSE,4,"old",69,170,57,"f"
5,"LEG CURL",2,"Ecc03",2640,2700,2650,2750,2670,2700,0.011,-30,2685,"Ecc",-60,-100,FALSE,FALSE,FALSE,1.11,"old",69,170,57,"f"
5,"LEG CURL",2,"Ecc04",2580,2580,2500,2500,2580,2500,0.031,80,2540,"Ecc",0,0,FALSE,FALSE,FALSE,3.2,"old",69,170,57,"f"
5,"LEG CURL",2,"Ecc05",2700,2680,2800,2600,2690,2700,0.004,-10,2695,"Ecc",20,200,FALSE,FALSE,TRUE,0.37,"old",69,170,57,"f"
5,"LEG CURL",2,"Ecc06",2220,2200,2000,1800,2210,1900,0.14,310,2055,"Ecc",20,200,TRUE,FALSE,TRUE,16.32,"old",69,170,57,"f"
5,"LEG CURL",2,"Ecc07",2720,2720,2600,2550,2720,2575,0.053,145,2647.5,"Ecc",0,50,FALSE,FALSE,FALSE,5.63,"old",69,170,57,"f"
5,"LEG CURL",2,"Ecc08",2740,2760,2200,2650,2750,2425,0.118,325,2587.5,"Ecc",-20,-450,TRUE,FALSE,TRUE,13.4,"old",69,170,57,"f"
5,"LEG CURL",2,"Ecc09",3080,3080,2800,2800,3080,2800,0.091,280,2940,"Ecc",0,0,TRUE,FALSE,FALSE,10,"old",69,170,57,"f"
5,"LEG CURL",2,"Ecc10",3560,3560,3400,3400,3560,3400,0.045,160,3480,"Ecc",0,0,FALSE,FALSE,FALSE,4.71,"old",69,170,57,"f"
5,"LEG CURL",1,"Rep01",6460,6480,5350,5450,6470,5400,0.165,1070,5935,"Rep",-20,-100,TRUE,FALSE,FALSE,19.81,"old",69,170,57,"f"
5,"LEG CURL",1,"Rep02",4920,4920,5000,4950,4920,4975,0.011,-55,4947.5,"Rep",0,50,FALSE,FALSE,FALSE,1.11,"old",69,170,57,"f"
5,"LEG CURL",1,"Rep03",4160,4160,4400,4550,4160,4475,0.076,-315,4317.5,"Rep",0,-150,TRUE,FALSE,FALSE,7.04,"old",69,170,57,"f"
5,"LEG CURL",1,"Rep04",5040,5040,4750,4600,5040,4675,0.072,365,4857.5,"Rep",0,150,TRUE,FALSE,FALSE,7.81,"old",69,170,57,"f"
5,"LEG CURL",1,"Rep05",4680,4720,4750,4650,4700,4700,0,0,4700,"Rep",-40,100,FALSE,FALSE,FALSE,0,"old",69,170,57,"f"
5,"LEG CURL",1,"Rep06",4820,4740,4750,4800,4780,4775,0.001,5,4777.5,"Rep",80,-50,FALSE,TRUE,FALSE,0.1,"old",69,170,57,"f"
5,"LEG CURL",1,"Rep07",4600,4620,4750,4650,4610,4700,0.02,-90,4655,"Rep",-20,100,FALSE,FALSE,FALSE,1.91,"old",69,170,57,"f"
5,"LEG CURL",1,"Rep08",4720,4720,4300,4400,4720,4350,0.078,370,4535,"Rep",0,-100,TRUE,FALSE,FALSE,8.51,"old",69,170,57,"f"
5,"LEG CURL",1,"Rep09",4840,4840,4500,4400,4840,4450,0.081,390,4645,"Rep",0,100,TRUE,FALSE,FALSE,8.76,"old",69,170,57,"f"
5,"LEG CURL",1,"Rep10",5800,5780,6400,6550,5790,6475,0.118,-685,6132.5,"Rep",20,-150,TRUE,FALSE,FALSE,10.58,"old",69,170,57,"f"
5,"LEG CURL",2,"Rep01",5720,5720,5650,5550,5720,5600,0.021,120,5660,"Rep",0,100,FALSE,FALSE,FALSE,2.14,"old",69,170,57,"f"
5,"LEG CURL",2,"Rep02",4960,4960,4850,5050,4960,4950,0.002,10,4955,"Rep",0,-200,FALSE,FALSE,TRUE,0.2,"old",69,170,57,"f"
5,"LEG CURL",2,"Rep03",5160,5200,5300,5300,5180,5300,0.023,-120,5240,"Rep",-40,0,FALSE,FALSE,FALSE,2.26,"old",69,170,57,"f"
5,"LEG CURL",2,"Rep04",4640,4580,4550,4500,4610,4525,0.018,85,4567.5,"Rep",60,50,FALSE,FALSE,FALSE,1.88,"old",69,170,57,"f"
5,"LEG CURL",2,"Rep05",5060,5040,5100,5000,5050,5050,0,0,5050,"Rep",20,100,FALSE,FALSE,FALSE,0,"old",69,170,57,"f"
5,"LEG CURL",2,"Rep06",4620,4640,4500,4550,4630,4525,0.023,105,4577.5,"Rep",-20,-50,FALSE,FALSE,FALSE,2.32,"old",69,170,57,"f"
5,"LEG CURL",2,"Rep07",5100,5100,5100,5150,5100,5125,0.005,-25,5112.5,"Rep",0,-50,FALSE,FALSE,FALSE,0.49,"old",69,170,57,"f"
5,"LEG CURL",2,"Rep08",5040,5040,4750,5050,5040,4900,0.028,140,4970,"Rep",0,-300,FALSE,FALSE,TRUE,2.86,"old",69,170,57,"f"
5,"LEG CURL",2,"Rep09",5180,5160,5350,5050,5170,5200,0.006,-30,5185,"Rep",20,300,FALSE,FALSE,TRUE,0.58,"old",69,170,57,"f"
5,"LEG CURL",2,"Rep10",5500,5520,5700,5750,5510,5725,0.039,-215,5617.5,"Rep",-20,-50,TRUE,FALSE,FALSE,3.76,"old",69,170,57,"f"
5,"LEG CURL",1,"TuT",50040,50020,48950,49000,50030,48975,0.021,1055,49502.5,"TuT",20,-50,TRUE,FALSE,FALSE,2.15,"old",69,170,57,"f"
5,"LEG CURL",2,"TuT",50980,50960,50850,50950,50970,50900,0.001,70,50935,"TuT",20,-100,FALSE,FALSE,FALSE,0.14,"old",69,170,57,"f"
5,"ABDUCTOR",1,"Con01",1420,1460,1750,1550,1440,1650,0.146,-210,1545,"Con",-40,200,FALSE,TRUE,FALSE,12.73,"old",69,170,57,"f"
5,"ABDUCTOR",1,"Con02",1400,1440,1300,1650,1420,1475,0.039,-55,1447.5,"Con",-40,-350,FALSE,TRUE,TRUE,3.73,"old",69,170,57,"f"
5,"ABDUCTOR",1,"Con03",1660,1660,1550,1550,1660,1550,0.066,110,1605,"Con",0,0,FALSE,FALSE,FALSE,7.1,"old",69,170,57,"f"
5,"ABDUCTOR",1,"Con04",1040,1100,1600,1200,1070,1400,0.308,-330,1235,"Con",-60,400,TRUE,TRUE,TRUE,23.57,"old",69,170,57,"f"
5,"ABDUCTOR",1,"Con05",1000,1020,1250,1100,1010,1175,0.163,-165,1092.5,"Con",-20,150,FALSE,FALSE,FALSE,14.04,"old",69,170,57,"f"
5,"ABDUCTOR",1,"Con06",1040,1060,950,1000,1050,975,0.071,75,1012.5,"Con",-20,-50,FALSE,FALSE,FALSE,7.69,"old",69,170,57,"f"
5,"ABDUCTOR",1,"Con07",880,920,1000,1150,900,1075,0.194,-175,987.5,"Con",-40,-150,FALSE,TRUE,FALSE,16.28,"old",69,170,57,"f"
5,"ABDUCTOR",1,"Con08",860,880,950,1600,870,1275,0.466,-405,1072.5,"Con",-20,-650,TRUE,FALSE,TRUE,31.76,"old",69,170,57,"f"
5,"ABDUCTOR",1,"Con09",860,900,1350,1200,880,1275,0.449,-395,1077.5,"Con",-40,150,TRUE,TRUE,FALSE,30.98,"old",69,170,57,"f"
5,"ABDUCTOR",1,"Con10",880,920,1550,1400,900,1475,0.639,-575,1187.5,"Con",-40,150,TRUE,TRUE,FALSE,38.98,"old",69,170,57,"f"
5,"ABDUCTOR",2,"Con01",1080,1080,1300,1650,1080,1475,0.366,-395,1277.5,"Con",0,-350,TRUE,FALSE,TRUE,26.78,"old",69,170,57,"f"
5,"ABDUCTOR",2,"Con02",900,940,950,1700,920,1325,0.44,-405,1122.5,"Con",-40,-750,TRUE,TRUE,TRUE,30.57,"old",69,170,57,"f"
5,"ABDUCTOR",2,"Con03",920,900,900,800,910,850,0.066,60,880,"Con",20,100,FALSE,FALSE,FALSE,7.06,"old",69,170,57,"f"
5,"ABDUCTOR",2,"Con04",1120,1140,1200,1150,1130,1175,0.04,-45,1152.5,"Con",-20,50,FALSE,FALSE,FALSE,3.83,"old",69,170,57,"f"
5,"ABDUCTOR",2,"Con05",920,960,1150,1150,940,1150,0.223,-210,1045,"Con",-40,0,FALSE,TRUE,FALSE,18.26,"old",69,170,57,"f"
5,"ABDUCTOR",2,"Con06",880,900,1200,1100,890,1150,0.292,-260,1020,"Con",-20,100,FALSE,FALSE,FALSE,22.61,"old",69,170,57,"f"
5,"ABDUCTOR",2,"Con07",900,920,1200,1500,910,1350,0.484,-440,1130,"Con",-20,-300,TRUE,FALSE,TRUE,32.59,"old",69,170,57,"f"
5,"ABDUCTOR",2,"Con08",820,880,950,1650,850,1300,0.529,-450,1075,"Con",-60,-700,TRUE,TRUE,TRUE,34.62,"old",69,170,57,"f"
5,"ABDUCTOR",2,"Con09",920,960,1100,1200,940,1150,0.223,-210,1045,"Con",-40,-100,FALSE,TRUE,FALSE,18.26,"old",69,170,57,"f"
5,"ABDUCTOR",2,"Con10",940,940,1250,1200,940,1225,0.303,-285,1082.5,"Con",0,50,FALSE,FALSE,FALSE,23.27,"old",69,170,57,"f"
5,"ABDUCTOR",1,"Ecc01",1760,1720,1800,1500,1740,1650,0.052,90,1695,"Ecc",40,300,FALSE,TRUE,FALSE,5.45,"old",69,170,57,"f"
5,"ABDUCTOR",1,"Ecc02",2460,2400,2500,2450,2430,2475,0.019,-45,2452.5,"Ecc",60,50,FALSE,TRUE,FALSE,1.82,"old",69,170,57,"f"
5,"ABDUCTOR",1,"Ecc03",2240,2240,1750,2100,2240,1925,0.141,315,2082.5,"Ecc",0,-350,TRUE,FALSE,TRUE,16.36,"old",69,170,57,"f"
5,"ABDUCTOR",1,"Ecc04",1840,1800,1550,1750,1820,1650,0.093,170,1735,"Ecc",40,-200,FALSE,TRUE,FALSE,10.3,"old",69,170,57,"f"
5,"ABDUCTOR",1,"Ecc05",1820,1800,1850,1800,1810,1825,0.008,-15,1817.5,"Ecc",20,50,FALSE,FALSE,FALSE,0.82,"old",69,170,57,"f"
5,"ABDUCTOR",1,"Ecc06",1780,1760,1750,1600,1770,1675,0.054,95,1722.5,"Ecc",20,150,FALSE,FALSE,FALSE,5.67,"old",69,170,57,"f"
5,"ABDUCTOR",1,"Ecc07",2040,2000,1950,1250,2020,1600,0.208,420,1810,"Ecc",40,700,TRUE,TRUE,TRUE,26.25,"old",69,170,57,"f"
5,"ABDUCTOR",1,"Ecc08",2380,2360,1900,2100,2370,2000,0.156,370,2185,"Ecc",20,-200,TRUE,FALSE,FALSE,18.5,"old",69,170,57,"f"
5,"ABDUCTOR",1,"Ecc09",1760,1720,1100,1250,1740,1175,0.325,565,1457.5,"Ecc",40,-150,TRUE,TRUE,FALSE,48.09,"old",69,170,57,"f"
5,"ABDUCTOR",1,"Ecc10",2080,2080,1650,2050,2080,1850,0.111,230,1965,"Ecc",0,-400,FALSE,FALSE,TRUE,12.43,"old",69,170,57,"f"
5,"ABDUCTOR",2,"Ecc01",2320,2280,2150,1400,2300,1775,0.228,525,2037.5,"Ecc",40,750,TRUE,TRUE,TRUE,29.58,"old",69,170,57,"f"
5,"ABDUCTOR",2,"Ecc02",2020,2020,2000,2050,2020,2025,0.002,-5,2022.5,"Ecc",0,-50,FALSE,FALSE,FALSE,0.25,"old",69,170,57,"f"
5,"ABDUCTOR",2,"Ecc03",1860,1860,1850,1950,1860,1900,0.022,-40,1880,"Ecc",0,-100,FALSE,FALSE,FALSE,2.11,"old",69,170,57,"f"
5,"ABDUCTOR",2,"Ecc04",2060,2040,1850,1850,2050,1850,0.098,200,1950,"Ecc",20,0,FALSE,FALSE,FALSE,10.81,"old",69,170,57,"f"
5,"ABDUCTOR",2,"Ecc05",1960,1920,1650,1750,1940,1700,0.124,240,1820,"Ecc",40,-100,FALSE,TRUE,FALSE,14.12,"old",69,170,57,"f"
5,"ABDUCTOR",2,"Ecc06",2020,2000,1750,1450,2010,1600,0.204,410,1805,"Ecc",20,300,TRUE,FALSE,FALSE,25.62,"old",69,170,57,"f"
5,"ABDUCTOR",2,"Ecc07",2080,2040,1900,1250,2060,1575,0.235,485,1817.5,"Ecc",40,650,TRUE,TRUE,TRUE,30.79,"old",69,170,57,"f"
5,"ABDUCTOR",2,"Ecc08",1960,1900,1800,1650,1930,1725,0.106,205,1827.5,"Ecc",60,150,FALSE,TRUE,FALSE,11.88,"old",69,170,57,"f"
5,"ABDUCTOR",2,"Ecc09",1860,1860,1550,1600,1860,1575,0.153,285,1717.5,"Ecc",0,-50,FALSE,FALSE,FALSE,18.1,"old",69,170,57,"f"
5,"ABDUCTOR",2,"Ecc10",2680,2680,2700,2650,2680,2675,0.002,5,2677.5,"Ecc",0,50,FALSE,FALSE,FALSE,0.19,"old",69,170,57,"f"
5,"ABDUCTOR",1,"Rep01",3180,3180,3550,3050,3180,3300,0.038,-120,3240,"Rep",0,500,FALSE,FALSE,TRUE,3.64,"old",69,170,57,"f"
5,"ABDUCTOR",1,"Rep02",3860,3840,3800,4100,3850,3950,0.026,-100,3900,"Rep",20,-300,FALSE,FALSE,FALSE,2.53,"old",69,170,57,"f"
5,"ABDUCTOR",1,"Rep03",3900,3900,3300,3650,3900,3475,0.109,425,3687.5,"Rep",0,-350,TRUE,FALSE,TRUE,12.23,"old",69,170,57,"f"
5,"ABDUCTOR",1,"Rep04",2880,2900,3150,2950,2890,3050,0.055,-160,2970,"Rep",-20,200,FALSE,FALSE,FALSE,5.25,"old",69,170,57,"f"
5,"ABDUCTOR",1,"Rep05",2820,2820,3100,2900,2820,3000,0.064,-180,2910,"Rep",0,200,FALSE,FALSE,FALSE,6,"old",69,170,57,"f"
5,"ABDUCTOR",1,"Rep06",2820,2820,2700,2600,2820,2650,0.06,170,2735,"Rep",0,100,FALSE,FALSE,FALSE,6.42,"old",69,170,57,"f"
5,"ABDUCTOR",1,"Rep07",2920,2920,2950,2400,2920,2675,0.084,245,2797.5,"Rep",0,550,FALSE,FALSE,TRUE,9.16,"old",69,170,57,"f"
5,"ABDUCTOR",1,"Rep08",3240,3240,2850,3700,3240,3275,0.011,-35,3257.5,"Rep",0,-850,FALSE,FALSE,TRUE,1.07,"old",69,170,57,"f"
5,"ABDUCTOR",1,"Rep09",2620,2620,2450,2450,2620,2450,0.065,170,2535,"Rep",0,0,FALSE,FALSE,FALSE,6.94,"old",69,170,57,"f"
5,"ABDUCTOR",1,"Rep10",2960,3000,3200,3450,2980,3325,0.116,-345,3152.5,"Rep",-40,-250,TRUE,FALSE,FALSE,10.38,"old",69,170,57,"f"
5,"ABDUCTOR",2,"Rep01",3400,3360,3450,3050,3380,3250,0.038,130,3315,"Rep",40,400,FALSE,FALSE,TRUE,4,"old",69,170,57,"f"
5,"ABDUCTOR",2,"Rep02",2920,2960,2950,3750,2940,3350,0.139,-410,3145,"Rep",-40,-800,TRUE,FALSE,TRUE,12.24,"old",69,170,57,"f"
5,"ABDUCTOR",2,"Rep03",2780,2760,2750,2750,2770,2750,0.007,20,2760,"Rep",20,0,FALSE,FALSE,FALSE,0.73,"old",69,170,57,"f"
5,"ABDUCTOR",2,"Rep04",3180,3180,3050,3000,3180,3025,0.049,155,3102.5,"Rep",0,50,FALSE,FALSE,FALSE,5.12,"old",69,170,57,"f"
5,"ABDUCTOR",2,"Rep05",2880,2880,2800,2900,2880,2850,0.01,30,2865,"Rep",0,-100,FALSE,FALSE,FALSE,1.05,"old",69,170,57,"f"
5,"ABDUCTOR",2,"Rep06",2900,2900,2950,2550,2900,2750,0.052,150,2825,"Rep",0,400,FALSE,FALSE,TRUE,5.45,"old",69,170,57,"f"
5,"ABDUCTOR",2,"Rep07",2980,2960,3100,2750,2970,2925,0.015,45,2947.5,"Rep",20,350,FALSE,FALSE,TRUE,1.54,"old",69,170,57,"f"
5,"ABDUCTOR",2,"Rep08",2780,2780,2750,3300,2780,3025,0.088,-245,2902.5,"Rep",0,-550,FALSE,FALSE,TRUE,8.1,"old",69,170,57,"f"
5,"ABDUCTOR",2,"Rep09",2780,2820,2650,2800,2800,2725,0.027,75,2762.5,"Rep",-40,-150,FALSE,FALSE,FALSE,2.75,"old",69,170,57,"f"
5,"ABDUCTOR",2,"Rep10",3620,3620,3950,3850,3620,3900,0.077,-280,3760,"Rep",0,100,FALSE,FALSE,FALSE,7.18,"old",69,170,57,"f"
5,"ABDUCTOR",1,"TuT",31200,31240,31050,31250,31220,31150,0.002,70,31185,"TuT",-40,-200,FALSE,TRUE,FALSE,0.22,"old",69,170,57,"f"
5,"ABDUCTOR",2,"TuT",30220,30220,30400,30700,30220,30550,0.011,-330,30385,"TuT",0,-300,FALSE,FALSE,FALSE,1.08,"old",69,170,57,"f"
5,"ADDUCTOR",1,"Con01",1100,1120,1850,1700,1110,1775,0.599,-665,1442.5,"Con",-20,150,TRUE,FALSE,FALSE,37.46,"old",69,170,57,"f"
5,"ADDUCTOR",1,"Con02",1020,1020,1100,950,1020,1025,0.005,-5,1022.5,"Con",0,150,FALSE,FALSE,FALSE,0.49,"old",69,170,57,"f"
5,"ADDUCTOR",1,"Con03",1020,1040,1400,1300,1030,1350,0.311,-320,1190,"Con",-20,100,FALSE,FALSE,FALSE,23.7,"old",69,170,57,"f"
5,"ADDUCTOR",1,"Con04",1040,1060,1500,1400,1050,1450,0.381,-400,1250,"Con",-20,100,FALSE,FALSE,FALSE,27.59,"old",69,170,57,"f"
5,"ADDUCTOR",1,"Con05",1180,1200,1300,1550,1190,1425,0.197,-235,1307.5,"Con",-20,-250,FALSE,FALSE,FALSE,16.49,"old",69,170,57,"f"
5,"ADDUCTOR",1,"Con06",980,1000,950,1150,990,1050,0.061,-60,1020,"Con",-20,-200,FALSE,FALSE,FALSE,5.71,"old",69,170,57,"f"
5,"ADDUCTOR",1,"Con07",1020,1020,1050,850,1020,950,0.069,70,985,"Con",0,200,FALSE,FALSE,FALSE,7.37,"old",69,170,57,"f"
5,"ADDUCTOR",1,"Con08",1120,1140,1400,1150,1130,1275,0.128,-145,1202.5,"Con",-20,250,FALSE,FALSE,FALSE,11.37,"old",69,170,57,"f"
5,"ADDUCTOR",1,"Con09",1000,1020,1300,1250,1010,1275,0.262,-265,1142.5,"Con",-20,50,FALSE,FALSE,FALSE,20.78,"old",69,170,57,"f"
5,"ADDUCTOR",1,"Con10",980,1000,4300,5000,990,4650,3.697,-3660,2820,"Con",-20,-700,TRUE,FALSE,TRUE,78.71,"old",69,170,57,"f"
5,"ADDUCTOR",2,"Con01",760,760,1400,1200,760,1300,0.711,-540,1030,"Con",0,200,FALSE,FALSE,FALSE,41.54,"old",69,170,57,"f"
5,"ADDUCTOR",2,"Con02",1020,1040,900,850,1030,875,0.15,155,952.5,"Con",-20,50,FALSE,FALSE,FALSE,17.71,"old",69,170,57,"f"
5,"ADDUCTOR",2,"Con03",1020,1020,850,850,1020,850,0.167,170,935,"Con",0,0,FALSE,FALSE,FALSE,20,"old",69,170,57,"f"
5,"ADDUCTOR",2,"Con04",1040,1080,1050,1000,1060,1025,0.033,35,1042.5,"Con",-40,50,FALSE,TRUE,FALSE,3.41,"old",69,170,57,"f"
5,"ADDUCTOR",2,"Con05",1300,1320,1400,1350,1310,1375,0.05,-65,1342.5,"Con",-20,50,FALSE,FALSE,FALSE,4.73,"old",69,170,57,"f"
5,"ADDUCTOR",2,"Con06",1180,1180,1600,1400,1180,1500,0.271,-320,1340,"Con",0,200,FALSE,FALSE,FALSE,21.33,"old",69,170,57,"f"
5,"ADDUCTOR",2,"Con07",1000,1020,1300,1150,1010,1225,0.213,-215,1117.5,"Con",-20,150,FALSE,FALSE,FALSE,17.55,"old",69,170,57,"f"
5,"ADDUCTOR",2,"Con08",1000,1040,1250,1200,1020,1225,0.201,-205,1122.5,"Con",-40,50,FALSE,TRUE,FALSE,16.73,"old",69,170,57,"f"
5,"ADDUCTOR",2,"Con09",1140,1100,1400,1700,1120,1550,0.384,-430,1335,"Con",40,-300,FALSE,TRUE,FALSE,27.74,"old",69,170,57,"f"
5,"ADDUCTOR",2,"Con10",1060,1100,1200,1500,1080,1350,0.25,-270,1215,"Con",-40,-300,FALSE,TRUE,FALSE,20,"old",69,170,57,"f"
5,"ADDUCTOR",1,"Ecc01",2460,2460,1800,2100,2460,1950,0.207,510,2205,"Ecc",0,-300,FALSE,FALSE,FALSE,26.15,"old",69,170,57,"f"
5,"ADDUCTOR",1,"Ecc02",1940,1920,1750,1850,1930,1800,0.067,130,1865,"Ecc",20,-100,FALSE,FALSE,FALSE,7.22,"old",69,170,57,"f"
5,"ADDUCTOR",1,"Ecc03",1980,1960,1450,1550,1970,1500,0.239,470,1735,"Ecc",20,-100,FALSE,FALSE,FALSE,31.33,"old",69,170,57,"f"
5,"ADDUCTOR",1,"Ecc04",1720,1720,1350,1350,1720,1350,0.215,370,1535,"Ecc",0,0,FALSE,FALSE,FALSE,27.41,"old",69,170,57,"f"
5,"ADDUCTOR",1,"Ecc05",1780,1740,1800,1550,1760,1675,0.048,85,1717.5,"Ecc",40,250,FALSE,TRUE,FALSE,5.07,"old",69,170,57,"f"
5,"ADDUCTOR",1,"Ecc06",1820,1820,1900,1700,1820,1800,0.011,20,1810,"Ecc",0,200,FALSE,FALSE,FALSE,1.11,"old",69,170,57,"f"
5,"ADDUCTOR",1,"Ecc07",2040,2020,1800,2200,2030,2000,0.015,30,2015,"Ecc",20,-400,FALSE,FALSE,TRUE,1.5,"old",69,170,57,"f"
5,"ADDUCTOR",1,"Ecc08",2100,2080,1900,2050,2090,1975,0.055,115,2032.5,"Ecc",20,-150,FALSE,FALSE,FALSE,5.82,"old",69,170,57,"f"
5,"ADDUCTOR",1,"Ecc09",2000,1980,1250,1250,1990,1250,0.372,740,1620,"Ecc",20,0,TRUE,FALSE,FALSE,59.2,"old",69,170,57,"f"
5,"ADDUCTOR",1,"Ecc10",2720,2740,1650,1700,2730,1675,0.386,1055,2202.5,"Ecc",-20,-50,TRUE,FALSE,FALSE,62.99,"old",69,170,57,"f"
5,"ADDUCTOR",2,"Ecc01",2240,2220,1900,1850,2230,1875,0.159,355,2052.5,"Ecc",20,50,FALSE,FALSE,FALSE,18.93,"old",69,170,57,"f"
5,"ADDUCTOR",2,"Ecc02",1700,1700,1850,1900,1700,1875,0.103,-175,1787.5,"Ecc",0,-50,FALSE,FALSE,FALSE,9.33,"old",69,170,57,"f"
5,"ADDUCTOR",2,"Ecc03",1580,1540,1700,1700,1560,1700,0.09,-140,1630,"Ecc",40,0,FALSE,TRUE,FALSE,8.24,"old",69,170,57,"f"
5,"ADDUCTOR",2,"Ecc04",1320,1300,1350,1400,1310,1375,0.05,-65,1342.5,"Ecc",20,-50,FALSE,FALSE,FALSE,4.73,"old",69,170,57,"f"
5,"ADDUCTOR",2,"Ecc05",1580,1580,1100,1300,1580,1200,0.241,380,1390,"Ecc",0,-200,FALSE,FALSE,FALSE,31.67,"old",69,170,57,"f"
5,"ADDUCTOR",2,"Ecc06",1460,1440,1150,1300,1450,1225,0.155,225,1337.5,"Ecc",20,-150,FALSE,FALSE,FALSE,18.37,"old",69,170,57,"f"
5,"ADDUCTOR",2,"Ecc07",1640,1620,1400,1500,1630,1450,0.11,180,1540,"Ecc",20,-100,FALSE,FALSE,FALSE,12.41,"old",69,170,57,"f"
5,"ADDUCTOR",2,"Ecc08",1640,1640,1400,1200,1640,1300,0.207,340,1470,"Ecc",0,200,FALSE,FALSE,FALSE,26.15,"old",69,170,57,"f"
5,"ADDUCTOR",2,"Ecc09",1580,1580,1400,1150,1580,1275,0.193,305,1427.5,"Ecc",0,250,FALSE,FALSE,FALSE,23.92,"old",69,170,57,"f"
5,"ADDUCTOR",2,"Ecc10",2380,2380,2300,2100,2380,2200,0.076,180,2290,"Ecc",0,200,FALSE,FALSE,FALSE,8.18,"old",69,170,57,"f"
5,"ADDUCTOR",1,"Rep01",3560,3580,3650,3800,3570,3725,0.043,-155,3647.5,"Rep",-20,-150,FALSE,FALSE,FALSE,4.16,"old",69,170,57,"f"
5,"ADDUCTOR",1,"Rep02",2960,2940,2850,2800,2950,2825,0.042,125,2887.5,"Rep",20,50,FALSE,FALSE,FALSE,4.42,"old",69,170,57,"f"
5,"ADDUCTOR",1,"Rep03",3000,3000,2850,2850,3000,2850,0.05,150,2925,"Rep",0,0,FALSE,FALSE,FALSE,5.26,"old",69,170,57,"f"
5,"ADDUCTOR",1,"Rep04",2760,2780,2850,2750,2770,2800,0.011,-30,2785,"Rep",-20,100,FALSE,FALSE,FALSE,1.07,"old",69,170,57,"f"
5,"ADDUCTOR",1,"Rep05",2960,2940,3100,3100,2950,3100,0.051,-150,3025,"Rep",20,0,FALSE,FALSE,FALSE,4.84,"old",69,170,57,"f"
5,"ADDUCTOR",1,"Rep06",2800,2820,2850,2850,2810,2850,0.014,-40,2830,"Rep",-20,0,FALSE,FALSE,FALSE,1.4,"old",69,170,57,"f"
5,"ADDUCTOR",1,"Rep07",3060,3040,2850,3050,3050,2950,0.033,100,3000,"Rep",20,-200,FALSE,FALSE,FALSE,3.39,"old",69,170,57,"f"
5,"ADDUCTOR",1,"Rep08",3220,3220,3300,3200,3220,3250,0.009,-30,3235,"Rep",0,100,FALSE,FALSE,FALSE,0.92,"old",69,170,57,"f"
5,"ADDUCTOR",1,"Rep09",3000,3000,2550,2500,3000,2525,0.158,475,2762.5,"Rep",0,50,TRUE,FALSE,FALSE,18.81,"old",69,170,57,"f"
5,"ADDUCTOR",1,"Rep10",3700,3740,5950,6700,3720,6325,0.7,-2605,5022.5,"Rep",-40,-750,TRUE,FALSE,TRUE,41.19,"old",69,170,57,"f"
5,"ADDUCTOR",2,"Rep01",3000,2980,3300,3050,2990,3175,0.062,-185,3082.5,"Rep",20,250,FALSE,FALSE,TRUE,5.83,"old",69,170,57,"f"
5,"ADDUCTOR",2,"Rep02",2720,2740,2750,2750,2730,2750,0.007,-20,2740,"Rep",-20,0,FALSE,FALSE,FALSE,0.73,"old",69,170,57,"f"
5,"ADDUCTOR",2,"Rep03",2600,2560,2550,2550,2580,2550,0.012,30,2565,"Rep",40,0,FALSE,FALSE,FALSE,1.18,"old",69,170,57,"f"
5,"ADDUCTOR",2,"Rep04",2360,2380,2400,2400,2370,2400,0.013,-30,2385,"Rep",-20,0,FALSE,FALSE,FALSE,1.25,"old",69,170,57,"f"
5,"ADDUCTOR",2,"Rep05",2880,2900,2500,2650,2890,2575,0.109,315,2732.5,"Rep",-20,-150,FALSE,FALSE,FALSE,12.23,"old",69,170,57,"f"
5,"ADDUCTOR",2,"Rep06",2640,2620,2750,2700,2630,2725,0.036,-95,2677.5,"Rep",20,50,FALSE,FALSE,FALSE,3.49,"old",69,170,57,"f"
5,"ADDUCTOR",2,"Rep07",2640,2640,2700,2650,2640,2675,0.013,-35,2657.5,"Rep",0,50,FALSE,FALSE,FALSE,1.31,"old",69,170,57,"f"
5,"ADDUCTOR",2,"Rep08",2640,2680,2650,2400,2660,2525,0.051,135,2592.5,"Rep",-40,250,FALSE,FALSE,TRUE,5.35,"old",69,170,57,"f"
5,"ADDUCTOR",2,"Rep09",2720,2680,2800,2850,2700,2825,0.046,-125,2762.5,"Rep",40,-50,FALSE,FALSE,FALSE,4.42,"old",69,170,57,"f"
5,"ADDUCTOR",2,"Rep10",3440,3480,3500,3600,3460,3550,0.026,-90,3505,"Rep",-40,-100,FALSE,FALSE,FALSE,2.54,"old",69,170,57,"f"
5,"ADDUCTOR",1,"TuT",31020,31060,32800,33600,31040,33200,0.07,-2160,32120,"TuT",-40,-800,TRUE,TRUE,TRUE,6.51,"old",69,170,57,"f"
5,"ADDUCTOR",2,"TuT",27640,27660,27900,27600,27650,27750,0.004,-100,27700,"TuT",-20,300,FALSE,FALSE,FALSE,0.36,"old",69,170,57,"f"
5,"LOWER BACK",1,"Con01",2300,2360,1850,2550,2330,2200,0.056,130,2265,"Con",-60,-700,FALSE,TRUE,TRUE,5.91,"old",69,170,57,"f"
5,"LOWER BACK",1,"Con02",1680,1700,1700,1650,1690,1675,0.009,15,1682.5,"Con",-20,50,FALSE,FALSE,FALSE,0.9,"old",69,170,57,"f"
5,"LOWER BACK",1,"Con03",1700,1700,1750,1750,1700,1750,0.029,-50,1725,"Con",0,0,FALSE,FALSE,FALSE,2.86,"old",69,170,57,"f"
5,"LOWER BACK",1,"Con04",1700,1720,1850,1900,1710,1875,0.096,-165,1792.5,"Con",-20,-50,FALSE,FALSE,FALSE,8.8,"old",69,170,57,"f"
5,"LOWER BACK",1,"Con05",1720,1760,1750,1850,1740,1800,0.034,-60,1770,"Con",-40,-100,FALSE,TRUE,FALSE,3.33,"old",69,170,57,"f"
5,"LOWER BACK",1,"Con06",1680,1640,1800,1800,1660,1800,0.084,-140,1730,"Con",40,0,FALSE,TRUE,FALSE,7.78,"old",69,170,57,"f"
5,"LOWER BACK",1,"Con07",1640,1640,1900,1850,1640,1875,0.143,-235,1757.5,"Con",0,50,TRUE,FALSE,FALSE,12.53,"old",69,170,57,"f"
5,"LOWER BACK",1,"Con08",1740,1760,2000,1850,1750,1925,0.1,-175,1837.5,"Con",-20,150,FALSE,FALSE,FALSE,9.09,"old",69,170,57,"f"
5,"LOWER BACK",1,"Con09",1800,1860,2100,2050,1830,2075,0.134,-245,1952.5,"Con",-60,50,TRUE,TRUE,FALSE,11.81,"old",69,170,57,"f"
5,"LOWER BACK",1,"Con10",1720,1760,2050,2000,1740,2025,0.164,-285,1882.5,"Con",-40,50,TRUE,TRUE,FALSE,14.07,"old",69,170,57,"f"
5,"LOWER BACK",2,"Con01",1540,1580,1600,1550,1560,1575,0.01,-15,1567.5,"Con",-40,50,FALSE,TRUE,FALSE,0.95,"old",69,170,57,"f"
5,"LOWER BACK",2,"Con02",1480,1520,1550,1500,1500,1525,0.017,-25,1512.5,"Con",-40,50,FALSE,TRUE,FALSE,1.64,"old",69,170,57,"f"
5,"LOWER BACK",2,"Con03",1640,1640,1650,1600,1640,1625,0.009,15,1632.5,"Con",0,50,FALSE,FALSE,FALSE,0.92,"old",69,170,57,"f"
5,"LOWER BACK",2,"Con04",1440,1460,1500,1500,1450,1500,0.034,-50,1475,"Con",-20,0,FALSE,FALSE,FALSE,3.33,"old",69,170,57,"f"
5,"LOWER BACK",2,"Con05",1480,1520,1550,1550,1500,1550,0.033,-50,1525,"Con",-40,0,FALSE,TRUE,FALSE,3.23,"old",69,170,57,"f"
5,"LOWER BACK",2,"Con06",1680,1700,1750,1800,1690,1775,0.05,-85,1732.5,"Con",-20,-50,FALSE,FALSE,FALSE,4.79,"old",69,170,57,"f"
5,"LOWER BACK",2,"Con07",1600,1620,1650,1700,1610,1675,0.04,-65,1642.5,"Con",-20,-50,FALSE,FALSE,FALSE,3.88,"old",69,170,57,"f"
5,"LOWER BACK",2,"Con08",1360,1400,1450,1450,1380,1450,0.051,-70,1415,"Con",-40,0,FALSE,TRUE,FALSE,4.83,"old",69,170,57,"f"
5,"LOWER BACK",2,"Con09",1480,1500,1700,1600,1490,1650,0.107,-160,1570,"Con",-20,100,FALSE,FALSE,FALSE,9.7,"old",69,170,57,"f"
5,"LOWER BACK",2,"Con10",1500,1520,1950,1800,1510,1875,0.242,-365,1692.5,"Con",-20,150,TRUE,FALSE,FALSE,19.47,"old",69,170,57,"f"
5,"LOWER BACK",1,"Ecc01",2840,2840,2850,2900,2840,2875,0.012,-35,2857.5,"Ecc",0,-50,FALSE,FALSE,FALSE,1.22,"old",69,170,57,"f"
5,"LOWER BACK",1,"Ecc02",2880,2840,2850,2850,2860,2850,0.003,10,2855,"Ecc",40,0,FALSE,FALSE,FALSE,0.35,"old",69,170,57,"f"
5,"LOWER BACK",1,"Ecc03",2900,2900,2750,2700,2900,2725,0.06,175,2812.5,"Ecc",0,50,TRUE,FALSE,FALSE,6.42,"old",69,170,57,"f"
5,"LOWER BACK",1,"Ecc04",2540,2500,2500,2450,2520,2475,0.018,45,2497.5,"Ecc",40,50,FALSE,FALSE,FALSE,1.82,"old",69,170,57,"f"
5,"LOWER BACK",1,"Ecc05",2920,2940,2850,2800,2930,2825,0.036,105,2877.5,"Ecc",-20,50,FALSE,FALSE,FALSE,3.72,"old",69,170,57,"f"
5,"LOWER BACK",1,"Ecc06",3020,3040,2750,2800,3030,2775,0.084,255,2902.5,"Ecc",-20,-50,TRUE,FALSE,FALSE,9.19,"old",69,170,57,"f"
5,"LOWER BACK",1,"Ecc07",2660,2640,2450,2550,2650,2500,0.057,150,2575,"Ecc",20,-100,FALSE,FALSE,FALSE,6,"old",69,170,57,"f"
5,"LOWER BACK",1,"Ecc08",2740,2700,2400,2500,2720,2450,0.099,270,2585,"Ecc",40,-100,TRUE,FALSE,FALSE,11.02,"old",69,170,57,"f"
5,"LOWER BACK",1,"Ecc09",2880,2840,2550,2600,2860,2575,0.1,285,2717.5,"Ecc",40,-50,TRUE,FALSE,FALSE,11.07,"old",69,170,57,"f"
5,"LOWER BACK",1,"Ecc10",2960,2960,2800,2750,2960,2775,0.062,185,2867.5,"Ecc",0,50,TRUE,FALSE,FALSE,6.67,"old",69,170,57,"f"
5,"LOWER BACK",2,"Ecc01",2280,2260,2250,2300,2270,2275,0.002,-5,2272.5,"Ecc",20,-50,FALSE,FALSE,FALSE,0.22,"old",69,170,57,"f"
5,"LOWER BACK",2,"Ecc02",2160,2140,2150,2150,2150,2150,0,0,2150,"Ecc",20,0,FALSE,FALSE,FALSE,0,"old",69,170,57,"f"
5,"LOWER BACK",2,"Ecc03",2280,2260,2200,2250,2270,2225,0.02,45,2247.5,"Ecc",20,-50,FALSE,FALSE,FALSE,2.02,"old",69,170,57,"f"
5,"LOWER BACK",2,"Ecc04",2380,2340,2300,2300,2360,2300,0.025,60,2330,"Ecc",40,0,FALSE,FALSE,FALSE,2.61,"old",69,170,57,"f"
5,"LOWER BACK",2,"Ecc05",2240,2240,2250,2200,2240,2225,0.007,15,2232.5,"Ecc",0,50,FALSE,FALSE,FALSE,0.67,"old",69,170,57,"f"
5,"LOWER BACK",2,"Ecc06",2300,2260,2200,2150,2280,2175,0.046,105,2227.5,"Ecc",40,50,FALSE,FALSE,FALSE,4.83,"old",69,170,57,"f"
5,"LOWER BACK",2,"Ecc07",2340,2320,2300,2250,2330,2275,0.024,55,2302.5,"Ecc",20,50,FALSE,FALSE,FALSE,2.42,"old",69,170,57,"f"
5,"LOWER BACK",2,"Ecc08",2240,2200,2050,2150,2220,2100,0.054,120,2160,"Ecc",40,-100,FALSE,FALSE,FALSE,5.71,"old",69,170,57,"f"
5,"LOWER BACK",2,"Ecc09",2400,2400,1950,2150,2400,2050,0.146,350,2225,"Ecc",0,-200,TRUE,FALSE,TRUE,17.07,"old",69,170,57,"f"
5,"LOWER BACK",2,"Ecc10",2560,2540,2500,2500,2550,2500,0.02,50,2525,"Ecc",20,0,FALSE,FALSE,FALSE,2,"old",69,170,57,"f"
5,"LOWER BACK",1,"Rep01",5140,5200,4700,5450,5170,5075,0.018,95,5122.5,"Rep",-60,-750,FALSE,FALSE,TRUE,1.87,"old",69,170,57,"f"
5,"LOWER BACK",1,"Rep02",4560,4540,4550,4500,4550,4525,0.005,25,4537.5,"Rep",20,50,FALSE,FALSE,FALSE,0.55,"old",69,170,57,"f"
5,"LOWER BACK",1,"Rep03",4600,4600,4500,4450,4600,4475,0.027,125,4537.5,"Rep",0,50,TRUE,FALSE,FALSE,2.79,"old",69,170,57,"f"
5,"LOWER BACK",1,"Rep04",4240,4220,4350,4350,4230,4350,0.028,-120,4290,"Rep",20,0,TRUE,FALSE,FALSE,2.76,"old",69,170,57,"f"
5,"LOWER BACK",1,"Rep05",4640,4700,4600,4650,4670,4625,0.01,45,4647.5,"Rep",-60,-50,FALSE,FALSE,FALSE,0.97,"old",69,170,57,"f"
5,"LOWER BACK",1,"Rep06",4700,4680,4550,4600,4690,4575,0.025,115,4632.5,"Rep",20,-50,TRUE,FALSE,FALSE,2.51,"old",69,170,57,"f"
5,"LOWER BACK",1,"Rep07",4300,4280,4350,4400,4290,4375,0.02,-85,4332.5,"Rep",20,-50,FALSE,FALSE,FALSE,1.94,"old",69,170,57,"f"
5,"LOWER BACK",1,"Rep08",4480,4460,4400,4350,4470,4375,0.021,95,4422.5,"Rep",20,50,FALSE,FALSE,FALSE,2.17,"old",69,170,57,"f"
5,"LOWER BACK",1,"Rep09",4680,4700,4650,4650,4690,4650,0.009,40,4670,"Rep",-20,0,FALSE,FALSE,FALSE,0.86,"old",69,170,57,"f"
5,"LOWER BACK",1,"Rep10",4680,4720,4850,4750,4700,4800,0.021,-100,4750,"Rep",-40,100,TRUE,FALSE,FALSE,2.08,"old",69,170,57,"f"
5,"LOWER BACK",2,"Rep01",3820,3840,3850,3850,3830,3850,0.005,-20,3840,"Rep",-20,0,FALSE,FALSE,FALSE,0.52,"old",69,170,57,"f"
5,"LOWER BACK",2,"Rep02",3640,3660,3700,3650,3650,3675,0.007,-25,3662.5,"Rep",-20,50,FALSE,FALSE,FALSE,0.68,"old",69,170,57,"f"
5,"LOWER BACK",2,"Rep03",3920,3900,3850,3850,3910,3850,0.015,60,3880,"Rep",20,0,FALSE,FALSE,FALSE,1.56,"old",69,170,57,"f"
5,"LOWER BACK",2,"Rep04",3820,3800,3800,3800,3810,3800,0.003,10,3805,"Rep",20,0,FALSE,FALSE,FALSE,0.26,"old",69,170,57,"f"
5,"LOWER BACK",2,"Rep05",3720,3760,3800,3750,3740,3775,0.009,-35,3757.5,"Rep",-40,50,FALSE,FALSE,FALSE,0.93,"old",69,170,57,"f"
5,"LOWER BACK",2,"Rep06",3980,3960,3950,3950,3970,3950,0.005,20,3960,"Rep",20,0,FALSE,FALSE,FALSE,0.51,"old",69,170,57,"f"
5,"LOWER BACK",2,"Rep07",3940,3940,3950,3950,3940,3950,0.003,-10,3945,"Rep",0,0,FALSE,FALSE,FALSE,0.25,"old",69,170,57,"f"
5,"LOWER BACK",2,"Rep08",3600,3600,3500,3600,3600,3550,0.014,50,3575,"Rep",0,-100,FALSE,FALSE,FALSE,1.41,"old",69,170,57,"f"
5,"LOWER BACK",2,"Rep09",3880,3900,3650,3750,3890,3700,0.049,190,3795,"Rep",-20,-100,TRUE,FALSE,FALSE,5.14,"old",69,170,57,"f"
5,"LOWER BACK",2,"Rep10",4060,4060,4450,4300,4060,4375,0.078,-315,4217.5,"Rep",0,150,TRUE,FALSE,FALSE,7.2,"old",69,170,57,"f"
5,"LOWER BACK",1,"TuT",46020,46100,45500,46150,46060,45825,0.005,235,45942.5,"TuT",-80,-650,TRUE,TRUE,TRUE,0.51,"old",69,170,57,"f"
5,"LOWER BACK",2,"TuT",38380,38420,38500,38450,38400,38475,0.002,-75,38437.5,"TuT",-40,50,FALSE,FALSE,FALSE,0.19,"old",69,170,57,"f"
5,"TOTAL ABDOMINAL",1,"Con01",2080,2100,2000,1850,2090,1925,0.079,165,2007.5,"Con",-20,150,TRUE,FALSE,FALSE,8.57,"old",69,170,57,"f"
5,"TOTAL ABDOMINAL",1,"Con02",1600,1620,1750,1550,1610,1650,0.025,-40,1630,"Con",-20,200,FALSE,FALSE,TRUE,2.42,"old",69,170,57,"f"
5,"TOTAL ABDOMINAL",1,"Con03",1740,1780,1850,1700,1760,1775,0.009,-15,1767.5,"Con",-40,150,FALSE,TRUE,FALSE,0.85,"old",69,170,57,"f"
5,"TOTAL ABDOMINAL",1,"Con04",1920,1960,1900,1900,1940,1900,0.021,40,1920,"Con",-40,0,FALSE,TRUE,FALSE,2.11,"old",69,170,57,"f"
5,"TOTAL ABDOMINAL",1,"Con05",1700,1740,1750,1750,1720,1750,0.017,-30,1735,"Con",-40,0,FALSE,TRUE,FALSE,1.71,"old",69,170,57,"f"
5,"TOTAL ABDOMINAL",1,"Con06",1700,1720,1850,2000,1710,1925,0.126,-215,1817.5,"Con",-20,-150,TRUE,FALSE,FALSE,11.17,"old",69,170,57,"f"
5,"TOTAL ABDOMINAL",1,"Con07",1880,1860,1950,2100,1870,2025,0.083,-155,1947.5,"Con",20,-150,TRUE,FALSE,FALSE,7.65,"old",69,170,57,"f"
5,"TOTAL ABDOMINAL",1,"Con08",1700,1700,1800,1900,1700,1850,0.088,-150,1775,"Con",0,-100,TRUE,FALSE,FALSE,8.11,"old",69,170,57,"f"
5,"TOTAL ABDOMINAL",1,"Con09",1920,1960,2000,2150,1940,2075,0.07,-135,2007.5,"Con",-40,-150,FALSE,TRUE,FALSE,6.51,"old",69,170,57,"f"
5,"TOTAL ABDOMINAL",1,"Con10",1800,1780,2100,2000,1790,2050,0.145,-260,1920,"Con",20,100,TRUE,FALSE,FALSE,12.68,"old",69,170,57,"f"
5,"TOTAL ABDOMINAL",2,"Con01",1580,1580,1700,1700,1580,1700,0.076,-120,1640,"Con",0,0,FALSE,FALSE,FALSE,7.06,"old",69,170,57,"f"
5,"TOTAL ABDOMINAL",2,"Con02",1560,1560,1600,1650,1560,1625,0.042,-65,1592.5,"Con",0,-50,FALSE,FALSE,FALSE,4,"old",69,170,57,"f"
5,"TOTAL ABDOMINAL",2,"Con03",1540,1600,1550,1600,1570,1575,0.003,-5,1572.5,"Con",-60,-50,FALSE,TRUE,FALSE,0.32,"old",69,170,57,"f"
5,"TOTAL ABDOMINAL",2,"Con04",1740,1760,1900,1950,1750,1925,0.1,-175,1837.5,"Con",-20,-50,TRUE,FALSE,FALSE,9.09,"old",69,170,57,"f"
5,"TOTAL ABDOMINAL",2,"Con05",1500,1540,1650,1750,1520,1700,0.118,-180,1610,"Con",-40,-100,TRUE,TRUE,FALSE,10.59,"old",69,170,57,"f"
5,"TOTAL ABDOMINAL",2,"Con06",1740,1740,1950,1800,1740,1875,0.078,-135,1807.5,"Con",0,150,FALSE,FALSE,FALSE,7.2,"old",69,170,57,"f"
5,"TOTAL ABDOMINAL",2,"Con07",1720,1740,1850,1850,1730,1850,0.069,-120,1790,"Con",-20,0,FALSE,FALSE,FALSE,6.49,"old",69,170,57,"f"
5,"TOTAL ABDOMINAL",2,"Con08",1640,1660,1750,1900,1650,1825,0.106,-175,1737.5,"Con",-20,-150,TRUE,FALSE,FALSE,9.59,"old",69,170,57,"f"
5,"TOTAL ABDOMINAL",2,"Con09",1700,1720,1900,2000,1710,1950,0.14,-240,1830,"Con",-20,-100,TRUE,FALSE,FALSE,12.31,"old",69,170,57,"f"
5,"TOTAL ABDOMINAL",2,"Con10",1540,1560,1900,1950,1550,1925,0.242,-375,1737.5,"Con",-20,-50,TRUE,FALSE,FALSE,19.48,"old",69,170,57,"f"
5,"TOTAL ABDOMINAL",1,"Ecc01",2400,2380,2250,2550,2390,2400,0.004,-10,2395,"Ecc",20,-300,FALSE,FALSE,TRUE,0.42,"old",69,170,57,"f"
5,"TOTAL ABDOMINAL",1,"Ecc02",2620,2600,2550,2700,2610,2625,0.006,-15,2617.5,"Ecc",20,-150,FALSE,FALSE,FALSE,0.57,"old",69,170,57,"f"
5,"TOTAL ABDOMINAL",1,"Ecc03",2360,2300,2250,2350,2330,2300,0.013,30,2315,"Ecc",60,-100,FALSE,TRUE,FALSE,1.3,"old",69,170,57,"f"
5,"TOTAL ABDOMINAL",1,"Ecc04",2460,2440,2550,2500,2450,2525,0.031,-75,2487.5,"Ecc",20,50,FALSE,FALSE,FALSE,2.97,"old",69,170,57,"f"
5,"TOTAL ABDOMINAL",1,"Ecc05",2180,2160,2050,2000,2170,2025,0.067,145,2097.5,"Ecc",20,50,TRUE,FALSE,FALSE,7.16,"old",69,170,57,"f"
5,"TOTAL ABDOMINAL",1,"Ecc06",2380,2380,2300,2100,2380,2200,0.076,180,2290,"Ecc",0,200,TRUE,FALSE,TRUE,8.18,"old",69,170,57,"f"
5,"TOTAL ABDOMINAL",1,"Ecc07",2720,2700,2550,2500,2710,2525,0.068,185,2617.5,"Ecc",20,50,TRUE,FALSE,FALSE,7.33,"old",69,170,57,"f"
5,"TOTAL ABDOMINAL",1,"Ecc08",2360,2340,2300,2150,2350,2225,0.053,125,2287.5,"Ecc",20,150,FALSE,FALSE,FALSE,5.62,"old",69,170,57,"f"
5,"TOTAL ABDOMINAL",1,"Ecc09",2360,2360,2200,2100,2360,2150,0.089,210,2255,"Ecc",0,100,TRUE,FALSE,FALSE,9.77,"old",69,170,57,"f"
5,"TOTAL ABDOMINAL",1,"Ecc10",2360,2380,2150,2400,2370,2275,0.04,95,2322.5,"Ecc",-20,-250,FALSE,FALSE,TRUE,4.18,"old",69,170,57,"f"
5,"TOTAL ABDOMINAL",2,"Ecc01",2340,2340,2150,2200,2340,2175,0.071,165,2257.5,"Ecc",0,-50,TRUE,FALSE,FALSE,7.59,"old",69,170,57,"f"
5,"TOTAL ABDOMINAL",2,"Ecc02",2460,2420,2600,2350,2440,2475,0.014,-35,2457.5,"Ecc",40,250,FALSE,TRUE,TRUE,1.41,"old",69,170,57,"f"
5,"TOTAL ABDOMINAL",2,"Ecc03",2420,2400,2150,2300,2410,2225,0.077,185,2317.5,"Ecc",20,-150,TRUE,FALSE,FALSE,8.31,"old",69,170,57,"f"
5,"TOTAL ABDOMINAL",2,"Ecc04",2280,2220,2250,1950,2250,2100,0.067,150,2175,"Ecc",60,300,TRUE,TRUE,TRUE,7.14,"old",69,170,57,"f"
5,"TOTAL ABDOMINAL",2,"Ecc05",2000,2000,1700,1950,2000,1825,0.088,175,1912.5,"Ecc",0,-250,TRUE,FALSE,TRUE,9.59,"old",69,170,57,"f"
5,"TOTAL ABDOMINAL",2,"Ecc06",2280,2260,2150,2150,2270,2150,0.053,120,2210,"Ecc",20,0,FALSE,FALSE,FALSE,5.58,"old",69,170,57,"f"
5,"TOTAL ABDOMINAL",2,"Ecc07",2700,2700,2600,2500,2700,2550,0.056,150,2625,"Ecc",0,100,TRUE,FALSE,FALSE,5.88,"old",69,170,57,"f"
5,"TOTAL ABDOMINAL",2,"Ecc08",2620,2580,2450,2350,2600,2400,0.077,200,2500,"Ecc",40,100,TRUE,TRUE,FALSE,8.33,"old",69,170,57,"f"
5,"TOTAL ABDOMINAL",2,"Ecc09",2860,2840,2550,2450,2850,2500,0.123,350,2675,"Ecc",20,100,TRUE,FALSE,FALSE,14,"old",69,170,57,"f"
5,"TOTAL ABDOMINAL",2,"Ecc10",3360,3360,3300,3300,3360,3300,0.018,60,3330,"Ecc",0,0,FALSE,FALSE,FALSE,1.82,"old",69,170,57,"f"
5,"TOTAL ABDOMINAL",1,"Rep01",4480,4480,4250,4400,4480,4325,0.035,155,4402.5,"Rep",0,-150,TRUE,FALSE,FALSE,3.58,"old",69,170,57,"f"
5,"TOTAL ABDOMINAL",1,"Rep02",4220,4220,4300,4250,4220,4275,0.013,-55,4247.5,"Rep",0,50,FALSE,FALSE,FALSE,1.29,"old",69,170,57,"f"
5,"TOTAL ABDOMINAL",1,"Rep03",4100,4080,4100,4050,4090,4075,0.004,15,4082.5,"Rep",20,50,FALSE,FALSE,FALSE,0.37,"old",69,170,57,"f"
5,"TOTAL ABDOMINAL",1,"Rep04",4380,4400,4450,4400,4390,4425,0.008,-35,4407.5,"Rep",-20,50,FALSE,FALSE,FALSE,0.79,"old",69,170,57,"f"
5,"TOTAL ABDOMINAL",1,"Rep05",3880,3900,3800,3750,3890,3775,0.03,115,3832.5,"Rep",-20,50,FALSE,FALSE,FALSE,3.05,"old",69,170,57,"f"
5,"TOTAL ABDOMINAL",1,"Rep06",4080,4100,4150,4100,4090,4125,0.009,-35,4107.5,"Rep",-20,50,FALSE,FALSE,FALSE,0.85,"old",69,170,57,"f"
5,"TOTAL ABDOMINAL",1,"Rep07",4600,4560,4500,4600,4580,4550,0.007,30,4565,"Rep",40,-100,FALSE,FALSE,FALSE,0.66,"old",69,170,57,"f"
5,"TOTAL ABDOMINAL",1,"Rep08",4060,4040,4100,4050,4050,4075,0.006,-25,4062.5,"Rep",20,50,FALSE,FALSE,FALSE,0.61,"old",69,170,57,"f"
5,"TOTAL ABDOMINAL",1,"Rep09",4280,4320,4200,4250,4300,4225,0.017,75,4262.5,"Rep",-40,-50,FALSE,FALSE,FALSE,1.78,"old",69,170,57,"f"
5,"TOTAL ABDOMINAL",1,"Rep10",4160,4160,4250,4400,4160,4325,0.04,-165,4242.5,"Rep",0,-150,TRUE,FALSE,FALSE,3.82,"old",69,170,57,"f"
5,"TOTAL ABDOMINAL",2,"Rep01",3920,3920,3850,3900,3920,3875,0.011,45,3897.5,"Rep",0,-50,FALSE,FALSE,FALSE,1.16,"old",69,170,57,"f"
5,"TOTAL ABDOMINAL",2,"Rep02",4020,3980,4200,4000,4000,4100,0.025,-100,4050,"Rep",40,200,FALSE,FALSE,TRUE,2.44,"old",69,170,57,"f"
5,"TOTAL ABDOMINAL",2,"Rep03",3960,4000,3700,3900,3980,3800,0.045,180,3890,"Rep",-40,-200,TRUE,FALSE,TRUE,4.74,"old",69,170,57,"f"
5,"TOTAL ABDOMINAL",2,"Rep04",4020,3980,4150,3900,4000,4025,0.006,-25,4012.5,"Rep",40,250,FALSE,FALSE,TRUE,0.62,"old",69,170,57,"f"
5,"TOTAL ABDOMINAL",2,"Rep05",3500,3540,3350,3700,3520,3525,0.001,-5,3522.5,"Rep",-40,-350,FALSE,FALSE,TRUE,0.14,"old",69,170,57,"f"
5,"TOTAL ABDOMINAL",2,"Rep06",4020,4000,4100,3950,4010,4025,0.004,-15,4017.5,"Rep",20,150,FALSE,FALSE,FALSE,0.37,"old",69,170,57,"f"
5,"TOTAL ABDOMINAL",2,"Rep07",4420,4440,4450,4350,4430,4400,0.007,30,4415,"Rep",-20,100,FALSE,FALSE,FALSE,0.68,"old",69,170,57,"f"
5,"TOTAL ABDOMINAL",2,"Rep08",4260,4240,4200,4250,4250,4225,0.006,25,4237.5,"Rep",20,-50,FALSE,FALSE,FALSE,0.59,"old",69,170,57,"f"
5,"TOTAL ABDOMINAL",2,"Rep09",4560,4560,4450,4450,4560,4450,0.024,110,4505,"Rep",0,0,FALSE,FALSE,FALSE,2.47,"old",69,170,57,"f"
5,"TOTAL ABDOMINAL",2,"Rep10",4900,4920,5200,5250,4910,5225,0.064,-315,5067.5,"Rep",-20,-50,TRUE,FALSE,FALSE,6.03,"old",69,170,57,"f"
5,"TOTAL ABDOMINAL",1,"TuT",42240,42260,42100,42250,42250,42175,0.002,75,42212.5,"TuT",-20,-150,FALSE,FALSE,FALSE,0.18,"old",69,170,57,"f"
5,"TOTAL ABDOMINAL",2,"TuT",41580,41580,41650,41650,41580,41650,0.002,-70,41615,"TuT",0,0,FALSE,FALSE,FALSE,0.17,"old",69,170,57,"f"
5,"VERTICAL TRACTION",1,"Con01",2580,2560,3150,1800,2570,2475,0.037,95,2522.5,"Con",20,1350,FALSE,FALSE,TRUE,3.84,"old",69,170,57,"f"
5,"VERTICAL TRACTION",1,"Con02",1900,1920,1900,1900,1910,1900,0.005,10,1905,"Con",-20,0,FALSE,FALSE,FALSE,0.53,"old",69,170,57,"f"
5,"VERTICAL TRACTION",1,"Con03",1800,1820,1650,1700,1810,1675,0.075,135,1742.5,"Con",-20,-50,FALSE,FALSE,FALSE,8.06,"old",69,170,57,"f"
5,"VERTICAL TRACTION",1,"Con04",1780,1780,1750,1650,1780,1700,0.045,80,1740,"Con",0,100,FALSE,FALSE,FALSE,4.71,"old",69,170,57,"f"
5,"VERTICAL TRACTION",1,"Con05",1540,1560,1700,1600,1550,1650,0.065,-100,1600,"Con",-20,100,FALSE,FALSE,FALSE,6.06,"old",69,170,57,"f"
5,"VERTICAL TRACTION",1,"Con06",1620,1620,2050,2050,1620,2050,0.265,-430,1835,"Con",0,0,TRUE,FALSE,FALSE,20.98,"old",69,170,57,"f"
5,"VERTICAL TRACTION",1,"Con07",1600,1620,1750,1750,1610,1750,0.087,-140,1680,"Con",-20,0,FALSE,FALSE,FALSE,8,"old",69,170,57,"f"
5,"VERTICAL TRACTION",1,"Con08",1500,1520,1600,1750,1510,1675,0.109,-165,1592.5,"Con",-20,-150,FALSE,FALSE,FALSE,9.85,"old",69,170,57,"f"
5,"VERTICAL TRACTION",1,"Con09",1460,1460,1800,1950,1460,1875,0.284,-415,1667.5,"Con",0,-150,TRUE,FALSE,FALSE,22.13,"old",69,170,57,"f"
5,"VERTICAL TRACTION",1,"Con10",1680,1640,2250,2200,1660,2225,0.34,-565,1942.5,"Con",40,50,TRUE,FALSE,FALSE,25.39,"old",69,170,57,"f"
5,"VERTICAL TRACTION",2,"Con01",2160,2140,2150,2150,2150,2150,0,0,2150,"Con",20,0,FALSE,FALSE,FALSE,0,"old",69,170,57,"f"
5,"VERTICAL TRACTION",2,"Con02",1840,1860,1900,1750,1850,1825,0.014,25,1837.5,"Con",-20,150,FALSE,FALSE,FALSE,1.37,"old",69,170,57,"f"
5,"VERTICAL TRACTION",2,"Con03",1600,1620,1800,1650,1610,1725,0.071,-115,1667.5,"Con",-20,150,FALSE,FALSE,FALSE,6.67,"old",69,170,57,"f"
5,"VERTICAL TRACTION",2,"Con04",1700,1700,1800,1800,1700,1800,0.059,-100,1750,"Con",0,0,FALSE,FALSE,FALSE,5.56,"old",69,170,57,"f"
5,"VERTICAL TRACTION",2,"Con05",1580,1600,1650,1700,1590,1675,0.053,-85,1632.5,"Con",-20,-50,FALSE,FALSE,FALSE,5.07,"old",69,170,57,"f"
5,"VERTICAL TRACTION",2,"Con06",1760,1780,1800,1850,1770,1825,0.031,-55,1797.5,"Con",-20,-50,FALSE,FALSE,FALSE,3.01,"old",69,170,57,"f"
5,"VERTICAL TRACTION",2,"Con07",1680,1700,1950,1800,1690,1875,0.109,-185,1782.5,"Con",-20,150,FALSE,FALSE,FALSE,9.87,"old",69,170,57,"f"
5,"VERTICAL TRACTION",2,"Con08",1740,1740,1850,1750,1740,1800,0.034,-60,1770,"Con",0,100,FALSE,FALSE,FALSE,3.33,"old",69,170,57,"f"
5,"VERTICAL TRACTION",2,"Con09",1620,1660,1850,1900,1640,1875,0.143,-235,1757.5,"Con",-40,-50,FALSE,FALSE,FALSE,12.53,"old",69,170,57,"f"
5,"VERTICAL TRACTION",2,"Con10",2040,2040,2350,2350,2040,2350,0.152,-310,2195,"Con",0,0,TRUE,FALSE,FALSE,13.19,"old",69,170,57,"f"
5,"VERTICAL TRACTION",1,"Ecc01",3020,3020,3000,3000,3020,3000,0.007,20,3010,"Ecc",0,0,FALSE,FALSE,FALSE,0.67,"old",69,170,57,"f"
5,"VERTICAL TRACTION",1,"Ecc02",2620,2580,2750,2700,2600,2725,0.048,-125,2662.5,"Ecc",40,50,FALSE,FALSE,FALSE,4.59,"old",69,170,57,"f"
5,"VERTICAL TRACTION",1,"Ecc03",2360,2360,2450,2500,2360,2475,0.049,-115,2417.5,"Ecc",0,-50,FALSE,FALSE,FALSE,4.65,"old",69,170,57,"f"
5,"VERTICAL TRACTION",1,"Ecc04",1840,1820,1700,1800,1830,1750,0.044,80,1790,"Ecc",20,-100,FALSE,FALSE,FALSE,4.57,"old",69,170,57,"f"
5,"VERTICAL TRACTION",1,"Ecc05",2220,2200,1800,1800,2210,1800,0.186,410,2005,"Ecc",20,0,TRUE,FALSE,FALSE,22.78,"old",69,170,57,"f"
5,"VERTICAL TRACTION",1,"Ecc06",2080,2100,1900,1950,2090,1925,0.079,165,2007.5,"Ecc",-20,-50,FALSE,FALSE,FALSE,8.57,"old",69,170,57,"f"
5,"VERTICAL TRACTION",1,"Ecc07",1880,1840,1800,1650,1860,1725,0.073,135,1792.5,"Ecc",40,150,FALSE,FALSE,FALSE,7.83,"old",69,170,57,"f"
5,"VERTICAL TRACTION",1,"Ecc08",2060,2080,1750,1550,2070,1650,0.203,420,1860,"Ecc",-20,200,TRUE,FALSE,TRUE,25.45,"old",69,170,57,"f"
5,"VERTICAL TRACTION",1,"Ecc09",2200,2200,1650,1750,2200,1700,0.227,500,1950,"Ecc",0,-100,TRUE,FALSE,FALSE,29.41,"old",69,170,57,"f"
5,"VERTICAL TRACTION",1,"Ecc10",3400,3380,3400,3350,3390,3375,0.004,15,3382.5,"Ecc",20,50,FALSE,FALSE,FALSE,0.44,"old",69,170,57,"f"
5,"VERTICAL TRACTION",2,"Ecc01",2920,2900,2800,2950,2910,2875,0.012,35,2892.5,"Ecc",20,-150,FALSE,FALSE,FALSE,1.22,"old",69,170,57,"f"
5,"VERTICAL TRACTION",2,"Ecc02",2620,2620,2450,2650,2620,2550,0.027,70,2585,"Ecc",0,-200,FALSE,FALSE,TRUE,2.75,"old",69,170,57,"f"
5,"VERTICAL TRACTION",2,"Ecc03",2260,2260,2200,2150,2260,2175,0.038,85,2217.5,"Ecc",0,50,FALSE,FALSE,FALSE,3.91,"old",69,170,57,"f"
5,"VERTICAL TRACTION",2,"Ecc04",2300,2280,2200,2200,2290,2200,0.039,90,2245,"Ecc",20,0,FALSE,FALSE,FALSE,4.09,"old",69,170,57,"f"
5,"VERTICAL TRACTION",2,"Ecc05",2040,2020,2000,1950,2030,1975,0.027,55,2002.5,"Ecc",20,50,FALSE,FALSE,FALSE,2.78,"old",69,170,57,"f"
5,"VERTICAL TRACTION",2,"Ecc06",2160,2140,1900,2000,2150,1950,0.093,200,2050,"Ecc",20,-100,FALSE,FALSE,FALSE,10.26,"old",69,170,57,"f"
5,"VERTICAL TRACTION",2,"Ecc07",2260,2240,2150,2250,2250,2200,0.022,50,2225,"Ecc",20,-100,FALSE,FALSE,FALSE,2.27,"old",69,170,57,"f"
5,"VERTICAL TRACTION",2,"Ecc08",1920,1920,1700,1700,1920,1700,0.115,220,1810,"Ecc",0,0,FALSE,FALSE,FALSE,12.94,"old",69,170,57,"f"
5,"VERTICAL TRACTION",2,"Ecc09",2300,2260,2000,2000,2280,2000,0.123,280,2140,"Ecc",40,0,TRUE,FALSE,FALSE,14,"old",69,170,57,"f"
5,"VERTICAL TRACTION",2,"Ecc10",4000,4000,4200,4150,4000,4175,0.044,-175,4087.5,"Ecc",0,50,FALSE,FALSE,FALSE,4.19,"old",69,170,57,"f"
5,"VERTICAL TRACTION",1,"Rep01",5600,5580,6150,4800,5590,5475,0.021,115,5532.5,"Rep",20,1350,FALSE,FALSE,TRUE,2.1,"old",69,170,57,"f"
5,"VERTICAL TRACTION",1,"Rep02",4520,4500,4650,4600,4510,4625,0.025,-115,4567.5,"Rep",20,50,FALSE,FALSE,FALSE,2.49,"old",69,170,57,"f"
5,"VERTICAL TRACTION",1,"Rep03",4160,4180,4100,4200,4170,4150,0.005,20,4160,"Rep",-20,-100,FALSE,FALSE,FALSE,0.48,"old",69,170,57,"f"
5,"VERTICAL TRACTION",1,"Rep04",3620,3600,3450,3450,3610,3450,0.044,160,3530,"Rep",20,0,TRUE,FALSE,FALSE,4.64,"old",69,170,57,"f"
5,"VERTICAL TRACTION",1,"Rep05",3760,3760,3500,3400,3760,3450,0.082,310,3605,"Rep",0,100,TRUE,FALSE,FALSE,8.99,"old",69,170,57,"f"
5,"VERTICAL TRACTION",1,"Rep06",3700,3720,3950,4000,3710,3975,0.071,-265,3842.5,"Rep",-20,-50,TRUE,FALSE,FALSE,6.67,"old",69,170,57,"f"
5,"VERTICAL TRACTION",1,"Rep07",3480,3460,3550,3400,3470,3475,0.001,-5,3472.5,"Rep",20,150,FALSE,FALSE,FALSE,0.14,"old",69,170,57,"f"
5,"VERTICAL TRACTION",1,"Rep08",3560,3600,3350,3300,3580,3325,0.071,255,3452.5,"Rep",-40,50,TRUE,FALSE,FALSE,7.67,"old",69,170,57,"f"
5,"VERTICAL TRACTION",1,"Rep09",3660,3660,3450,3700,3660,3575,0.023,85,3617.5,"Rep",0,-250,FALSE,FALSE,TRUE,2.38,"old",69,170,57,"f"
5,"VERTICAL TRACTION",1,"Rep10",5080,5020,5650,5550,5050,5600,0.109,-550,5325,"Rep",60,100,TRUE,FALSE,FALSE,9.82,"old",69,170,57,"f"
5,"VERTICAL TRACTION",2,"Rep01",5080,5040,4950,5100,5060,5025,0.007,35,5042.5,"Rep",40,-150,FALSE,FALSE,FALSE,0.7,"old",69,170,57,"f"
5,"VERTICAL TRACTION",2,"Rep02",4460,4480,4350,4400,4470,4375,0.021,95,4422.5,"Rep",-20,-50,FALSE,FALSE,FALSE,2.17,"old",69,170,57,"f"
5,"VERTICAL TRACTION",2,"Rep03",3860,3880,4000,3800,3870,3900,0.008,-30,3885,"Rep",-20,200,FALSE,FALSE,TRUE,0.77,"old",69,170,57,"f"
5,"VERTICAL TRACTION",2,"Rep04",4000,3980,4000,4000,3990,4000,0.003,-10,3995,"Rep",20,0,FALSE,FALSE,FALSE,0.25,"old",69,170,57,"f"
5,"VERTICAL TRACTION",2,"Rep05",3620,3620,3650,3650,3620,3650,0.008,-30,3635,"Rep",0,0,FALSE,FALSE,FALSE,0.82,"old",69,170,57,"f"
5,"VERTICAL TRACTION",2,"Rep06",3920,3920,3700,3850,3920,3775,0.037,145,3847.5,"Rep",0,-150,TRUE,FALSE,FALSE,3.84,"old",69,170,57,"f"
5,"VERTICAL TRACTION",2,"Rep07",3940,3940,4100,4050,3940,4075,0.034,-135,4007.5,"Rep",0,50,FALSE,FALSE,FALSE,3.31,"old",69,170,57,"f"
5,"VERTICAL TRACTION",2,"Rep08",3660,3660,3550,3450,3660,3500,0.044,160,3580,"Rep",0,100,TRUE,FALSE,FALSE,4.57,"old",69,170,57,"f"
5,"VERTICAL TRACTION",2,"Rep09",3920,3920,3850,3900,3920,3875,0.011,45,3897.5,"Rep",0,-50,FALSE,FALSE,FALSE,1.16,"old",69,170,57,"f"
5,"VERTICAL TRACTION",2,"Rep10",6040,6040,6550,6500,6040,6525,0.08,-485,6282.5,"Rep",0,50,TRUE,FALSE,FALSE,7.43,"old",69,170,57,"f"
5,"VERTICAL TRACTION",1,"TuT",41140,41080,41800,40400,41110,41100,0,10,41105,"TuT",60,1400,FALSE,FALSE,FALSE,0.02,"old",69,170,57,"f"
5,"VERTICAL TRACTION",2,"TuT",42500,42480,42700,42700,42490,42700,0.005,-210,42595,"TuT",20,0,FALSE,FALSE,FALSE,0.49,"old",69,170,57,"f"
5,"CHEST PRESS",1,"Con01",2500,2520,2500,2600,2510,2550,0.016,-40,2530,"Con",-20,-100,FALSE,FALSE,FALSE,1.57,"old",69,170,57,"f"
5,"CHEST PRESS",1,"Con02",1900,1940,2050,1800,1920,1925,0.003,-5,1922.5,"Con",-40,250,FALSE,TRUE,FALSE,0.26,"old",69,170,57,"f"
5,"CHEST PRESS",1,"Con03",1660,1700,1800,1850,1680,1825,0.086,-145,1752.5,"Con",-40,-50,FALSE,TRUE,FALSE,7.95,"old",69,170,57,"f"
5,"CHEST PRESS",1,"Con04",2000,2000,2000,2050,2000,2025,0.012,-25,2012.5,"Con",0,-50,FALSE,FALSE,FALSE,1.23,"old",69,170,57,"f"
5,"CHEST PRESS",1,"Con05",1840,1860,1850,1850,1850,1850,0,0,1850,"Con",-20,0,FALSE,FALSE,FALSE,0,"old",69,170,57,"f"
5,"CHEST PRESS",1,"Con06",1740,1720,2050,1950,1730,2000,0.156,-270,1865,"Con",20,100,FALSE,FALSE,FALSE,13.5,"old",69,170,57,"f"
5,"CHEST PRESS",1,"Con07",1520,1540,2050,1750,1530,1900,0.242,-370,1715,"Con",-20,300,TRUE,FALSE,FALSE,19.47,"old",69,170,57,"f"
5,"CHEST PRESS",1,"Con08",1580,1600,1750,1900,1590,1825,0.148,-235,1707.5,"Con",-20,-150,FALSE,FALSE,FALSE,12.88,"old",69,170,57,"f"
5,"CHEST PRESS",1,"Con09",1520,1580,1850,2200,1550,2025,0.306,-475,1787.5,"Con",-60,-350,TRUE,TRUE,TRUE,23.46,"old",69,170,57,"f"
5,"CHEST PRESS",1,"Con10",1580,1640,2500,2400,1610,2450,0.522,-840,2030,"Con",-60,100,TRUE,TRUE,FALSE,34.29,"old",69,170,57,"f"
5,"CHEST PRESS",2,"Con01",1980,1920,1900,1950,1950,1925,0.013,25,1937.5,"Con",60,-50,FALSE,TRUE,FALSE,1.3,"old",69,170,57,"f"
5,"CHEST PRESS",2,"Con02",1720,1760,1700,1750,1740,1725,0.009,15,1732.5,"Con",-40,-50,FALSE,TRUE,FALSE,0.87,"old",69,170,57,"f"
5,"CHEST PRESS",2,"Con03",1620,1640,1600,1550,1630,1575,0.034,55,1602.5,"Con",-20,50,FALSE,FALSE,FALSE,3.49,"old",69,170,57,"f"
5,"CHEST PRESS",2,"Con04",1540,1540,1800,1600,1540,1700,0.104,-160,1620,"Con",0,200,FALSE,FALSE,FALSE,9.41,"old",69,170,57,"f"
5,"CHEST PRESS",2,"Con05",1480,1520,1650,1600,1500,1625,0.083,-125,1562.5,"Con",-40,50,FALSE,TRUE,FALSE,7.69,"old",69,170,57,"f"
5,"CHEST PRESS",2,"Con06",1640,1640,1750,1750,1640,1750,0.067,-110,1695,"Con",0,0,FALSE,FALSE,FALSE,6.29,"old",69,170,57,"f"
5,"CHEST PRESS",2,"Con07",1760,1760,1900,1900,1760,1900,0.08,-140,1830,"Con",0,0,FALSE,FALSE,FALSE,7.37,"old",69,170,57,"f"
5,"CHEST PRESS",2,"Con08",1780,1820,2050,2000,1800,2025,0.125,-225,1912.5,"Con",-40,50,FALSE,TRUE,FALSE,11.11,"old",69,170,57,"f"
5,"CHEST PRESS",2,"Con09",2000,2040,2150,2250,2020,2200,0.089,-180,2110,"Con",-40,-100,FALSE,TRUE,FALSE,8.18,"old",69,170,57,"f"
5,"CHEST PRESS",2,"Con10",2280,2320,2400,2500,2300,2450,0.065,-150,2375,"Con",-40,-100,FALSE,TRUE,FALSE,6.12,"old",69,170,57,"f"
5,"CHEST PRESS",1,"Ecc01",3020,3000,2850,2900,3010,2875,0.045,135,2942.5,"Ecc",20,-50,FALSE,FALSE,FALSE,4.7,"old",69,170,57,"f"
5,"CHEST PRESS",1,"Ecc02",3000,2980,2850,3000,2990,2925,0.022,65,2957.5,"Ecc",20,-150,FALSE,FALSE,FALSE,2.22,"old",69,170,57,"f"
5,"CHEST PRESS",1,"Ecc03",2680,2620,2650,2600,2650,2625,0.009,25,2637.5,"Ecc",60,50,FALSE,TRUE,FALSE,0.95,"old",69,170,57,"f"
5,"CHEST PRESS",1,"Ecc04",2380,2380,2350,2300,2380,2325,0.023,55,2352.5,"Ecc",0,50,FALSE,FALSE,FALSE,2.37,"old",69,170,57,"f"
5,"CHEST PRESS",1,"Ecc05",2220,2220,2100,2150,2220,2125,0.043,95,2172.5,"Ecc",0,-50,FALSE,FALSE,FALSE,4.47,"old",69,170,57,"f"
5,"CHEST PRESS",1,"Ecc06",2420,2420,1850,2200,2420,2025,0.163,395,2222.5,"Ecc",0,-350,TRUE,FALSE,TRUE,19.51,"old",69,170,57,"f"
5,"CHEST PRESS",1,"Ecc07",2400,2380,2150,2050,2390,2100,0.121,290,2245,"Ecc",20,100,FALSE,FALSE,FALSE,13.81,"old",69,170,57,"f"
5,"CHEST PRESS",1,"Ecc08",2560,2520,2350,2000,2540,2175,0.144,365,2357.5,"Ecc",40,350,TRUE,TRUE,TRUE,16.78,"old",69,170,57,"f"
5,"CHEST PRESS",1,"Ecc09",2460,2400,1600,1600,2430,1600,0.342,830,2015,"Ecc",60,0,TRUE,TRUE,FALSE,51.88,"old",69,170,57,"f"
5,"CHEST PRESS",1,"Ecc10",3700,3700,4600,4650,3700,4625,0.25,-925,4162.5,"Ecc",0,-50,TRUE,FALSE,FALSE,20,"old",69,170,57,"f"
5,"CHEST PRESS",2,"Ecc01",2380,2360,2400,2350,2370,2375,0.002,-5,2372.5,"Ecc",20,50,FALSE,FALSE,FALSE,0.21,"old",69,170,57,"f"
5,"CHEST PRESS",2,"Ecc02",2060,2000,2050,2100,2030,2075,0.022,-45,2052.5,"Ecc",60,-50,FALSE,TRUE,FALSE,2.17,"old",69,170,57,"f"
5,"CHEST PRESS",2,"Ecc03",1820,1840,1650,1800,1830,1725,0.057,105,1777.5,"Ecc",-20,-150,FALSE,FALSE,FALSE,6.09,"old",69,170,57,"f"
5,"CHEST PRESS",2,"Ecc04",2280,2260,2100,2200,2270,2150,0.053,120,2210,"Ecc",20,-100,FALSE,FALSE,FALSE,5.58,"old",69,170,57,"f"
5,"CHEST PRESS",2,"Ecc05",2140,2120,2000,2000,2130,2000,0.061,130,2065,"Ecc",20,0,FALSE,FALSE,FALSE,6.5,"old",69,170,57,"f"
5,"CHEST PRESS",2,"Ecc06",1880,1880,1800,1800,1880,1800,0.043,80,1840,"Ecc",0,0,FALSE,FALSE,FALSE,4.44,"old",69,170,57,"f"
5,"CHEST PRESS",2,"Ecc07",1740,1700,1500,1550,1720,1525,0.113,195,1622.5,"Ecc",40,-50,FALSE,TRUE,FALSE,12.79,"old",69,170,57,"f"
5,"CHEST PRESS",2,"Ecc08",1880,1860,1700,1650,1870,1675,0.104,195,1772.5,"Ecc",20,50,FALSE,FALSE,FALSE,11.64,"old",69,170,57,"f"
5,"CHEST PRESS",2,"Ecc09",1880,1860,1800,1700,1870,1750,0.064,120,1810,"Ecc",20,100,FALSE,FALSE,FALSE,6.86,"old",69,170,57,"f"
5,"CHEST PRESS",2,"Ecc10",2960,2940,4150,4100,2950,4125,0.398,-1175,3537.5,"Ecc",20,50,TRUE,FALSE,FALSE,28.48,"old",69,170,57,"f"
5,"CHEST PRESS",1,"Rep01",5520,5520,5350,5500,5520,5425,0.017,95,5472.5,"Rep",0,-150,FALSE,FALSE,FALSE,1.75,"old",69,170,57,"f"
5,"CHEST PRESS",1,"Rep02",4900,4920,4900,4800,4910,4850,0.012,60,4880,"Rep",-20,100,FALSE,FALSE,FALSE,1.24,"old",69,170,57,"f"
5,"CHEST PRESS",1,"Rep03",4340,4320,4450,4450,4330,4450,0.028,-120,4390,"Rep",20,0,FALSE,FALSE,FALSE,2.7,"old",69,170,57,"f"
5,"CHEST PRESS",1,"Rep04",4380,4380,4350,4350,4380,4350,0.007,30,4365,"Rep",0,0,FALSE,FALSE,FALSE,0.69,"old",69,170,57,"f"
5,"CHEST PRESS",1,"Rep05",4060,4080,3950,4000,4070,3975,0.023,95,4022.5,"Rep",-20,-50,FALSE,FALSE,FALSE,2.39,"old",69,170,57,"f"
5,"CHEST PRESS",1,"Rep06",4160,4140,3900,4150,4150,4025,0.03,125,4087.5,"Rep",20,-250,FALSE,FALSE,TRUE,3.11,"old",69,170,57,"f"
5,"CHEST PRESS",1,"Rep07",3920,3920,4200,3800,3920,4000,0.02,-80,3960,"Rep",0,400,FALSE,FALSE,TRUE,2,"old",69,170,57,"f"
5,"CHEST PRESS",1,"Rep08",4140,4120,4100,3900,4130,4000,0.031,130,4065,"Rep",20,200,FALSE,FALSE,TRUE,3.25,"old",69,170,57,"f"
5,"CHEST PRESS",1,"Rep09",3980,3980,3450,3800,3980,3625,0.089,355,3802.5,"Rep",0,-350,TRUE,FALSE,TRUE,9.79,"old",69,170,57,"f"
5,"CHEST PRESS",1,"Rep10",5280,5340,7100,7050,5310,7075,0.332,-1765,6192.5,"Rep",-60,50,TRUE,FALSE,FALSE,24.95,"old",69,170,57,"f"
5,"CHEST PRESS",2,"Rep01",4360,4280,4300,4300,4320,4300,0.005,20,4310,"Rep",80,0,FALSE,TRUE,FALSE,0.47,"old",69,170,57,"f"
5,"CHEST PRESS",2,"Rep02",3780,3760,3750,3850,3770,3800,0.008,-30,3785,"Rep",20,-100,FALSE,FALSE,FALSE,0.79,"old",69,170,57,"f"
5,"CHEST PRESS",2,"Rep03",3440,3480,3250,3350,3460,3300,0.046,160,3380,"Rep",-40,-100,TRUE,FALSE,FALSE,4.85,"old",69,170,57,"f"
5,"CHEST PRESS",2,"Rep04",3820,3800,3900,3800,3810,3850,0.01,-40,3830,"Rep",20,100,FALSE,FALSE,FALSE,1.04,"old",69,170,57,"f"
5,"CHEST PRESS",2,"Rep05",3620,3640,3650,3600,3630,3625,0.001,5,3627.5,"Rep",-20,50,FALSE,FALSE,FALSE,0.14,"old",69,170,57,"f"
5,"CHEST PRESS",2,"Rep06",3520,3520,3550,3550,3520,3550,0.009,-30,3535,"Rep",0,0,FALSE,FALSE,FALSE,0.85,"old",69,170,57,"f"
5,"CHEST PRESS",2,"Rep07",3500,3460,3400,3450,3480,3425,0.016,55,3452.5,"Rep",40,-50,FALSE,FALSE,FALSE,1.61,"old",69,170,57,"f"
5,"CHEST PRESS",2,"Rep08",3660,3680,3750,3650,3670,3700,0.008,-30,3685,"Rep",-20,100,FALSE,FALSE,FALSE,0.81,"old",69,170,57,"f"
5,"CHEST PRESS",2,"Rep09",3880,3900,3950,3950,3890,3950,0.015,-60,3920,"Rep",-20,0,FALSE,FALSE,FALSE,1.52,"old",69,170,57,"f"
5,"CHEST PRESS",2,"Rep10",5240,5260,6550,6600,5250,6575,0.252,-1325,5912.5,"Rep",-20,-50,TRUE,FALSE,FALSE,20.15,"old",69,170,57,"f"
5,"CHEST PRESS",1,"TuT",44680,44720,45750,45800,44700,45775,0.024,-1075,45237.5,"TuT",-40,-50,FALSE,FALSE,FALSE,2.35,"old",69,170,57,"f"
5,"CHEST PRESS",2,"TuT",38820,38780,40050,40100,38800,40075,0.033,-1275,39437.5,"TuT",40,-50,FALSE,FALSE,FALSE,3.18,"old",69,170,57,"f"
6,"LEG PRESS",1,"Con01",1340,1360,1650,1550,1350,1600,0.185,-250,1475,"Con",-20,100,FALSE,FALSE,FALSE,15.62,"young",34,165,68,"m"
6,"LEG PRESS",1,"Con02",1280,1260,1300,1300,1270,1300,0.024,-30,1285,"Con",20,0,FALSE,FALSE,FALSE,2.31,"young",34,165,68,"m"
6,"LEG PRESS",1,"Con03",1300,1280,1300,1300,1290,1300,0.008,-10,1295,"Con",20,0,FALSE,FALSE,FALSE,0.77,"young",34,165,68,"m"
6,"LEG PRESS",1,"Con04",1360,1400,1400,1350,1380,1375,0.004,5,1377.5,"Con",-40,50,FALSE,FALSE,FALSE,0.36,"young",34,165,68,"m"
6,"LEG PRESS",1,"Con05",1340,1340,1350,1350,1340,1350,0.007,-10,1345,"Con",0,0,FALSE,FALSE,FALSE,0.74,"young",34,165,68,"m"
6,"LEG PRESS",1,"Con06",1400,1400,1450,1400,1400,1425,0.018,-25,1412.5,"Con",0,50,FALSE,FALSE,FALSE,1.75,"young",34,165,68,"m"
6,"LEG PRESS",1,"Con07",1460,1480,1550,1600,1470,1575,0.071,-105,1522.5,"Con",-20,-50,FALSE,FALSE,FALSE,6.67,"young",34,165,68,"m"
6,"LEG PRESS",1,"Con08",1440,1440,1650,1700,1440,1675,0.163,-235,1557.5,"Con",0,-50,FALSE,FALSE,FALSE,14.03,"young",34,165,68,"m"
6,"LEG PRESS",1,"Con09",1500,1520,1950,1950,1510,1950,0.291,-440,1730,"Con",-20,0,TRUE,FALSE,FALSE,22.56,"young",34,165,68,"m"
6,"LEG PRESS",1,"Con10",1480,1480,1900,2000,1480,1950,0.318,-470,1715,"Con",0,-100,TRUE,FALSE,FALSE,24.1,"young",34,165,68,"m"
6,"LEG PRESS",2,"Con01",1460,1400,3200,1650,1430,2425,0.696,-995,1927.5,"Con",60,1550,TRUE,FALSE,TRUE,41.03,"young",34,165,68,"m"
6,"LEG PRESS",2,"Con02",1740,1760,1550,1550,1750,1550,0.114,200,1650,"Con",-20,0,FALSE,FALSE,FALSE,12.9,"young",34,165,68,"m"
6,"LEG PRESS",2,"Con03",1620,1640,1550,1550,1630,1550,0.049,80,1590,"Con",-20,0,FALSE,FALSE,FALSE,5.16,"young",34,165,68,"m"
6,"LEG PRESS",2,"Con04",1640,1640,1550,1550,1640,1550,0.055,90,1595,"Con",0,0,FALSE,FALSE,FALSE,5.81,"young",34,165,68,"m"
6,"LEG PRESS",2,"Con05",1720,1700,1700,1650,1710,1675,0.02,35,1692.5,"Con",20,50,FALSE,FALSE,FALSE,2.09,"young",34,165,68,"m"
6,"LEG PRESS",2,"Con06",1440,1420,1500,1550,1430,1525,0.066,-95,1477.5,"Con",20,-50,FALSE,FALSE,FALSE,6.23,"young",34,165,68,"m"
6,"LEG PRESS",2,"Con07",1440,1440,1550,1550,1440,1550,0.076,-110,1495,"Con",0,0,FALSE,FALSE,FALSE,7.1,"young",34,165,68,"m"
6,"LEG PRESS",2,"Con08",1460,1460,1700,1800,1460,1750,0.199,-290,1605,"Con",0,-100,FALSE,FALSE,FALSE,16.57,"young",34,165,68,"m"
6,"LEG PRESS",2,"Con09",1600,1600,2050,2150,1600,2100,0.312,-500,1850,"Con",0,-100,TRUE,FALSE,FALSE,23.81,"young",34,165,68,"m"
6,"LEG PRESS",2,"Con10",1580,1580,2000,2050,1580,2025,0.282,-445,1802.5,"Con",0,-50,TRUE,FALSE,FALSE,21.98,"young",34,165,68,"m"
6,"LEG PRESS",1,"Ecc01",2560,2540,2450,2500,2550,2475,0.029,75,2512.5,"Ecc",20,-50,FALSE,FALSE,FALSE,3.03,"young",34,165,68,"m"
6,"LEG PRESS",1,"Ecc02",1900,1920,1900,1900,1910,1900,0.005,10,1905,"Ecc",-20,0,FALSE,FALSE,FALSE,0.53,"young",34,165,68,"m"
6,"LEG PRESS",1,"Ecc03",1900,1920,1900,1900,1910,1900,0.005,10,1905,"Ecc",-20,0,FALSE,FALSE,FALSE,0.53,"young",34,165,68,"m"
6,"LEG PRESS",1,"Ecc04",2140,2100,2100,2150,2120,2125,0.002,-5,2122.5,"Ecc",40,-50,FALSE,FALSE,FALSE,0.24,"young",34,165,68,"m"
6,"LEG PRESS",1,"Ecc05",2020,2020,2000,2000,2020,2000,0.01,20,2010,"Ecc",0,0,FALSE,FALSE,FALSE,1,"young",34,165,68,"m"
6,"LEG PRESS",1,"Ecc06",2060,2060,2000,2000,2060,2000,0.029,60,2030,"Ecc",0,0,FALSE,FALSE,FALSE,3,"young",34,165,68,"m"
6,"LEG PRESS",1,"Ecc07",2240,2240,2150,2100,2240,2125,0.051,115,2182.5,"Ecc",0,50,FALSE,FALSE,FALSE,5.41,"young",34,165,68,"m"
6,"LEG PRESS",1,"Ecc08",2220,2200,1900,1900,2210,1900,0.14,310,2055,"Ecc",20,0,FALSE,FALSE,FALSE,16.32,"young",34,165,68,"m"
6,"LEG PRESS",1,"Ecc09",2200,2200,1800,1750,2200,1775,0.193,425,1987.5,"Ecc",0,50,TRUE,FALSE,FALSE,23.94,"young",34,165,68,"m"
6,"LEG PRESS",1,"Ecc10",2000,2000,1700,1650,2000,1675,0.162,325,1837.5,"Ecc",0,50,TRUE,FALSE,FALSE,19.4,"young",34,165,68,"m"
6,"LEG PRESS",2,"Ecc01",2660,2640,2550,2600,2650,2575,0.028,75,2612.5,"Ecc",20,-50,FALSE,FALSE,FALSE,2.91,"young",34,165,68,"m"
6,"LEG PRESS",2,"Ecc02",1940,1920,2150,2150,1930,2150,0.114,-220,2040,"Ecc",20,0,FALSE,FALSE,FALSE,10.23,"young",34,165,68,"m"
6,"LEG PRESS",2,"Ecc03",1840,1840,1900,1900,1840,1900,0.033,-60,1870,"Ecc",0,0,FALSE,FALSE,FALSE,3.16,"young",34,165,68,"m"
6,"LEG PRESS",2,"Ecc04",1860,1860,1900,1950,1860,1925,0.035,-65,1892.5,"Ecc",0,-50,FALSE,FALSE,FALSE,3.38,"young",34,165,68,"m"
6,"LEG PRESS",2,"Ecc05",2120,2140,2150,2150,2130,2150,0.009,-20,2140,"Ecc",-20,0,FALSE,FALSE,FALSE,0.93,"young",34,165,68,"m"
6,"LEG PRESS",2,"Ecc06",1980,2000,1900,1850,1990,1875,0.058,115,1932.5,"Ecc",-20,50,FALSE,FALSE,FALSE,6.13,"young",34,165,68,"m"
6,"LEG PRESS",2,"Ecc07",2040,2020,1900,1900,2030,1900,0.064,130,1965,"Ecc",20,0,FALSE,FALSE,FALSE,6.84,"young",34,165,68,"m"
6,"LEG PRESS",2,"Ecc08",2000,2020,1700,1550,2010,1625,0.192,385,1817.5,"Ecc",-20,150,TRUE,FALSE,FALSE,23.69,"young",34,165,68,"m"
6,"LEG PRESS",2,"Ecc09",1920,1920,1450,1400,1920,1425,0.258,495,1672.5,"Ecc",0,50,TRUE,FALSE,FALSE,34.74,"young",34,165,68,"m"
6,"LEG PRESS",2,"Ecc10",1900,1880,1700,1600,1890,1650,0.127,240,1770,"Ecc",20,100,FALSE,FALSE,FALSE,14.55,"young",34,165,68,"m"
6,"LEG PRESS",1,"Rep01",3900,3900,4100,4050,3900,4075,0.045,-175,3987.5,"Rep",0,50,TRUE,FALSE,FALSE,4.29,"young",34,165,68,"m"
6,"LEG PRESS",1,"Rep02",3180,3180,3200,3200,3180,3200,0.006,-20,3190,"Rep",0,0,FALSE,FALSE,FALSE,0.62,"young",34,165,68,"m"
6,"LEG PRESS",1,"Rep03",3200,3200,3200,3200,3200,3200,0,0,3200,"Rep",0,0,FALSE,FALSE,FALSE,0,"young",34,165,68,"m"
6,"LEG PRESS",1,"Rep04",3500,3500,3500,3500,3500,3500,0,0,3500,"Rep",0,0,FALSE,FALSE,FALSE,0,"young",34,165,68,"m"
6,"LEG PRESS",1,"Rep05",3360,3360,3350,3350,3360,3350,0.003,10,3355,"Rep",0,0,FALSE,FALSE,FALSE,0.3,"young",34,165,68,"m"
6,"LEG PRESS",1,"Rep06",3460,3460,3450,3400,3460,3425,0.01,35,3442.5,"Rep",0,50,FALSE,FALSE,FALSE,1.02,"young",34,165,68,"m"
6,"LEG PRESS",1,"Rep07",3700,3720,3700,3700,3710,3700,0.003,10,3705,"Rep",-20,0,FALSE,FALSE,FALSE,0.27,"young",34,165,68,"m"
6,"LEG PRESS",1,"Rep08",3660,3640,3550,3600,3650,3575,0.021,75,3612.5,"Rep",20,-50,FALSE,FALSE,FALSE,2.1,"young",34,165,68,"m"
6,"LEG PRESS",1,"Rep09",3700,3720,3750,3700,3710,3725,0.004,-15,3717.5,"Rep",-20,50,FALSE,FALSE,FALSE,0.4,"young",34,165,68,"m"
6,"LEG PRESS",1,"Rep10",3480,3480,3600,3650,3480,3625,0.042,-145,3552.5,"Rep",0,-50,TRUE,FALSE,FALSE,4,"young",34,165,68,"m"
6,"LEG PRESS",2,"Rep01",4120,4040,5750,4250,4080,5000,0.225,-920,4540,"Rep",80,1500,TRUE,TRUE,TRUE,18.4,"young",34,165,68,"m"
6,"LEG PRESS",2,"Rep02",3680,3680,3700,3700,3680,3700,0.005,-20,3690,"Rep",0,0,FALSE,FALSE,FALSE,0.54,"young",34,165,68,"m"
6,"LEG PRESS",2,"Rep03",3460,3480,3450,3450,3470,3450,0.006,20,3460,"Rep",-20,0,FALSE,FALSE,FALSE,0.58,"young",34,165,68,"m"
6,"LEG PRESS",2,"Rep04",3500,3500,3450,3500,3500,3475,0.007,25,3487.5,"Rep",0,-50,FALSE,FALSE,FALSE,0.72,"young",34,165,68,"m"
6,"LEG PRESS",2,"Rep05",3840,3840,3850,3800,3840,3825,0.004,15,3832.5,"Rep",0,50,FALSE,FALSE,FALSE,0.39,"young",34,165,68,"m"
6,"LEG PRESS",2,"Rep06",3420,3420,3400,3400,3420,3400,0.006,20,3410,"Rep",0,0,FALSE,FALSE,FALSE,0.59,"young",34,165,68,"m"
6,"LEG PRESS",2,"Rep07",3480,3460,3450,3450,3470,3450,0.006,20,3460,"Rep",20,0,FALSE,FALSE,FALSE,0.58,"young",34,165,68,"m"
6,"LEG PRESS",2,"Rep08",3460,3480,3400,3350,3470,3375,0.027,95,3422.5,"Rep",-20,50,FALSE,FALSE,FALSE,2.81,"young",34,165,68,"m"
6,"LEG PRESS",2,"Rep09",3520,3520,3500,3550,3520,3525,0.001,-5,3522.5,"Rep",0,-50,FALSE,FALSE,FALSE,0.14,"young",34,165,68,"m"
6,"LEG PRESS",2,"Rep10",3480,3460,3700,3650,3470,3675,0.059,-205,3572.5,"Rep",20,50,TRUE,FALSE,FALSE,5.58,"young",34,165,68,"m"
6,"LEG PRESS",1,"TuT",35140,35160,35400,35350,35150,35375,0.006,-225,35262.5,"TuT",-20,50,FALSE,FALSE,FALSE,0.64,"young",34,165,68,"m"
6,"LEG PRESS",2,"TuT",35960,35880,37650,36100,35920,36875,0.027,-955,36397.5,"TuT",80,1550,TRUE,TRUE,TRUE,2.59,"young",34,165,68,"m"
6,"LEG EXTENSION",1,"Con01",1220,1200,1300,1350,1210,1325,0.095,-115,1267.5,"Con",20,-50,FALSE,FALSE,FALSE,8.68,"young",34,165,68,"m"
6,"LEG EXTENSION",1,"Con02",1260,1280,1300,1250,1270,1275,0.004,-5,1272.5,"Con",-20,50,FALSE,FALSE,FALSE,0.39,"young",34,165,68,"m"
6,"LEG EXTENSION",1,"Con03",1360,1380,1400,1300,1370,1350,0.015,20,1360,"Con",-20,100,FALSE,FALSE,FALSE,1.48,"young",34,165,68,"m"
6,"LEG EXTENSION",1,"Con04",1260,1280,1300,1150,1270,1225,0.035,45,1247.5,"Con",-20,150,FALSE,FALSE,FALSE,3.67,"young",34,165,68,"m"
6,"LEG EXTENSION",1,"Con05",1280,1300,1300,1400,1290,1350,0.047,-60,1320,"Con",-20,-100,FALSE,FALSE,FALSE,4.44,"young",34,165,68,"m"
6,"LEG EXTENSION",1,"Con06",1320,1320,1250,1300,1320,1275,0.034,45,1297.5,"Con",0,-50,FALSE,FALSE,FALSE,3.53,"young",34,165,68,"m"
6,"LEG EXTENSION",1,"Con07",1400,1400,1500,1550,1400,1525,0.089,-125,1462.5,"Con",0,-50,FALSE,FALSE,FALSE,8.2,"young",34,165,68,"m"
6,"LEG EXTENSION",1,"Con08",1380,1400,1500,1550,1390,1525,0.097,-135,1457.5,"Con",-20,-50,FALSE,FALSE,FALSE,8.85,"young",34,165,68,"m"
6,"LEG EXTENSION",1,"Con09",1400,1420,1600,1650,1410,1625,0.152,-215,1517.5,"Con",-20,-50,TRUE,FALSE,FALSE,13.23,"young",34,165,68,"m"
6,"LEG EXTENSION",1,"Con10",1280,1320,1550,1600,1300,1575,0.212,-275,1437.5,"Con",-40,-50,TRUE,TRUE,FALSE,17.46,"young",34,165,68,"m"
6,"LEG EXTENSION",2,"Con01",1340,1340,1550,1500,1340,1525,0.138,-185,1432.5,"Con",0,50,TRUE,FALSE,FALSE,12.13,"young",34,165,68,"m"
6,"LEG EXTENSION",2,"Con02",1520,1520,1450,1500,1520,1475,0.03,45,1497.5,"Con",0,-50,FALSE,FALSE,FALSE,3.05,"young",34,165,68,"m"
6,"LEG EXTENSION",2,"Con03",1560,1580,1550,1500,1570,1525,0.029,45,1547.5,"Con",-20,50,FALSE,FALSE,FALSE,2.95,"young",34,165,68,"m"
6,"LEG EXTENSION",2,"Con04",1460,1460,1400,1350,1460,1375,0.058,85,1417.5,"Con",0,50,FALSE,FALSE,FALSE,6.18,"young",34,165,68,"m"
6,"LEG EXTENSION",2,"Con05",1260,1260,1300,1250,1260,1275,0.012,-15,1267.5,"Con",0,50,FALSE,FALSE,FALSE,1.18,"young",34,165,68,"m"
6,"LEG EXTENSION",2,"Con06",1340,1360,1450,1450,1350,1450,0.074,-100,1400,"Con",-20,0,FALSE,FALSE,FALSE,6.9,"young",34,165,68,"m"
6,"LEG EXTENSION",2,"Con07",1200,1200,1300,1350,1200,1325,0.104,-125,1262.5,"Con",0,-50,FALSE,FALSE,FALSE,9.43,"young",34,165,68,"m"
6,"LEG EXTENSION",2,"Con08",1240,1260,1400,1500,1250,1450,0.16,-200,1350,"Con",-20,-100,TRUE,FALSE,FALSE,13.79,"young",34,165,68,"m"
6,"LEG EXTENSION",2,"Con09",1180,1180,1450,1500,1180,1475,0.25,-295,1327.5,"Con",0,-50,TRUE,FALSE,FALSE,20,"young",34,165,68,"m"
6,"LEG EXTENSION",2,"Con10",1080,1100,1350,1600,1090,1475,0.353,-385,1282.5,"Con",-20,-250,TRUE,FALSE,TRUE,26.1,"young",34,165,68,"m"
6,"LEG EXTENSION",1,"Ecc01",2080,2060,2050,2050,2070,2050,0.01,20,2060,"Ecc",20,0,FALSE,FALSE,FALSE,0.98,"young",34,165,68,"m"
6,"LEG EXTENSION",1,"Ecc02",2820,2820,2750,2850,2820,2800,0.007,20,2810,"Ecc",0,-100,FALSE,FALSE,FALSE,0.71,"young",34,165,68,"m"
6,"LEG EXTENSION",1,"Ecc03",2500,2480,2450,2600,2490,2525,0.014,-35,2507.5,"Ecc",20,-150,FALSE,FALSE,FALSE,1.39,"young",34,165,68,"m"
6,"LEG EXTENSION",1,"Ecc04",2380,2340,2350,2350,2360,2350,0.004,10,2355,"Ecc",40,0,FALSE,TRUE,FALSE,0.43,"young",34,165,68,"m"
6,"LEG EXTENSION",1,"Ecc05",2560,2560,2600,2500,2560,2550,0.004,10,2555,"Ecc",0,100,FALSE,FALSE,FALSE,0.39,"young",34,165,68,"m"
6,"LEG EXTENSION",1,"Ecc06",2300,2300,2300,2250,2300,2275,0.011,25,2287.5,"Ecc",0,50,FALSE,FALSE,FALSE,1.1,"young",34,165,68,"m"
6,"LEG EXTENSION",1,"Ecc07",2440,2440,2350,2300,2440,2325,0.047,115,2382.5,"Ecc",0,50,FALSE,FALSE,FALSE,4.95,"young",34,165,68,"m"
6,"LEG EXTENSION",1,"Ecc08",2680,2660,2500,2450,2670,2475,0.073,195,2572.5,"Ecc",20,50,TRUE,FALSE,FALSE,7.88,"young",34,165,68,"m"
6,"LEG EXTENSION",1,"Ecc09",2460,2420,2200,2150,2440,2175,0.109,265,2307.5,"Ecc",40,50,TRUE,TRUE,FALSE,12.18,"young",34,165,68,"m"
6,"LEG EXTENSION",1,"Ecc10",2200,2200,2150,2150,2200,2150,0.023,50,2175,"Ecc",0,0,FALSE,FALSE,FALSE,2.33,"young",34,165,68,"m"
6,"LEG EXTENSION",2,"Ecc01",2580,2580,2600,2600,2580,2600,0.008,-20,2590,"Ecc",0,0,FALSE,FALSE,FALSE,0.77,"young",34,165,68,"m"
6,"LEG EXTENSION",2,"Ecc02",3120,3100,3150,3150,3110,3150,0.013,-40,3130,"Ecc",20,0,FALSE,FALSE,FALSE,1.27,"young",34,165,68,"m"
6,"LEG EXTENSION",2,"Ecc03",3220,3200,3250,3300,3210,3275,0.02,-65,3242.5,"Ecc",20,-50,FALSE,FALSE,FALSE,1.98,"young",34,165,68,"m"
6,"LEG EXTENSION",2,"Ecc04",2980,2980,3000,3050,2980,3025,0.015,-45,3002.5,"Ecc",0,-50,FALSE,FALSE,FALSE,1.49,"young",34,165,68,"m"
6,"LEG EXTENSION",2,"Ecc05",2520,2520,2450,2450,2520,2450,0.028,70,2485,"Ecc",0,0,FALSE,FALSE,FALSE,2.86,"young",34,165,68,"m"
6,"LEG EXTENSION",2,"Ecc06",2240,2220,2100,2100,2230,2100,0.058,130,2165,"Ecc",20,0,FALSE,FALSE,FALSE,6.19,"young",34,165,68,"m"
6,"LEG EXTENSION",2,"Ecc07",2140,2120,2050,1950,2130,2000,0.061,130,2065,"Ecc",20,100,FALSE,FALSE,FALSE,6.5,"young",34,165,68,"m"
6,"LEG EXTENSION",2,"Ecc08",2060,2060,1800,1750,2060,1775,0.138,285,1917.5,"Ecc",0,50,TRUE,FALSE,FALSE,16.06,"young",34,165,68,"m"
6,"LEG EXTENSION",2,"Ecc09",2000,1980,1750,1500,1990,1625,0.183,365,1807.5,"Ecc",20,250,TRUE,FALSE,TRUE,22.46,"young",34,165,68,"m"
6,"LEG EXTENSION",2,"Ecc10",2220,2220,2150,2150,2220,2150,0.032,70,2185,"Ecc",0,0,FALSE,FALSE,FALSE,3.26,"young",34,165,68,"m"
6,"LEG EXTENSION",1,"Rep01",3300,3260,3350,3400,3280,3375,0.029,-95,3327.5,"Rep",40,-50,FALSE,FALSE,FALSE,2.81,"young",34,165,68,"m"
6,"LEG EXTENSION",1,"Rep02",4080,4100,4050,4100,4090,4075,0.004,15,4082.5,"Rep",-20,-50,FALSE,FALSE,FALSE,0.37,"young",34,165,68,"m"
6,"LEG EXTENSION",1,"Rep03",3860,3860,3850,3900,3860,3875,0.004,-15,3867.5,"Rep",0,-50,FALSE,FALSE,FALSE,0.39,"young",34,165,68,"m"
6,"LEG EXTENSION",1,"Rep04",3640,3620,3650,3500,3630,3575,0.015,55,3602.5,"Rep",20,150,FALSE,FALSE,FALSE,1.54,"young",34,165,68,"m"
6,"LEG EXTENSION",1,"Rep05",3840,3860,3900,3900,3850,3900,0.013,-50,3875,"Rep",-20,0,FALSE,FALSE,FALSE,1.28,"young",34,165,68,"m"
6,"LEG EXTENSION",1,"Rep06",3620,3620,3550,3550,3620,3550,0.019,70,3585,"Rep",0,0,FALSE,FALSE,FALSE,1.97,"young",34,165,68,"m"
6,"LEG EXTENSION",1,"Rep07",3840,3840,3850,3850,3840,3850,0.003,-10,3845,"Rep",0,0,FALSE,FALSE,FALSE,0.26,"young",34,165,68,"m"
6,"LEG EXTENSION",1,"Rep08",4060,4060,4000,4000,4060,4000,0.015,60,4030,"Rep",0,0,FALSE,FALSE,FALSE,1.5,"young",34,165,68,"m"
6,"LEG EXTENSION",1,"Rep09",3860,3840,3800,3800,3850,3800,0.013,50,3825,"Rep",20,0,FALSE,FALSE,FALSE,1.32,"young",34,165,68,"m"
6,"LEG EXTENSION",1,"Rep10",3480,3520,3700,3750,3500,3725,0.064,-225,3612.5,"Rep",-40,-50,TRUE,FALSE,FALSE,6.04,"young",34,165,68,"m"
6,"LEG EXTENSION",2,"Rep01",3920,3920,4150,4100,3920,4125,0.052,-205,4022.5,"Rep",0,50,TRUE,FALSE,FALSE,4.97,"young",34,165,68,"m"
6,"LEG EXTENSION",2,"Rep02",4640,4620,4600,4650,4630,4625,0.001,5,4627.5,"Rep",20,-50,FALSE,FALSE,FALSE,0.11,"young",34,165,68,"m"
6,"LEG EXTENSION",2,"Rep03",4780,4780,4800,4800,4780,4800,0.004,-20,4790,"Rep",0,0,FALSE,FALSE,FALSE,0.42,"young",34,165,68,"m"
6,"LEG EXTENSION",2,"Rep04",4440,4440,4400,4400,4440,4400,0.009,40,4420,"Rep",0,0,FALSE,FALSE,FALSE,0.91,"young",34,165,68,"m"
6,"LEG EXTENSION",2,"Rep05",3780,3780,3750,3700,3780,3725,0.015,55,3752.5,"Rep",0,50,FALSE,FALSE,FALSE,1.48,"young",34,165,68,"m"
6,"LEG EXTENSION",2,"Rep06",3580,3580,3550,3550,3580,3550,0.008,30,3565,"Rep",0,0,FALSE,FALSE,FALSE,0.85,"young",34,165,68,"m"
6,"LEG EXTENSION",2,"Rep07",3340,3320,3350,3300,3330,3325,0.002,5,3327.5,"Rep",20,50,FALSE,FALSE,FALSE,0.15,"young",34,165,68,"m"
6,"LEG EXTENSION",2,"Rep08",3300,3320,3200,3250,3310,3225,0.026,85,3267.5,"Rep",-20,-50,FALSE,FALSE,FALSE,2.64,"young",34,165,68,"m"
6,"LEG EXTENSION",2,"Rep09",3180,3160,3200,3000,3170,3100,0.022,70,3135,"Rep",20,200,FALSE,FALSE,TRUE,2.26,"young",34,165,68,"m"
6,"LEG EXTENSION",2,"Rep10",3300,3320,3500,3750,3310,3625,0.095,-315,3467.5,"Rep",-20,-250,TRUE,FALSE,TRUE,8.69,"young",34,165,68,"m"
6,"LEG EXTENSION",1,"TuT",37580,37580,37700,37750,37580,37725,0.004,-145,37652.5,"TuT",0,-50,FALSE,FALSE,FALSE,0.38,"young",34,165,68,"m"
6,"LEG EXTENSION",2,"TuT",38260,38240,38500,38500,38250,38500,0.007,-250,38375,"TuT",20,0,TRUE,FALSE,FALSE,0.65,"young",34,165,68,"m"
6,"LEG CURL",1,"Con01",2620,2580,2650,2650,2600,2650,0.019,-50,2625,"Con",40,0,FALSE,FALSE,FALSE,1.89,"young",34,165,68,"m"
6,"LEG CURL",1,"Con02",2140,2140,2100,2050,2140,2075,0.03,65,2107.5,"Con",0,50,FALSE,FALSE,FALSE,3.13,"young",34,165,68,"m"
6,"LEG CURL",1,"Con03",2080,2080,2000,2000,2080,2000,0.038,80,2040,"Con",0,0,FALSE,FALSE,FALSE,4,"young",34,165,68,"m"
6,"LEG CURL",1,"Con04",2180,2220,2200,2200,2200,2200,0,0,2200,"Con",-40,0,FALSE,FALSE,FALSE,0,"young",34,165,68,"m"
6,"LEG CURL",1,"Con05",2340,2340,2350,2350,2340,2350,0.004,-10,2345,"Con",0,0,FALSE,FALSE,FALSE,0.43,"young",34,165,68,"m"
6,"LEG CURL",1,"Con06",2560,2540,2550,2650,2550,2600,0.02,-50,2575,"Con",20,-100,FALSE,FALSE,FALSE,1.92,"young",34,165,68,"m"
6,"LEG CURL",1,"Con07",2320,2360,2400,2400,2340,2400,0.026,-60,2370,"Con",-40,0,FALSE,FALSE,FALSE,2.5,"young",34,165,68,"m"
6,"LEG CURL",1,"Con08",2280,2260,2300,2300,2270,2300,0.013,-30,2285,"Con",20,0,FALSE,FALSE,FALSE,1.3,"young",34,165,68,"m"
6,"LEG CURL",1,"Con09",2520,2560,2650,2700,2540,2675,0.053,-135,2607.5,"Con",-40,-50,FALSE,FALSE,FALSE,5.05,"young",34,165,68,"m"
6,"LEG CURL",1,"Con10",2440,2460,2600,2650,2450,2625,0.071,-175,2537.5,"Con",-20,-50,FALSE,FALSE,FALSE,6.67,"young",34,165,68,"m"
6,"LEG CURL",2,"Con01",2500,2540,2500,2550,2520,2525,0.002,-5,2522.5,"Con",-40,-50,FALSE,FALSE,FALSE,0.2,"young",34,165,68,"m"
6,"LEG CURL",2,"Con02",2200,2220,2250,2250,2210,2250,0.018,-40,2230,"Con",-20,0,FALSE,FALSE,FALSE,1.78,"young",34,165,68,"m"
6,"LEG CURL",2,"Con03",2180,2200,2250,2300,2190,2275,0.039,-85,2232.5,"Con",-20,-50,FALSE,FALSE,FALSE,3.74,"young",34,165,68,"m"
6,"LEG CURL",2,"Con04",2100,2160,2100,2150,2130,2125,0.002,5,2127.5,"Con",-60,-50,FALSE,FALSE,FALSE,0.24,"young",34,165,68,"m"
6,"LEG CURL",2,"Con05",2440,2460,2400,2450,2450,2425,0.01,25,2437.5,"Con",-20,-50,FALSE,FALSE,FALSE,1.03,"young",34,165,68,"m"
6,"LEG CURL",2,"Con06",2400,2400,2350,2300,2400,2325,0.031,75,2362.5,"Con",0,50,FALSE,FALSE,FALSE,3.23,"young",34,165,68,"m"
6,"LEG CURL",2,"Con07",1680,1680,1750,1750,1680,1750,0.042,-70,1715,"Con",0,0,FALSE,FALSE,FALSE,4,"young",34,165,68,"m"
6,"LEG CURL",2,"Con08",1660,1700,1800,1800,1680,1800,0.071,-120,1740,"Con",-40,0,FALSE,FALSE,FALSE,6.67,"young",34,165,68,"m"
6,"LEG CURL",2,"Con09",1600,1600,1750,1750,1600,1750,0.094,-150,1675,"Con",0,0,FALSE,FALSE,FALSE,8.57,"young",34,165,68,"m"
6,"LEG CURL",2,"Con10",1700,1760,1850,1900,1730,1875,0.084,-145,1802.5,"Con",-60,-50,FALSE,FALSE,FALSE,7.73,"young",34,165,68,"m"
6,"LEG CURL",1,"Ecc01",2420,2440,2400,2450,2430,2425,0.002,5,2427.5,"Ecc",-20,-50,FALSE,FALSE,FALSE,0.21,"young",34,165,68,"m"
6,"LEG CURL",1,"Ecc02",2560,2560,2650,2650,2560,2650,0.035,-90,2605,"Ecc",0,0,FALSE,FALSE,FALSE,3.4,"young",34,165,68,"m"
6,"LEG CURL",1,"Ecc03",2200,2160,2200,2250,2180,2225,0.021,-45,2202.5,"Ecc",40,-50,FALSE,FALSE,FALSE,2.02,"young",34,165,68,"m"
6,"LEG CURL",1,"Ecc04",2780,2780,2800,2750,2780,2775,0.002,5,2777.5,"Ecc",0,50,FALSE,FALSE,FALSE,0.18,"young",34,165,68,"m"
6,"LEG CURL",1,"Ecc05",2700,2720,2700,2650,2710,2675,0.013,35,2692.5,"Ecc",-20,50,FALSE,FALSE,FALSE,1.31,"young",34,165,68,"m"
6,"LEG CURL",1,"Ecc06",2440,2420,2400,2350,2430,2375,0.023,55,2402.5,"Ecc",20,50,FALSE,FALSE,FALSE,2.32,"young",34,165,68,"m"
6,"LEG CURL",1,"Ecc07",2280,2260,2200,2200,2270,2200,0.031,70,2235,"Ecc",20,0,FALSE,FALSE,FALSE,3.18,"young",34,165,68,"m"
6,"LEG CURL",1,"Ecc08",1880,1860,1850,1850,1870,1850,0.011,20,1860,"Ecc",20,0,FALSE,FALSE,FALSE,1.08,"young",34,165,68,"m"
6,"LEG CURL",1,"Ecc09",2980,2960,2850,2750,2970,2800,0.057,170,2885,"Ecc",20,100,FALSE,FALSE,FALSE,6.07,"young",34,165,68,"m"
6,"LEG CURL",1,"Ecc10",3480,3480,3450,3400,3480,3425,0.016,55,3452.5,"Ecc",0,50,FALSE,FALSE,FALSE,1.61,"young",34,165,68,"m"
6,"LEG CURL",2,"Ecc01",2880,2840,2900,2850,2860,2875,0.005,-15,2867.5,"Ecc",40,50,FALSE,FALSE,FALSE,0.52,"young",34,165,68,"m"
6,"LEG CURL",2,"Ecc02",2560,2540,2450,2450,2550,2450,0.039,100,2500,"Ecc",20,0,FALSE,FALSE,FALSE,4.08,"young",34,165,68,"m"
6,"LEG CURL",2,"Ecc03",2600,2560,2600,2500,2580,2550,0.012,30,2565,"Ecc",40,100,FALSE,FALSE,FALSE,1.18,"young",34,165,68,"m"
6,"LEG CURL",2,"Ecc04",2780,2740,2750,2750,2760,2750,0.004,10,2755,"Ecc",40,0,FALSE,FALSE,FALSE,0.36,"young",34,165,68,"m"
6,"LEG CURL",2,"Ecc05",2220,2220,2300,2250,2220,2275,0.025,-55,2247.5,"Ecc",0,50,FALSE,FALSE,FALSE,2.42,"young",34,165,68,"m"
6,"LEG CURL",2,"Ecc06",2480,2480,2500,2550,2480,2525,0.018,-45,2502.5,"Ecc",0,-50,FALSE,FALSE,FALSE,1.78,"young",34,165,68,"m"
6,"LEG CURL",2,"Ecc07",2100,2060,1950,1950,2080,1950,0.062,130,2015,"Ecc",40,0,FALSE,FALSE,FALSE,6.67,"young",34,165,68,"m"
6,"LEG CURL",2,"Ecc08",2040,2040,1900,1900,2040,1900,0.069,140,1970,"Ecc",0,0,FALSE,FALSE,FALSE,7.37,"young",34,165,68,"m"
6,"LEG CURL",2,"Ecc09",2000,1960,1850,1800,1980,1825,0.078,155,1902.5,"Ecc",40,50,FALSE,FALSE,FALSE,8.49,"young",34,165,68,"m"
6,"LEG CURL",2,"Ecc10",3520,3500,3500,3500,3510,3500,0.003,10,3505,"Ecc",20,0,FALSE,FALSE,FALSE,0.29,"young",34,165,68,"m"
6,"LEG CURL",1,"Rep01",5040,5020,5050,5100,5030,5075,0.009,-45,5052.5,"Rep",20,-50,FALSE,FALSE,FALSE,0.89,"young",34,165,68,"m"
6,"LEG CURL",1,"Rep02",4700,4700,4750,4700,4700,4725,0.005,-25,4712.5,"Rep",0,50,FALSE,FALSE,FALSE,0.53,"young",34,165,68,"m"
6,"LEG CURL",1,"Rep03",4280,4240,4200,4250,4260,4225,0.008,35,4242.5,"Rep",40,-50,FALSE,FALSE,FALSE,0.83,"young",34,165,68,"m"
6,"LEG CURL",1,"Rep04",4960,5000,5000,4950,4980,4975,0.001,5,4977.5,"Rep",-40,50,FALSE,FALSE,FALSE,0.1,"young",34,165,68,"m"
6,"LEG CURL",1,"Rep05",5040,5060,5050,5000,5050,5025,0.005,25,5037.5,"Rep",-20,50,FALSE,FALSE,FALSE,0.5,"young",34,165,68,"m"
6,"LEG CURL",1,"Rep06",5000,4960,4950,5000,4980,4975,0.001,5,4977.5,"Rep",40,-50,FALSE,FALSE,FALSE,0.1,"young",34,165,68,"m"
6,"LEG CURL",1,"Rep07",4600,4620,4600,4600,4610,4600,0.002,10,4605,"Rep",-20,0,FALSE,FALSE,FALSE,0.22,"young",34,165,68,"m"
6,"LEG CURL",1,"Rep08",4160,4120,4150,4150,4140,4150,0.002,-10,4145,"Rep",40,0,FALSE,FALSE,FALSE,0.24,"young",34,165,68,"m"
6,"LEG CURL",1,"Rep09",5500,5520,5500,5450,5510,5475,0.006,35,5492.5,"Rep",-20,50,FALSE,FALSE,FALSE,0.64,"young",34,165,68,"m"
6,"LEG CURL",1,"Rep10",5920,5940,6050,6050,5930,6050,0.02,-120,5990,"Rep",-20,0,FALSE,FALSE,FALSE,1.98,"young",34,165,68,"m"
6,"LEG CURL",2,"Rep01",5380,5380,5400,5400,5380,5400,0.004,-20,5390,"Rep",0,0,FALSE,FALSE,FALSE,0.37,"young",34,165,68,"m"
6,"LEG CURL",2,"Rep02",4760,4760,4700,4700,4760,4700,0.013,60,4730,"Rep",0,0,FALSE,FALSE,FALSE,1.28,"young",34,165,68,"m"
6,"LEG CURL",2,"Rep03",4780,4760,4850,4800,4770,4825,0.012,-55,4797.5,"Rep",20,50,FALSE,FALSE,FALSE,1.14,"young",34,165,68,"m"
6,"LEG CURL",2,"Rep04",4880,4900,4850,4900,4890,4875,0.003,15,4882.5,"Rep",-20,-50,FALSE,FALSE,FALSE,0.31,"young",34,165,68,"m"
6,"LEG CURL",2,"Rep05",4660,4680,4700,4700,4670,4700,0.006,-30,4685,"Rep",-20,0,FALSE,FALSE,FALSE,0.64,"young",34,165,68,"m"
6,"LEG CURL",2,"Rep06",4880,4880,4850,4850,4880,4850,0.006,30,4865,"Rep",0,0,FALSE,FALSE,FALSE,0.62,"young",34,165,68,"m"
6,"LEG CURL",2,"Rep07",3780,3740,3700,3700,3760,3700,0.016,60,3730,"Rep",40,0,FALSE,FALSE,FALSE,1.62,"young",34,165,68,"m"
6,"LEG CURL",2,"Rep08",3700,3740,3700,3700,3720,3700,0.005,20,3710,"Rep",-40,0,FALSE,FALSE,FALSE,0.54,"young",34,165,68,"m"
6,"LEG CURL",2,"Rep09",3600,3560,3600,3550,3580,3575,0.001,5,3577.5,"Rep",40,50,FALSE,FALSE,FALSE,0.14,"young",34,165,68,"m"
6,"LEG CURL",2,"Rep10",5220,5260,5350,5400,5240,5375,0.026,-135,5307.5,"Rep",-40,-50,FALSE,FALSE,FALSE,2.51,"young",34,165,68,"m"
6,"LEG CURL",1,"TuT",49200,49180,49300,49250,49190,49275,0.002,-85,49232.5,"TuT",20,50,FALSE,FALSE,FALSE,0.17,"young",34,165,68,"m"
6,"LEG CURL",2,"TuT",45640,45660,45700,45700,45650,45700,0.001,-50,45675,"TuT",-20,0,FALSE,FALSE,FALSE,0.11,"young",34,165,68,"m"
6,"ABDUCTOR",1,"Con01",1120,1140,1800,1550,1130,1675,0.482,-545,1402.5,"Con",-20,250,TRUE,FALSE,TRUE,32.54,"young",34,165,68,"m"
6,"ABDUCTOR",1,"Con02",1220,1260,1650,1600,1240,1625,0.31,-385,1432.5,"Con",-40,50,TRUE,TRUE,FALSE,23.69,"young",34,165,68,"m"
6,"ABDUCTOR",1,"Con03",1200,1260,1300,1450,1230,1375,0.118,-145,1302.5,"Con",-60,-150,FALSE,TRUE,FALSE,10.55,"young",34,165,68,"m"
6,"ABDUCTOR",1,"Con04",1080,1100,1000,1200,1090,1100,0.009,-10,1095,"Con",-20,-200,FALSE,FALSE,FALSE,0.91,"young",34,165,68,"m"
6,"ABDUCTOR",1,"Con05",1060,1100,1150,1200,1080,1175,0.088,-95,1127.5,"Con",-40,-50,FALSE,TRUE,FALSE,8.09,"young",34,165,68,"m"
6,"ABDUCTOR",1,"Con06",1060,1120,1200,1300,1090,1250,0.147,-160,1170,"Con",-60,-100,FALSE,TRUE,FALSE,12.8,"young",34,165,68,"m"
6,"ABDUCTOR",1,"Con07",1040,1080,1250,1700,1060,1475,0.392,-415,1267.5,"Con",-40,-450,TRUE,TRUE,TRUE,28.14,"young",34,165,68,"m"
6,"ABDUCTOR",1,"Con08",1060,1080,1550,1150,1070,1350,0.262,-280,1210,"Con",-20,400,FALSE,FALSE,TRUE,20.74,"young",34,165,68,"m"
6,"ABDUCTOR",1,"Con09",1220,1200,1750,1350,1210,1550,0.281,-340,1380,"Con",20,400,TRUE,FALSE,TRUE,21.94,"young",34,165,68,"m"
6,"ABDUCTOR",1,"Con10",1180,1220,1800,1800,1200,1800,0.5,-600,1500,"Con",-40,0,TRUE,TRUE,FALSE,33.33,"young",34,165,68,"m"
6,"ABDUCTOR",2,"Con01",1100,1140,1200,1400,1120,1300,0.161,-180,1210,"Con",-40,-200,FALSE,TRUE,FALSE,13.85,"young",34,165,68,"m"
6,"ABDUCTOR",2,"Con02",940,980,1450,1200,960,1325,0.38,-365,1142.5,"Con",-40,250,TRUE,TRUE,TRUE,27.55,"young",34,165,68,"m"
6,"ABDUCTOR",2,"Con03",1220,1240,1450,1250,1230,1350,0.098,-120,1290,"Con",-20,200,FALSE,FALSE,FALSE,8.89,"young",34,165,68,"m"
6,"ABDUCTOR",2,"Con04",1060,1100,1600,1200,1080,1400,0.296,-320,1240,"Con",-40,400,TRUE,TRUE,TRUE,22.86,"young",34,165,68,"m"
6,"ABDUCTOR",2,"Con05",1000,1020,1200,1950,1010,1575,0.559,-565,1292.5,"Con",-20,-750,TRUE,FALSE,TRUE,35.87,"young",34,165,68,"m"
6,"ABDUCTOR",2,"Con06",980,1020,1100,1350,1000,1225,0.225,-225,1112.5,"Con",-40,-250,FALSE,TRUE,TRUE,18.37,"young",34,165,68,"m"
6,"ABDUCTOR",2,"Con07",880,940,850,950,910,900,0.011,10,905,"Con",-60,-100,FALSE,TRUE,FALSE,1.11,"young",34,165,68,"m"
6,"ABDUCTOR",2,"Con08",1000,1040,1050,1050,1020,1050,0.029,-30,1035,"Con",-40,0,FALSE,TRUE,FALSE,2.86,"young",34,165,68,"m"
6,"ABDUCTOR",2,"Con09",1020,1020,1050,1050,1020,1050,0.029,-30,1035,"Con",0,0,FALSE,FALSE,FALSE,2.86,"young",34,165,68,"m"
6,"ABDUCTOR",2,"Con10",960,1020,1350,1450,990,1400,0.414,-410,1195,"Con",-60,-100,TRUE,TRUE,FALSE,29.29,"young",34,165,68,"m"
6,"ABDUCTOR",1,"Ecc01",2400,2360,1900,2000,2380,1950,0.181,430,2165,"Ecc",40,-100,TRUE,TRUE,FALSE,22.05,"young",34,165,68,"m"
6,"ABDUCTOR",1,"Ecc02",2640,2580,2500,2350,2610,2425,0.071,185,2517.5,"Ecc",60,150,FALSE,TRUE,FALSE,7.63,"young",34,165,68,"m"
6,"ABDUCTOR",1,"Ecc03",2240,2200,2200,2100,2220,2150,0.032,70,2185,"Ecc",40,100,FALSE,TRUE,FALSE,3.26,"young",34,165,68,"m"
6,"ABDUCTOR",1,"Ecc04",2660,2620,2650,2500,2640,2575,0.025,65,2607.5,"Ecc",40,150,FALSE,TRUE,FALSE,2.52,"young",34,165,68,"m"
6,"ABDUCTOR",1,"Ecc05",2620,2560,2500,2400,2590,2450,0.054,140,2520,"Ecc",60,100,FALSE,TRUE,FALSE,5.71,"young",34,165,68,"m"
6,"ABDUCTOR",1,"Ecc06",2440,2400,2250,1750,2420,2000,0.174,420,2210,"Ecc",40,500,TRUE,TRUE,TRUE,21,"young",34,165,68,"m"
6,"ABDUCTOR",1,"Ecc07",1880,1880,1450,1750,1880,1600,0.149,280,1740,"Ecc",0,-300,FALSE,FALSE,FALSE,17.5,"young",34,165,68,"m"
6,"ABDUCTOR",1,"Ecc08",2100,2100,1550,2050,2100,1800,0.143,300,1950,"Ecc",0,-500,FALSE,FALSE,TRUE,16.67,"young",34,165,68,"m"
6,"ABDUCTOR",1,"Ecc09",2160,2120,1550,1550,2140,1550,0.276,590,1845,"Ecc",40,0,TRUE,TRUE,FALSE,38.06,"young",34,165,68,"m"
6,"ABDUCTOR",1,"Ecc10",1980,1940,1850,1900,1960,1875,0.043,85,1917.5,"Ecc",40,-50,FALSE,TRUE,FALSE,4.53,"young",34,165,68,"m"
6,"ABDUCTOR",2,"Ecc01",2360,2320,1900,2150,2340,2025,0.135,315,2182.5,"Ecc",40,-250,TRUE,TRUE,FALSE,15.56,"young",34,165,68,"m"
6,"ABDUCTOR",2,"Ecc02",2380,2380,2150,2300,2380,2225,0.065,155,2302.5,"Ecc",0,-150,FALSE,FALSE,FALSE,6.97,"young",34,165,68,"m"
6,"ABDUCTOR",2,"Ecc03",2500,2440,1950,2400,2470,2175,0.119,295,2322.5,"Ecc",60,-450,FALSE,TRUE,TRUE,13.56,"young",34,165,68,"m"
6,"ABDUCTOR",2,"Ecc04",2480,2480,2250,1500,2480,1875,0.244,605,2177.5,"Ecc",0,750,TRUE,FALSE,TRUE,32.27,"young",34,165,68,"m"
6,"ABDUCTOR",2,"Ecc05",2440,2380,2250,2050,2410,2150,0.108,260,2280,"Ecc",60,200,FALSE,TRUE,FALSE,12.09,"young",34,165,68,"m"
6,"ABDUCTOR",2,"Ecc06",2400,2360,2400,2300,2380,2350,0.013,30,2365,"Ecc",40,100,FALSE,TRUE,FALSE,1.28,"young",34,165,68,"m"
6,"ABDUCTOR",2,"Ecc07",2220,2160,2200,2200,2190,2200,0.005,-10,2195,"Ecc",60,0,FALSE,TRUE,FALSE,0.45,"young",34,165,68,"m"
6,"ABDUCTOR",2,"Ecc08",2060,2060,2100,2050,2060,2075,0.007,-15,2067.5,"Ecc",0,50,FALSE,FALSE,FALSE,0.72,"young",34,165,68,"m"
6,"ABDUCTOR",2,"Ecc09",2380,2320,2050,1950,2350,2000,0.149,350,2175,"Ecc",60,100,TRUE,TRUE,FALSE,17.5,"young",34,165,68,"m"
6,"ABDUCTOR",2,"Ecc10",2440,2460,2300,2400,2450,2350,0.041,100,2400,"Ecc",-20,-100,FALSE,FALSE,FALSE,4.26,"young",34,165,68,"m"
6,"ABDUCTOR",1,"Rep01",3520,3500,3700,3550,3510,3625,0.033,-115,3567.5,"Rep",20,150,FALSE,FALSE,FALSE,3.17,"young",34,165,68,"m"
6,"ABDUCTOR",1,"Rep02",3860,3840,4150,3950,3850,4050,0.052,-200,3950,"Rep",20,200,FALSE,FALSE,FALSE,4.94,"young",34,165,68,"m"
6,"ABDUCTOR",1,"Rep03",3440,3460,3500,3550,3450,3525,0.022,-75,3487.5,"Rep",-20,-50,FALSE,FALSE,FALSE,2.13,"young",34,165,68,"m"
6,"ABDUCTOR",1,"Rep04",3740,3720,3650,3700,3730,3675,0.015,55,3702.5,"Rep",20,-50,FALSE,FALSE,FALSE,1.5,"young",34,165,68,"m"
6,"ABDUCTOR",1,"Rep05",3680,3660,3650,3600,3670,3625,0.012,45,3647.5,"Rep",20,50,FALSE,FALSE,FALSE,1.24,"young",34,165,68,"m"
6,"ABDUCTOR",1,"Rep06",3500,3520,3450,3050,3510,3250,0.074,260,3380,"Rep",-20,400,FALSE,FALSE,TRUE,8,"young",34,165,68,"m"
6,"ABDUCTOR",1,"Rep07",2920,2960,2700,3450,2940,3075,0.046,-135,3007.5,"Rep",-40,-750,FALSE,FALSE,TRUE,4.39,"young",34,165,68,"m"
6,"ABDUCTOR",1,"Rep08",3160,3180,3100,3200,3170,3150,0.006,20,3160,"Rep",-20,-100,FALSE,FALSE,FALSE,0.63,"young",34,165,68,"m"
6,"ABDUCTOR",1,"Rep09",3380,3320,3300,2900,3350,3100,0.075,250,3225,"Rep",60,400,FALSE,FALSE,TRUE,8.06,"young",34,165,68,"m"
6,"ABDUCTOR",1,"Rep10",3160,3160,3650,3700,3160,3675,0.163,-515,3417.5,"Rep",0,-50,TRUE,FALSE,FALSE,14.01,"young",34,165,68,"m"
6,"ABDUCTOR",2,"Rep01",3460,3460,3100,3550,3460,3325,0.039,135,3392.5,"Rep",0,-450,FALSE,FALSE,TRUE,4.06,"young",34,165,68,"m"
6,"ABDUCTOR",2,"Rep02",3320,3360,3600,3500,3340,3550,0.063,-210,3445,"Rep",-40,100,FALSE,FALSE,FALSE,5.92,"young",34,165,68,"m"
6,"ABDUCTOR",2,"Rep03",3720,3680,3400,3650,3700,3525,0.047,175,3612.5,"Rep",40,-250,FALSE,FALSE,FALSE,4.96,"young",34,165,68,"m"
6,"ABDUCTOR",2,"Rep04",3540,3580,3850,2700,3560,3275,0.08,285,3417.5,"Rep",-40,1150,FALSE,FALSE,TRUE,8.7,"young",34,165,68,"m"
6,"ABDUCTOR",2,"Rep05",3440,3400,3450,4000,3420,3725,0.089,-305,3572.5,"Rep",40,-550,TRUE,FALSE,TRUE,8.19,"young",34,165,68,"m"
6,"ABDUCTOR",2,"Rep06",3380,3380,3500,3650,3380,3575,0.058,-195,3477.5,"Rep",0,-150,FALSE,FALSE,FALSE,5.45,"young",34,165,68,"m"
6,"ABDUCTOR",2,"Rep07",3100,3100,3050,3150,3100,3100,0,0,3100,"Rep",0,-100,FALSE,FALSE,FALSE,0,"young",34,165,68,"m"
6,"ABDUCTOR",2,"Rep08",3060,3100,3150,3100,3080,3125,0.015,-45,3102.5,"Rep",-40,50,FALSE,FALSE,FALSE,1.44,"young",34,165,68,"m"
6,"ABDUCTOR",2,"Rep09",3400,3340,3100,3000,3370,3050,0.095,320,3210,"Rep",60,100,TRUE,FALSE,FALSE,10.49,"young",34,165,68,"m"
6,"ABDUCTOR",2,"Rep10",3400,3480,3650,3850,3440,3750,0.09,-310,3595,"Rep",-80,-200,TRUE,TRUE,FALSE,8.27,"young",34,165,68,"m"
6,"ABDUCTOR",1,"TuT",34360,34320,34850,34650,34340,34750,0.012,-410,34545,"TuT",40,200,FALSE,TRUE,FALSE,1.18,"young",34,165,68,"m"
6,"ABDUCTOR",2,"TuT",33820,33880,33850,34150,33850,34000,0.004,-150,33925,"TuT",-60,-300,FALSE,TRUE,FALSE,0.44,"young",34,165,68,"m"
6,"ADDUCTOR",1,"Con01",920,960,1050,2350,940,1700,0.809,-760,1320,"Con",-40,-1300,TRUE,TRUE,TRUE,44.71,"young",34,165,68,"m"
6,"ADDUCTOR",1,"Con02",920,920,1450,1350,920,1400,0.522,-480,1160,"Con",0,100,FALSE,FALSE,FALSE,34.29,"young",34,165,68,"m"
6,"ADDUCTOR",1,"Con03",800,820,2300,1050,810,1675,1.068,-865,1242.5,"Con",-20,1250,TRUE,FALSE,TRUE,51.64,"young",34,165,68,"m"
6,"ADDUCTOR",1,"Con04",1280,1320,2100,750,1300,1425,0.096,-125,1362.5,"Con",-40,1350,FALSE,TRUE,TRUE,8.77,"young",34,165,68,"m"
6,"ADDUCTOR",1,"Con05",720,740,800,500,730,650,0.11,80,690,"Con",-20,300,FALSE,FALSE,FALSE,12.31,"young",34,165,68,"m"
6,"ADDUCTOR",1,"Con06",920,920,600,1400,920,1000,0.087,-80,960,"Con",0,-800,FALSE,FALSE,TRUE,8,"young",34,165,68,"m"
6,"ADDUCTOR",1,"Con07",960,900,1500,1450,930,1475,0.586,-545,1202.5,"Con",60,50,FALSE,TRUE,FALSE,36.95,"young",34,165,68,"m"
6,"ADDUCTOR",1,"Con08",700,740,1450,0,720,725,0.007,-5,722.5,"Con",-40,1450,FALSE,TRUE,TRUE,0.69,"young",34,165,68,"m"
6,"ADDUCTOR",1,"Con09",1020,1040,1850,0,1030,925,0.102,105,977.5,"Con",-20,1850,FALSE,FALSE,TRUE,11.35,"young",34,165,68,"m"
6,"ADDUCTOR",1,"Con10",920,920,3800,39550,920,21675,22.56,-20755,11297.5,"Con",0,-35750,TRUE,FALSE,TRUE,95.76,"young",34,165,68,"m"
6,"ADDUCTOR",2,"Con01",720,760,1300,0,740,650,0.122,90,695,"Con",-40,1300,FALSE,TRUE,TRUE,13.85,"young",34,165,68,"m"
6,"ADDUCTOR",2,"Con02",900,900,1500,0,900,750,0.167,150,825,"Con",0,1500,FALSE,FALSE,TRUE,20,"young",34,165,68,"m"
6,"ADDUCTOR",2,"Con03",1060,1060,1750,10100,1060,5925,4.59,-4865,3492.5,"Con",0,-8350,TRUE,FALSE,TRUE,82.11,"young",34,165,68,"m"
6,"ADDUCTOR",2,"Con04",1160,1180,2050,450,1170,1250,0.068,-80,1210,"Con",-20,1600,FALSE,FALSE,TRUE,6.4,"young",34,165,68,"m"
6,"ADDUCTOR",2,"Con05",1060,1060,1150,300,1060,725,0.316,335,892.5,"Con",0,850,FALSE,FALSE,TRUE,46.21,"young",34,165,68,"m"
6,"ADDUCTOR",2,"Con06",1000,960,700,750,980,725,0.26,255,852.5,"Con",40,-50,FALSE,TRUE,FALSE,35.17,"young",34,165,68,"m"
6,"ADDUCTOR",2,"Con07",840,860,850,1050,850,950,0.118,-100,900,"Con",-20,-200,FALSE,FALSE,FALSE,10.53,"young",34,165,68,"m"
6,"ADDUCTOR",2,"Con08",780,740,750,0,760,375,0.507,385,567.5,"Con",40,750,FALSE,TRUE,TRUE,102.67,"young",34,165,68,"m"
6,"ADDUCTOR",2,"Con09",840,880,850,33250,860,17050,18.826,-16190,8955,"Con",-40,-32400,TRUE,TRUE,TRUE,94.96,"young",34,165,68,"m"
6,"ADDUCTOR",2,"Con10",1000,1020,1600,0,1010,800,0.208,210,905,"Con",-20,1600,FALSE,FALSE,TRUE,26.25,"young",34,165,68,"m"
6,"ADDUCTOR",1,"Ecc01",2380,2380,2550,1750,2380,2150,0.097,230,2265,"Ecc",0,800,FALSE,FALSE,TRUE,10.7,"young",34,165,68,"m"
6,"ADDUCTOR",1,"Ecc02",2700,2700,900,2150,2700,1525,0.435,1175,2112.5,"Ecc",0,-1250,TRUE,FALSE,TRUE,77.05,"young",34,165,68,"m"
6,"ADDUCTOR",1,"Ecc03",2440,2380,1700,2850,2410,2275,0.056,135,2342.5,"Ecc",60,-1150,FALSE,TRUE,TRUE,5.93,"young",34,165,68,"m"
6,"ADDUCTOR",1,"Ecc04",2500,2460,1900,2700,2480,2300,0.073,180,2390,"Ecc",40,-800,FALSE,TRUE,TRUE,7.83,"young",34,165,68,"m"
6,"ADDUCTOR",1,"Ecc05",2900,2920,3000,2850,2910,2925,0.005,-15,2917.5,"Ecc",-20,150,FALSE,FALSE,FALSE,0.51,"young",34,165,68,"m"
6,"ADDUCTOR",1,"Ecc06",2760,2800,2900,2300,2780,2600,0.065,180,2690,"Ecc",-40,600,FALSE,TRUE,TRUE,6.92,"young",34,165,68,"m"
6,"ADDUCTOR",1,"Ecc07",2860,2840,2250,2250,2850,2250,0.211,600,2550,"Ecc",20,0,TRUE,FALSE,FALSE,26.67,"young",34,165,68,"m"
6,"ADDUCTOR",1,"Ecc08",2820,2800,1950,0,2810,975,0.653,1835,1892.5,"Ecc",20,1950,TRUE,FALSE,TRUE,188.21,"young",34,165,68,"m"
6,"ADDUCTOR",1,"Ecc09",2700,2680,1300,0,2690,650,0.758,2040,1670,"Ecc",20,1300,TRUE,FALSE,TRUE,313.85,"young",34,165,68,"m"
6,"ADDUCTOR",1,"Ecc10",1860,1880,2000,1850,1870,1925,0.029,-55,1897.5,"Ecc",-20,150,FALSE,FALSE,FALSE,2.86,"young",34,165,68,"m"
6,"ADDUCTOR",2,"Ecc01",1860,1840,1100,0,1850,550,0.703,1300,1200,"Ecc",20,1100,TRUE,FALSE,TRUE,236.36,"young",34,165,68,"m"
6,"ADDUCTOR",2,"Ecc02",1700,1720,1300,0,1710,650,0.62,1060,1180,"Ecc",-20,1300,TRUE,FALSE,TRUE,163.08,"young",34,165,68,"m"
6,"ADDUCTOR",2,"Ecc03",2340,2320,1250,5200,2330,3225,0.384,-895,2777.5,"Ecc",20,-3950,TRUE,FALSE,TRUE,27.75,"young",34,165,68,"m"
6,"ADDUCTOR",2,"Ecc04",2240,2220,1600,2600,2230,2100,0.058,130,2165,"Ecc",20,-1000,FALSE,FALSE,TRUE,6.19,"young",34,165,68,"m"
6,"ADDUCTOR",2,"Ecc05",1900,1940,2000,2550,1920,2275,0.185,-355,2097.5,"Ecc",-40,-550,FALSE,TRUE,TRUE,15.6,"young",34,165,68,"m"
6,"ADDUCTOR",2,"Ecc06",2040,2040,2300,2400,2040,2350,0.152,-310,2195,"Ecc",0,-100,FALSE,FALSE,FALSE,13.19,"young",34,165,68,"m"
6,"ADDUCTOR",2,"Ecc07",2520,2540,2500,1400,2530,1950,0.229,580,2240,"Ecc",-20,1100,TRUE,FALSE,TRUE,29.74,"young",34,165,68,"m"
6,"ADDUCTOR",2,"Ecc08",2000,1980,2100,0,1990,1050,0.472,940,1520,"Ecc",20,2100,TRUE,FALSE,TRUE,89.52,"young",34,165,68,"m"
6,"ADDUCTOR",2,"Ecc09",2100,2080,1650,1750,2090,1700,0.187,390,1895,"Ecc",20,-100,FALSE,FALSE,FALSE,22.94,"young",34,165,68,"m"
6,"ADDUCTOR",2,"Ecc10",1780,1780,1450,0,1780,725,0.593,1055,1252.5,"Ecc",0,1450,TRUE,FALSE,TRUE,145.52,"young",34,165,68,"m"
6,"ADDUCTOR",1,"Rep01",3300,3340,3600,4100,3320,3850,0.16,-530,3585,"Rep",-40,-500,TRUE,FALSE,TRUE,13.77,"young",34,165,68,"m"
6,"ADDUCTOR",1,"Rep02",3620,3620,2350,3500,3620,2925,0.192,695,3272.5,"Rep",0,-1150,TRUE,FALSE,TRUE,23.76,"young",34,165,68,"m"
6,"ADDUCTOR",1,"Rep03",3240,3200,4000,3900,3220,3950,0.227,-730,3585,"Rep",40,100,TRUE,FALSE,FALSE,18.48,"young",34,165,68,"m"
6,"ADDUCTOR",1,"Rep04",3780,3780,4000,3450,3780,3725,0.015,55,3752.5,"Rep",0,550,FALSE,FALSE,TRUE,1.48,"young",34,165,68,"m"
6,"ADDUCTOR",1,"Rep05",3620,3660,3800,3350,3640,3575,0.018,65,3607.5,"Rep",-40,450,FALSE,FALSE,TRUE,1.82,"young",34,165,68,"m"
6,"ADDUCTOR",1,"Rep06",3680,3720,3500,3700,3700,3600,0.027,100,3650,"Rep",-40,-200,FALSE,FALSE,FALSE,2.78,"young",34,165,68,"m"
6,"ADDUCTOR",1,"Rep07",3820,3740,3750,3700,3780,3725,0.015,55,3752.5,"Rep",80,50,FALSE,TRUE,FALSE,1.48,"young",34,165,68,"m"
6,"ADDUCTOR",1,"Rep08",3520,3540,3400,0,3530,1700,0.518,1830,2615,"Rep",-20,3400,TRUE,FALSE,TRUE,107.65,"young",34,165,68,"m"
6,"ADDUCTOR",1,"Rep09",3720,3720,3150,0,3720,1575,0.577,2145,2647.5,"Rep",0,3150,TRUE,FALSE,TRUE,136.19,"young",34,165,68,"m"
6,"ADDUCTOR",1,"Rep10",2780,2800,5800,41400,2790,23600,7.459,-20810,13195,"Rep",-20,-35600,TRUE,FALSE,TRUE,88.18,"young",34,165,68,"m"
6,"ADDUCTOR",2,"Rep01",2580,2600,2400,0,2590,1200,0.537,1390,1895,"Rep",-20,2400,TRUE,FALSE,TRUE,115.83,"young",34,165,68,"m"
6,"ADDUCTOR",2,"Rep02",2600,2620,2800,0,2610,1400,0.464,1210,2005,"Rep",-20,2800,TRUE,FALSE,TRUE,86.43,"young",34,165,68,"m"
6,"ADDUCTOR",2,"Rep03",3400,3380,3000,15300,3390,9150,1.699,-5760,6270,"Rep",20,-12300,TRUE,FALSE,TRUE,62.95,"young",34,165,68,"m"
6,"ADDUCTOR",2,"Rep04",3400,3400,3650,3050,3400,3350,0.015,50,3375,"Rep",0,600,FALSE,FALSE,TRUE,1.49,"young",34,165,68,"m"
6,"ADDUCTOR",2,"Rep05",2960,3000,3150,2850,2980,3000,0.007,-20,2990,"Rep",-40,300,FALSE,FALSE,TRUE,0.67,"young",34,165,68,"m"
6,"ADDUCTOR",2,"Rep06",3040,3000,3000,3150,3020,3075,0.018,-55,3047.5,"Rep",40,-150,FALSE,FALSE,FALSE,1.79,"young",34,165,68,"m"
6,"ADDUCTOR",2,"Rep07",3360,3400,3350,2450,3380,2900,0.142,480,3140,"Rep",-40,900,TRUE,FALSE,TRUE,16.55,"young",34,165,68,"m"
6,"ADDUCTOR",2,"Rep08",2780,2720,2850,0,2750,1425,0.482,1325,2087.5,"Rep",60,2850,TRUE,FALSE,TRUE,92.98,"young",34,165,68,"m"
6,"ADDUCTOR",2,"Rep09",2940,2960,2500,35000,2950,18750,5.356,-15800,10850,"Rep",-20,-32500,TRUE,FALSE,TRUE,84.27,"young",34,165,68,"m"
6,"ADDUCTOR",2,"Rep10",2780,2800,3050,0,2790,1525,0.453,1265,2157.5,"Rep",-20,3050,TRUE,FALSE,TRUE,82.95,"young",34,165,68,"m"
6,"ADDUCTOR",1,"TuT",35080,35120,37350,67100,35100,52225,0.488,-17125,43662.5,"TuT",-40,-29750,TRUE,TRUE,TRUE,32.79,"young",34,165,68,"m"
6,"ADDUCTOR",2,"TuT",29840,29880,29750,61800,29860,45775,0.533,-15915,37817.5,"TuT",-40,-32050,TRUE,TRUE,TRUE,34.77,"young",34,165,68,"m"
6,"LOWER BACK",1,"Con01",1660,1680,1900,1850,1670,1875,0.123,-205,1772.5,"Con",-20,50,TRUE,FALSE,FALSE,10.93,"young",34,165,68,"m"
6,"LOWER BACK",1,"Con02",2020,2060,2000,2000,2040,2000,0.02,40,2020,"Con",-40,0,FALSE,TRUE,FALSE,2,"young",34,165,68,"m"
6,"LOWER BACK",1,"Con03",1840,1860,1850,1850,1850,1850,0,0,1850,"Con",-20,0,FALSE,FALSE,FALSE,0,"young",34,165,68,"m"
6,"LOWER BACK",1,"Con04",1760,1800,1750,1750,1780,1750,0.017,30,1765,"Con",-40,0,FALSE,TRUE,FALSE,1.71,"young",34,165,68,"m"
6,"LOWER BACK",1,"Con05",2080,2060,2100,2100,2070,2100,0.014,-30,2085,"Con",20,0,FALSE,FALSE,FALSE,1.43,"young",34,165,68,"m"
6,"LOWER BACK",1,"Con06",2060,2080,2150,2050,2070,2100,0.014,-30,2085,"Con",-20,100,FALSE,FALSE,FALSE,1.43,"young",34,165,68,"m"
6,"LOWER BACK",1,"Con07",1880,1920,2000,2000,1900,2000,0.053,-100,1950,"Con",-40,0,FALSE,TRUE,FALSE,5,"young",34,165,68,"m"
6,"LOWER BACK",1,"Con08",1800,1840,1950,1950,1820,1950,0.071,-130,1885,"Con",-40,0,FALSE,TRUE,FALSE,6.67,"young",34,165,68,"m"
6,"LOWER BACK",1,"Con09",1780,1820,1950,1950,1800,1950,0.083,-150,1875,"Con",-40,0,FALSE,TRUE,FALSE,7.69,"young",34,165,68,"m"
6,"LOWER BACK",1,"Con10",1760,1840,2000,2050,1800,2025,0.125,-225,1912.5,"Con",-80,-50,TRUE,TRUE,FALSE,11.11,"young",34,165,68,"m"
6,"LOWER BACK",2,"Con01",1720,1720,1700,1750,1720,1725,0.003,-5,1722.5,"Con",0,-50,FALSE,FALSE,FALSE,0.29,"young",34,165,68,"m"
6,"LOWER BACK",2,"Con02",1780,1760,1850,1700,1770,1775,0.003,-5,1772.5,"Con",20,150,FALSE,FALSE,FALSE,0.28,"young",34,165,68,"m"
6,"LOWER BACK",2,"Con03",1700,1700,1800,1700,1700,1750,0.029,-50,1725,"Con",0,100,FALSE,FALSE,FALSE,2.86,"young",34,165,68,"m"
6,"LOWER BACK",2,"Con04",1660,1680,1750,1650,1670,1700,0.018,-30,1685,"Con",-20,100,FALSE,FALSE,FALSE,1.76,"young",34,165,68,"m"
6,"LOWER BACK",2,"Con05",1740,1760,1800,1800,1750,1800,0.029,-50,1775,"Con",-20,0,FALSE,FALSE,FALSE,2.78,"young",34,165,68,"m"
6,"LOWER BACK",2,"Con06",1680,1700,1750,1700,1690,1725,0.021,-35,1707.5,"Con",-20,50,FALSE,FALSE,FALSE,2.03,"young",34,165,68,"m"
6,"LOWER BACK",2,"Con07",1800,1820,1800,1900,1810,1850,0.022,-40,1830,"Con",-20,-100,FALSE,FALSE,FALSE,2.16,"young",34,165,68,"m"
6,"LOWER BACK",2,"Con08",1760,1760,1800,2000,1760,1900,0.08,-140,1830,"Con",0,-200,FALSE,FALSE,TRUE,7.37,"young",34,165,68,"m"
6,"LOWER BACK",2,"Con09",1580,1660,1700,1800,1620,1750,0.08,-130,1685,"Con",-80,-100,FALSE,TRUE,FALSE,7.43,"young",34,165,68,"m"
6,"LOWER BACK",2,"Con10",1460,1460,1800,1800,1460,1800,0.233,-340,1630,"Con",0,0,TRUE,FALSE,FALSE,18.89,"young",34,165,68,"m"
6,"LOWER BACK",1,"Ecc01",2640,2600,2600,2600,2620,2600,0.008,20,2610,"Ecc",40,0,FALSE,FALSE,FALSE,0.77,"young",34,165,68,"m"
6,"LOWER BACK",1,"Ecc02",2400,2380,2400,2400,2390,2400,0.004,-10,2395,"Ecc",20,0,FALSE,FALSE,FALSE,0.42,"young",34,165,68,"m"
6,"LOWER BACK",1,"Ecc03",2420,2400,2450,2450,2410,2450,0.017,-40,2430,"Ecc",20,0,FALSE,FALSE,FALSE,1.63,"young",34,165,68,"m"
6,"LOWER BACK",1,"Ecc04",2540,2540,2550,2550,2540,2550,0.004,-10,2545,"Ecc",0,0,FALSE,FALSE,FALSE,0.39,"young",34,165,68,"m"
6,"LOWER BACK",1,"Ecc05",2840,2820,2750,2800,2830,2775,0.019,55,2802.5,"Ecc",20,-50,FALSE,FALSE,FALSE,1.98,"young",34,165,68,"m"
6,"LOWER BACK",1,"Ecc06",2480,2420,2350,2400,2450,2375,0.031,75,2412.5,"Ecc",60,-50,FALSE,FALSE,FALSE,3.16,"young",34,165,68,"m"
6,"LOWER BACK",1,"Ecc07",2340,2320,2200,2200,2330,2200,0.056,130,2265,"Ecc",20,0,FALSE,FALSE,FALSE,5.91,"young",34,165,68,"m"
6,"LOWER BACK",1,"Ecc08",2360,2340,2250,2250,2350,2250,0.043,100,2300,"Ecc",20,0,FALSE,FALSE,FALSE,4.44,"young",34,165,68,"m"
6,"LOWER BACK",1,"Ecc09",2500,2420,2200,2200,2460,2200,0.106,260,2330,"Ecc",80,0,TRUE,TRUE,FALSE,11.82,"young",34,165,68,"m"
6,"LOWER BACK",1,"Ecc10",2640,2640,2700,2400,2640,2550,0.034,90,2595,"Ecc",0,300,FALSE,FALSE,TRUE,3.53,"young",34,165,68,"m"
6,"LOWER BACK",2,"Ecc01",2300,2300,2250,2400,2300,2325,0.011,-25,2312.5,"Ecc",0,-150,FALSE,FALSE,FALSE,1.08,"young",34,165,68,"m"
6,"LOWER BACK",2,"Ecc02",2340,2340,2250,2350,2340,2300,0.017,40,2320,"Ecc",0,-100,FALSE,FALSE,FALSE,1.74,"young",34,165,68,"m"
6,"LOWER BACK",2,"Ecc03",2420,2440,2350,2450,2430,2400,0.012,30,2415,"Ecc",-20,-100,FALSE,FALSE,FALSE,1.25,"young",34,165,68,"m"
6,"LOWER BACK",2,"Ecc04",2360,2320,2250,2300,2340,2275,0.028,65,2307.5,"Ecc",40,-50,FALSE,FALSE,FALSE,2.86,"young",34,165,68,"m"
6,"LOWER BACK",2,"Ecc05",2240,2220,2200,2200,2230,2200,0.013,30,2215,"Ecc",20,0,FALSE,FALSE,FALSE,1.36,"young",34,165,68,"m"
6,"LOWER BACK",2,"Ecc06",2120,2100,2100,2100,2110,2100,0.005,10,2105,"Ecc",20,0,FALSE,FALSE,FALSE,0.48,"young",34,165,68,"m"
6,"LOWER BACK",2,"Ecc07",2500,2480,2450,2250,2490,2350,0.056,140,2420,"Ecc",20,200,FALSE,FALSE,TRUE,5.96,"young",34,165,68,"m"
6,"LOWER BACK",2,"Ecc08",2400,2340,2300,2200,2370,2250,0.051,120,2310,"Ecc",60,100,FALSE,FALSE,FALSE,5.33,"young",34,165,68,"m"
6,"LOWER BACK",2,"Ecc09",2520,2540,2250,2200,2530,2225,0.121,305,2377.5,"Ecc",-20,50,TRUE,FALSE,FALSE,13.71,"young",34,165,68,"m"
6,"LOWER BACK",2,"Ecc10",2620,2620,2600,2600,2620,2600,0.008,20,2610,"Ecc",0,0,FALSE,FALSE,FALSE,0.77,"young",34,165,68,"m"
6,"LOWER BACK",1,"Rep01",4300,4280,4500,4450,4290,4475,0.043,-185,4382.5,"Rep",20,50,TRUE,FALSE,FALSE,4.13,"young",34,165,68,"m"
6,"LOWER BACK",1,"Rep02",4420,4440,4400,4400,4430,4400,0.007,30,4415,"Rep",-20,0,FALSE,FALSE,FALSE,0.68,"young",34,165,68,"m"
6,"LOWER BACK",1,"Rep03",4260,4260,4300,4300,4260,4300,0.009,-40,4280,"Rep",0,0,FALSE,FALSE,FALSE,0.93,"young",34,165,68,"m"
6,"LOWER BACK",1,"Rep04",4300,4340,4300,4300,4320,4300,0.005,20,4310,"Rep",-40,0,FALSE,FALSE,FALSE,0.47,"young",34,165,68,"m"
6,"LOWER BACK",1,"Rep05",4920,4880,4850,4900,4900,4875,0.005,25,4887.5,"Rep",40,-50,FALSE,FALSE,FALSE,0.51,"young",34,165,68,"m"
6,"LOWER BACK",1,"Rep06",4540,4500,4500,4450,4520,4475,0.01,45,4497.5,"Rep",40,50,FALSE,FALSE,FALSE,1.01,"young",34,165,68,"m"
6,"LOWER BACK",1,"Rep07",4220,4240,4200,4200,4230,4200,0.007,30,4215,"Rep",-20,0,FALSE,FALSE,FALSE,0.71,"young",34,165,68,"m"
6,"LOWER BACK",1,"Rep08",4160,4180,4200,4200,4170,4200,0.007,-30,4185,"Rep",-20,0,FALSE,FALSE,FALSE,0.71,"young",34,165,68,"m"
6,"LOWER BACK",1,"Rep09",4280,4240,4150,4150,4260,4150,0.026,110,4205,"Rep",40,0,TRUE,FALSE,FALSE,2.65,"young",34,165,68,"m"
6,"LOWER BACK",1,"Rep10",4400,4480,4700,4450,4440,4575,0.03,-135,4507.5,"Rep",-80,250,TRUE,TRUE,TRUE,2.95,"young",34,165,68,"m"
6,"LOWER BACK",2,"Rep01",4020,4020,3950,4150,4020,4050,0.007,-30,4035,"Rep",0,-200,FALSE,FALSE,TRUE,0.74,"young",34,165,68,"m"
6,"LOWER BACK",2,"Rep02",4120,4100,4100,4050,4110,4075,0.009,35,4092.5,"Rep",20,50,FALSE,FALSE,FALSE,0.86,"young",34,165,68,"m"
6,"LOWER BACK",2,"Rep03",4120,4140,4150,4150,4130,4150,0.005,-20,4140,"Rep",-20,0,FALSE,FALSE,FALSE,0.48,"young",34,165,68,"m"
6,"LOWER BACK",2,"Rep04",4020,4000,4000,3950,4010,3975,0.009,35,3992.5,"Rep",20,50,FALSE,FALSE,FALSE,0.88,"young",34,165,68,"m"
6,"LOWER BACK",2,"Rep05",3980,3980,4000,4000,3980,4000,0.005,-20,3990,"Rep",0,0,FALSE,FALSE,FALSE,0.5,"young",34,165,68,"m"
6,"LOWER BACK",2,"Rep06",3800,3800,3850,3800,3800,3825,0.007,-25,3812.5,"Rep",0,50,FALSE,FALSE,FALSE,0.65,"young",34,165,68,"m"
6,"LOWER BACK",2,"Rep07",4300,4300,4250,4150,4300,4200,0.023,100,4250,"Rep",0,100,TRUE,FALSE,FALSE,2.38,"young",34,165,68,"m"
6,"LOWER BACK",2,"Rep08",4160,4100,4100,4200,4130,4150,0.005,-20,4140,"Rep",60,-100,FALSE,FALSE,FALSE,0.48,"young",34,165,68,"m"
6,"LOWER BACK",2,"Rep09",4100,4200,3950,4000,4150,3975,0.042,175,4062.5,"Rep",-100,-50,TRUE,TRUE,FALSE,4.4,"young",34,165,68,"m"
6,"LOWER BACK",2,"Rep10",4080,4080,4400,4400,4080,4400,0.078,-320,4240,"Rep",0,0,TRUE,FALSE,FALSE,7.27,"young",34,165,68,"m"
6,"LOWER BACK",1,"TuT",43800,43840,44100,43800,43820,43950,0.003,-130,43885,"TuT",-40,300,FALSE,FALSE,TRUE,0.3,"young",34,165,68,"m"
6,"LOWER BACK",2,"TuT",40700,40720,40750,40850,40710,40800,0.002,-90,40755,"TuT",-20,-100,FALSE,FALSE,FALSE,0.22,"young",34,165,68,"m"
6,"TOTAL ABDOMINAL",1,"Con01",1560,1560,1700,1650,1560,1675,0.074,-115,1617.5,"Con",0,50,FALSE,FALSE,FALSE,6.87,"young",34,165,68,"m"
6,"TOTAL ABDOMINAL",1,"Con02",1280,1320,1300,1300,1300,1300,0,0,1300,"Con",-40,0,FALSE,TRUE,FALSE,0,"young",34,165,68,"m"
6,"TOTAL ABDOMINAL",1,"Con03",1400,1440,1450,1400,1420,1425,0.004,-5,1422.5,"Con",-40,50,FALSE,TRUE,FALSE,0.35,"young",34,165,68,"m"
6,"TOTAL ABDOMINAL",1,"Con04",1340,1360,1350,1400,1350,1375,0.019,-25,1362.5,"Con",-20,-50,FALSE,FALSE,FALSE,1.82,"young",34,165,68,"m"
6,"TOTAL ABDOMINAL",1,"Con05",1400,1420,1450,1450,1410,1450,0.028,-40,1430,"Con",-20,0,FALSE,FALSE,FALSE,2.76,"young",34,165,68,"m"
6,"TOTAL ABDOMINAL",1,"Con06",1400,1460,1350,1450,1430,1400,0.021,30,1415,"Con",-60,-100,FALSE,TRUE,FALSE,2.14,"young",34,165,68,"m"
6,"TOTAL ABDOMINAL",1,"Con07",1460,1480,1550,1600,1470,1575,0.071,-105,1522.5,"Con",-20,-50,FALSE,FALSE,FALSE,6.67,"young",34,165,68,"m"
6,"TOTAL ABDOMINAL",1,"Con08",1680,1660,1800,1750,1670,1775,0.063,-105,1722.5,"Con",20,50,FALSE,FALSE,FALSE,5.92,"young",34,165,68,"m"
6,"TOTAL ABDOMINAL",1,"Con09",1720,1760,1850,1900,1740,1875,0.078,-135,1807.5,"Con",-40,-50,FALSE,TRUE,FALSE,7.2,"young",34,165,68,"m"
6,"TOTAL ABDOMINAL",1,"Con10",1680,1660,1750,1750,1670,1750,0.048,-80,1710,"Con",20,0,FALSE,FALSE,FALSE,4.57,"young",34,165,68,"m"
6,"TOTAL ABDOMINAL",2,"Con01",1860,1860,2700,2000,1860,2350,0.263,-490,2105,"Con",0,700,TRUE,FALSE,TRUE,20.85,"young",34,165,68,"m"
6,"TOTAL ABDOMINAL",2,"Con02",1660,1680,1600,1650,1670,1625,0.027,45,1647.5,"Con",-20,-50,FALSE,FALSE,FALSE,2.77,"young",34,165,68,"m"
6,"TOTAL ABDOMINAL",2,"Con03",1680,1680,1250,1550,1680,1400,0.167,280,1540,"Con",0,-300,TRUE,FALSE,TRUE,20,"young",34,165,68,"m"
6,"TOTAL ABDOMINAL",2,"Con04",1840,1840,1700,1750,1840,1725,0.062,115,1782.5,"Con",0,-50,FALSE,FALSE,FALSE,6.67,"young",34,165,68,"m"
6,"TOTAL ABDOMINAL",2,"Con05",1720,1740,1750,1650,1730,1700,0.017,30,1715,"Con",-20,100,FALSE,FALSE,FALSE,1.76,"young",34,165,68,"m"
6,"TOTAL ABDOMINAL",2,"Con06",1680,1640,1850,1600,1660,1725,0.039,-65,1692.5,"Con",40,250,FALSE,TRUE,TRUE,3.77,"young",34,165,68,"m"
6,"TOTAL ABDOMINAL",2,"Con07",1520,1540,1650,1550,1530,1600,0.046,-70,1565,"Con",-20,100,FALSE,FALSE,FALSE,4.38,"young",34,165,68,"m"
6,"TOTAL ABDOMINAL",2,"Con08",1480,1480,1600,1600,1480,1600,0.081,-120,1540,"Con",0,0,FALSE,FALSE,FALSE,7.5,"young",34,165,68,"m"
6,"TOTAL ABDOMINAL",2,"Con09",1540,1600,1850,1900,1570,1875,0.194,-305,1722.5,"Con",-60,-50,TRUE,TRUE,FALSE,16.27,"young",34,165,68,"m"
6,"TOTAL ABDOMINAL",2,"Con10",1580,1600,1750,2000,1590,1875,0.179,-285,1732.5,"Con",-20,-250,TRUE,FALSE,TRUE,15.2,"young",34,165,68,"m"
6,"TOTAL ABDOMINAL",1,"Ecc01",2200,2160,2150,2200,2180,2175,0.002,5,2177.5,"Ecc",40,-50,FALSE,TRUE,FALSE,0.23,"young",34,165,68,"m"
6,"TOTAL ABDOMINAL",1,"Ecc02",2040,2020,2050,2050,2030,2050,0.01,-20,2040,"Ecc",20,0,FALSE,FALSE,FALSE,0.98,"young",34,165,68,"m"
6,"TOTAL ABDOMINAL",1,"Ecc03",2260,2240,2250,2250,2250,2250,0,0,2250,"Ecc",20,0,FALSE,FALSE,FALSE,0,"young",34,165,68,"m"
6,"TOTAL ABDOMINAL",1,"Ecc04",2240,2220,2150,2150,2230,2150,0.036,80,2190,"Ecc",20,0,FALSE,FALSE,FALSE,3.72,"young",34,165,68,"m"
6,"TOTAL ABDOMINAL",1,"Ecc05",2380,2320,2400,2300,2350,2350,0,0,2350,"Ecc",60,100,FALSE,TRUE,FALSE,0,"young",34,165,68,"m"
6,"TOTAL ABDOMINAL",1,"Ecc06",2180,2160,2150,2100,2170,2125,0.021,45,2147.5,"Ecc",20,50,FALSE,FALSE,FALSE,2.12,"young",34,165,68,"m"
6,"TOTAL ABDOMINAL",1,"Ecc07",2400,2400,2300,2300,2400,2300,0.042,100,2350,"Ecc",0,0,FALSE,FALSE,FALSE,4.35,"young",34,165,68,"m"
6,"TOTAL ABDOMINAL",1,"Ecc08",2160,2140,2000,2000,2150,2000,0.07,150,2075,"Ecc",20,0,TRUE,FALSE,FALSE,7.5,"young",34,165,68,"m"
6,"TOTAL ABDOMINAL",1,"Ecc09",2280,2280,2250,2200,2280,2225,0.024,55,2252.5,"Ecc",0,50,FALSE,FALSE,FALSE,2.47,"young",34,165,68,"m"
6,"TOTAL ABDOMINAL",1,"Ecc10",2760,2780,2750,2700,2770,2725,0.016,45,2747.5,"Ecc",-20,50,FALSE,FALSE,FALSE,1.65,"young",34,165,68,"m"
6,"TOTAL ABDOMINAL",2,"Ecc01",2340,2320,2350,2350,2330,2350,0.009,-20,2340,"Ecc",20,0,FALSE,FALSE,FALSE,0.85,"young",34,165,68,"m"
6,"TOTAL ABDOMINAL",2,"Ecc02",2180,2180,2550,2300,2180,2425,0.112,-245,2302.5,"Ecc",0,250,TRUE,FALSE,TRUE,10.1,"young",34,165,68,"m"
6,"TOTAL ABDOMINAL",2,"Ecc03",2620,2600,2800,2700,2610,2750,0.054,-140,2680,"Ecc",20,100,FALSE,FALSE,FALSE,5.09,"young",34,165,68,"m"
6,"TOTAL ABDOMINAL",2,"Ecc04",2480,2500,2500,2550,2490,2525,0.014,-35,2507.5,"Ecc",-20,-50,FALSE,FALSE,FALSE,1.39,"young",34,165,68,"m"
6,"TOTAL ABDOMINAL",2,"Ecc05",2660,2660,2500,2750,2660,2625,0.013,35,2642.5,"Ecc",0,-250,FALSE,FALSE,TRUE,1.33,"young",34,165,68,"m"
6,"TOTAL ABDOMINAL",2,"Ecc06",2340,2340,2200,2350,2340,2275,0.028,65,2307.5,"Ecc",0,-150,FALSE,FALSE,FALSE,2.86,"young",34,165,68,"m"
6,"TOTAL ABDOMINAL",2,"Ecc07",2500,2500,2400,2400,2500,2400,0.04,100,2450,"Ecc",0,0,FALSE,FALSE,FALSE,4.17,"young",34,165,68,"m"
6,"TOTAL ABDOMINAL",2,"Ecc08",2400,2360,2150,2100,2380,2125,0.107,255,2252.5,"Ecc",40,50,TRUE,TRUE,FALSE,12,"young",34,165,68,"m"
6,"TOTAL ABDOMINAL",2,"Ecc09",2220,2200,2000,1800,2210,1900,0.14,310,2055,"Ecc",20,200,TRUE,FALSE,TRUE,16.32,"young",34,165,68,"m"
6,"TOTAL ABDOMINAL",2,"Ecc10",2500,2480,2450,2400,2490,2425,0.026,65,2457.5,"Ecc",20,50,FALSE,FALSE,FALSE,2.68,"young",34,165,68,"m"
6,"TOTAL ABDOMINAL",1,"Rep01",3760,3720,3850,3850,3740,3850,0.029,-110,3795,"Rep",40,0,FALSE,FALSE,FALSE,2.86,"young",34,165,68,"m"
6,"TOTAL ABDOMINAL",1,"Rep02",3320,3340,3350,3350,3330,3350,0.006,-20,3340,"Rep",-20,0,FALSE,FALSE,FALSE,0.6,"young",34,165,68,"m"
6,"TOTAL ABDOMINAL",1,"Rep03",3660,3680,3700,3650,3670,3675,0.001,-5,3672.5,"Rep",-20,50,FALSE,FALSE,FALSE,0.14,"young",34,165,68,"m"
6,"TOTAL ABDOMINAL",1,"Rep04",3580,3580,3500,3550,3580,3525,0.015,55,3552.5,"Rep",0,-50,FALSE,FALSE,FALSE,1.56,"young",34,165,68,"m"
6,"TOTAL ABDOMINAL",1,"Rep05",3780,3740,3850,3750,3760,3800,0.011,-40,3780,"Rep",40,100,FALSE,FALSE,FALSE,1.05,"young",34,165,68,"m"
6,"TOTAL ABDOMINAL",1,"Rep06",3580,3620,3500,3550,3600,3525,0.021,75,3562.5,"Rep",-40,-50,FALSE,FALSE,FALSE,2.13,"young",34,165,68,"m"
6,"TOTAL ABDOMINAL",1,"Rep07",3860,3880,3850,3900,3870,3875,0.001,-5,3872.5,"Rep",-20,-50,FALSE,FALSE,FALSE,0.13,"young",34,165,68,"m"
6,"TOTAL ABDOMINAL",1,"Rep08",3840,3800,3800,3750,3820,3775,0.012,45,3797.5,"Rep",40,50,FALSE,FALSE,FALSE,1.19,"young",34,165,68,"m"
6,"TOTAL ABDOMINAL",1,"Rep09",4000,4040,4100,4100,4020,4100,0.02,-80,4060,"Rep",-40,0,FALSE,FALSE,FALSE,1.95,"young",34,165,68,"m"
6,"TOTAL ABDOMINAL",1,"Rep10",4440,4440,4500,4450,4440,4475,0.008,-35,4457.5,"Rep",0,50,FALSE,FALSE,FALSE,0.78,"young",34,165,68,"m"
6,"TOTAL ABDOMINAL",2,"Rep01",4200,4180,5050,4350,4190,4700,0.122,-510,4445,"Rep",20,700,TRUE,FALSE,TRUE,10.85,"young",34,165,68,"m"
6,"TOTAL ABDOMINAL",2,"Rep02",3840,3860,4150,3950,3850,4050,0.052,-200,3950,"Rep",-20,200,TRUE,FALSE,TRUE,4.94,"young",34,165,68,"m"
6,"TOTAL ABDOMINAL",2,"Rep03",4300,4280,4050,4250,4290,4150,0.033,140,4220,"Rep",20,-200,TRUE,FALSE,TRUE,3.37,"young",34,165,68,"m"
6,"TOTAL ABDOMINAL",2,"Rep04",4320,4340,4200,4300,4330,4250,0.018,80,4290,"Rep",-20,-100,FALSE,FALSE,FALSE,1.88,"young",34,165,68,"m"
6,"TOTAL ABDOMINAL",2,"Rep05",4380,4400,4250,4400,4390,4325,0.015,65,4357.5,"Rep",-20,-150,FALSE,FALSE,FALSE,1.5,"young",34,165,68,"m"
6,"TOTAL ABDOMINAL",2,"Rep06",4020,3980,4050,3950,4000,4000,0,0,4000,"Rep",40,100,FALSE,FALSE,FALSE,0,"young",34,165,68,"m"
6,"TOTAL ABDOMINAL",2,"Rep07",4020,4040,4050,3950,4030,4000,0.007,30,4015,"Rep",-20,100,FALSE,FALSE,FALSE,0.75,"young",34,165,68,"m"
6,"TOTAL ABDOMINAL",2,"Rep08",3880,3840,3750,3700,3860,3725,0.035,135,3792.5,"Rep",40,50,TRUE,FALSE,FALSE,3.62,"young",34,165,68,"m"
6,"TOTAL ABDOMINAL",2,"Rep09",3760,3800,3850,3700,3780,3775,0.001,5,3777.5,"Rep",-40,150,FALSE,FALSE,FALSE,0.13,"young",34,165,68,"m"
6,"TOTAL ABDOMINAL",2,"Rep10",4080,4080,4200,4400,4080,4300,0.054,-220,4190,"Rep",0,-200,TRUE,FALSE,TRUE,5.12,"young",34,165,68,"m"
6,"TOTAL ABDOMINAL",1,"TuT",37820,37840,38000,37900,37830,37950,0.003,-120,37890,"TuT",-20,100,FALSE,FALSE,FALSE,0.32,"young",34,165,68,"m"
6,"TOTAL ABDOMINAL",2,"TuT",40800,40800,41600,40950,40800,41275,0.012,-475,41037.5,"TuT",0,650,TRUE,FALSE,TRUE,1.15,"young",34,165,68,"m"
6,"VERTICAL TRACTION",1,"Con01",1480,1500,1600,1800,1490,1700,0.141,-210,1595,"Con",-20,-200,FALSE,FALSE,TRUE,12.35,"young",34,165,68,"m"
6,"VERTICAL TRACTION",1,"Con02",1400,1380,1550,1300,1390,1425,0.025,-35,1407.5,"Con",20,250,FALSE,FALSE,TRUE,2.46,"young",34,165,68,"m"
6,"VERTICAL TRACTION",1,"Con03",1360,1400,1550,1300,1380,1425,0.033,-45,1402.5,"Con",-40,250,FALSE,FALSE,TRUE,3.16,"young",34,165,68,"m"
6,"VERTICAL TRACTION",1,"Con04",1400,1440,1650,1400,1420,1525,0.074,-105,1472.5,"Con",-40,250,FALSE,FALSE,TRUE,6.89,"young",34,165,68,"m"
6,"VERTICAL TRACTION",1,"Con05",1500,1520,1800,1400,1510,1600,0.06,-90,1555,"Con",-20,400,FALSE,FALSE,TRUE,5.62,"young",34,165,68,"m"
6,"VERTICAL TRACTION",1,"Con06",1540,1480,1450,1550,1510,1500,0.007,10,1505,"Con",60,-100,FALSE,FALSE,FALSE,0.67,"young",34,165,68,"m"
6,"VERTICAL TRACTION",1,"Con07",1560,1620,1700,1750,1590,1725,0.085,-135,1657.5,"Con",-60,-50,FALSE,FALSE,FALSE,7.83,"young",34,165,68,"m"
6,"VERTICAL TRACTION",1,"Con08",1580,1580,1650,1850,1580,1750,0.108,-170,1665,"Con",0,-200,FALSE,FALSE,TRUE,9.71,"young",34,165,68,"m"
6,"VERTICAL TRACTION",1,"Con09",1420,1460,1400,1650,1440,1525,0.059,-85,1482.5,"Con",-40,-250,FALSE,FALSE,TRUE,5.57,"young",34,165,68,"m"
6,"VERTICAL TRACTION",1,"Con10",1820,1820,1600,2450,1820,2025,0.113,-205,1922.5,"Con",0,-850,FALSE,FALSE,TRUE,10.12,"young",34,165,68,"m"
6,"VERTICAL TRACTION",2,"Con01",1860,1880,2550,1950,1870,2250,0.203,-380,2060,"Con",-20,600,TRUE,FALSE,TRUE,16.89,"young",34,165,68,"m"
6,"VERTICAL TRACTION",2,"Con02",1300,1300,1550,1450,1300,1500,0.154,-200,1400,"Con",0,100,FALSE,FALSE,FALSE,13.33,"young",34,165,68,"m"
6,"VERTICAL TRACTION",2,"Con03",1420,1460,1600,1500,1440,1550,0.076,-110,1495,"Con",-40,100,FALSE,FALSE,FALSE,7.1,"young",34,165,68,"m"
6,"VERTICAL TRACTION",2,"Con04",1500,1540,1550,1550,1520,1550,0.02,-30,1535,"Con",-40,0,FALSE,FALSE,FALSE,1.94,"young",34,165,68,"m"
6,"VERTICAL TRACTION",2,"Con05",1340,1380,1350,1500,1360,1425,0.048,-65,1392.5,"Con",-40,-150,FALSE,FALSE,FALSE,4.56,"young",34,165,68,"m"
6,"VERTICAL TRACTION",2,"Con06",1600,1640,1600,1550,1620,1575,0.028,45,1597.5,"Con",-40,50,FALSE,FALSE,FALSE,2.86,"young",34,165,68,"m"
6,"VERTICAL TRACTION",2,"Con07",1540,1480,1450,1450,1510,1450,0.04,60,1480,"Con",60,0,FALSE,FALSE,FALSE,4.14,"young",34,165,68,"m"
6,"VERTICAL TRACTION",2,"Con08",1380,1440,1450,1450,1410,1450,0.028,-40,1430,"Con",-60,0,FALSE,FALSE,FALSE,2.76,"young",34,165,68,"m"
6,"VERTICAL TRACTION",2,"Con09",1400,1360,1500,1450,1380,1475,0.069,-95,1427.5,"Con",40,50,FALSE,FALSE,FALSE,6.44,"young",34,165,68,"m"
6,"VERTICAL TRACTION",2,"Con10",1440,1440,1600,1800,1440,1700,0.181,-260,1570,"Con",0,-200,FALSE,FALSE,TRUE,15.29,"young",34,165,68,"m"
6,"VERTICAL TRACTION",1,"Ecc01",2820,2840,2700,2800,2830,2750,0.028,80,2790,"Ecc",-20,-100,FALSE,FALSE,FALSE,2.91,"young",34,165,68,"m"
6,"VERTICAL TRACTION",1,"Ecc02",2160,2160,1950,2300,2160,2125,0.016,35,2142.5,"Ecc",0,-350,FALSE,FALSE,TRUE,1.65,"young",34,165,68,"m"
6,"VERTICAL TRACTION",1,"Ecc03",2220,2180,2000,2200,2200,2100,0.045,100,2150,"Ecc",40,-200,FALSE,FALSE,TRUE,4.76,"young",34,165,68,"m"
6,"VERTICAL TRACTION",1,"Ecc04",2020,1980,1700,2100,2000,1900,0.05,100,1950,"Ecc",40,-400,FALSE,FALSE,TRUE,5.26,"young",34,165,68,"m"
6,"VERTICAL TRACTION",1,"Ecc05",2240,2300,2250,2300,2270,2275,0.002,-5,2272.5,"Ecc",-60,-50,FALSE,FALSE,FALSE,0.22,"young",34,165,68,"m"
6,"VERTICAL TRACTION",1,"Ecc06",2180,2140,2100,2000,2160,2050,0.051,110,2105,"Ecc",40,100,FALSE,FALSE,FALSE,5.37,"young",34,165,68,"m"
6,"VERTICAL TRACTION",1,"Ecc07",2580,2560,2500,2350,2570,2425,0.056,145,2497.5,"Ecc",20,150,FALSE,FALSE,FALSE,5.98,"young",34,165,68,"m"
6,"VERTICAL TRACTION",1,"Ecc08",2520,2500,2500,2300,2510,2400,0.044,110,2455,"Ecc",20,200,FALSE,FALSE,TRUE,4.58,"young",34,165,68,"m"
6,"VERTICAL TRACTION",1,"Ecc09",2320,2280,2400,2050,2300,2225,0.033,75,2262.5,"Ecc",40,350,FALSE,FALSE,TRUE,3.37,"young",34,165,68,"m"
6,"VERTICAL TRACTION",1,"Ecc10",2940,2980,3200,2500,2960,2850,0.037,110,2905,"Ecc",-40,700,FALSE,FALSE,TRUE,3.86,"young",34,165,68,"m"
6,"VERTICAL TRACTION",2,"Ecc01",2980,2960,2700,2800,2970,2750,0.074,220,2860,"Ecc",20,-100,FALSE,FALSE,FALSE,8,"young",34,165,68,"m"
6,"VERTICAL TRACTION",2,"Ecc02",2460,2460,2250,2350,2460,2300,0.065,160,2380,"Ecc",0,-100,FALSE,FALSE,FALSE,6.96,"young",34,165,68,"m"
6,"VERTICAL TRACTION",2,"Ecc03",2400,2360,2300,2400,2380,2350,0.013,30,2365,"Ecc",40,-100,FALSE,FALSE,FALSE,1.28,"young",34,165,68,"m"
6,"VERTICAL TRACTION",2,"Ecc04",2560,2500,2550,2400,2530,2475,0.022,55,2502.5,"Ecc",60,150,FALSE,FALSE,FALSE,2.22,"young",34,165,68,"m"
6,"VERTICAL TRACTION",2,"Ecc05",2300,2280,2300,2250,2290,2275,0.007,15,2282.5,"Ecc",20,50,FALSE,FALSE,FALSE,0.66,"young",34,165,68,"m"
6,"VERTICAL TRACTION",2,"Ecc06",2220,2260,2300,2350,2240,2325,0.038,-85,2282.5,"Ecc",-40,-50,FALSE,FALSE,FALSE,3.66,"young",34,165,68,"m"
6,"VERTICAL TRACTION",2,"Ecc07",2200,2140,2150,2150,2170,2150,0.009,20,2160,"Ecc",60,0,FALSE,FALSE,FALSE,0.93,"young",34,165,68,"m"
6,"VERTICAL TRACTION",2,"Ecc08",2000,2040,1950,2000,2020,1975,0.022,45,1997.5,"Ecc",-40,-50,FALSE,FALSE,FALSE,2.28,"young",34,165,68,"m"
6,"VERTICAL TRACTION",2,"Ecc09",2000,2000,1900,1850,2000,1875,0.062,125,1937.5,"Ecc",0,50,FALSE,FALSE,FALSE,6.67,"young",34,165,68,"m"
6,"VERTICAL TRACTION",2,"Ecc10",3720,3760,3000,3550,3740,3275,0.124,465,3507.5,"Ecc",-40,-550,TRUE,FALSE,TRUE,14.2,"young",34,165,68,"m"
6,"VERTICAL TRACTION",1,"Rep01",4300,4340,4300,4600,4320,4450,0.03,-130,4385,"Rep",-40,-300,FALSE,FALSE,TRUE,2.92,"young",34,165,68,"m"
6,"VERTICAL TRACTION",1,"Rep02",3560,3540,3500,3600,3550,3550,0,0,3550,"Rep",20,-100,FALSE,FALSE,FALSE,0,"young",34,165,68,"m"
6,"VERTICAL TRACTION",1,"Rep03",3580,3580,3550,3500,3580,3525,0.015,55,3552.5,"Rep",0,50,FALSE,FALSE,FALSE,1.56,"young",34,165,68,"m"
6,"VERTICAL TRACTION",1,"Rep04",3420,3420,3350,3500,3420,3425,0.001,-5,3422.5,"Rep",0,-150,FALSE,FALSE,FALSE,0.15,"young",34,165,68,"m"
6,"VERTICAL TRACTION",1,"Rep05",3740,3820,4050,3700,3780,3875,0.025,-95,3827.5,"Rep",-80,350,FALSE,TRUE,TRUE,2.45,"young",34,165,68,"m"
6,"VERTICAL TRACTION",1,"Rep06",3720,3620,3550,3550,3670,3550,0.033,120,3610,"Rep",100,0,FALSE,TRUE,FALSE,3.38,"young",34,165,68,"m"
6,"VERTICAL TRACTION",1,"Rep07",4140,4180,4200,4100,4160,4150,0.002,10,4155,"Rep",-40,100,FALSE,FALSE,FALSE,0.24,"young",34,165,68,"m"
6,"VERTICAL TRACTION",1,"Rep08",4100,4080,4150,4150,4090,4150,0.015,-60,4120,"Rep",20,0,FALSE,FALSE,FALSE,1.45,"young",34,165,68,"m"
6,"VERTICAL TRACTION",1,"Rep09",3740,3740,3800,3700,3740,3750,0.003,-10,3745,"Rep",0,100,FALSE,FALSE,FALSE,0.27,"young",34,165,68,"m"
6,"VERTICAL TRACTION",1,"Rep10",4760,4800,4800,4950,4780,4875,0.02,-95,4827.5,"Rep",-40,-150,FALSE,FALSE,FALSE,1.95,"young",34,165,68,"m"
6,"VERTICAL TRACTION",2,"Rep01",4840,4840,5250,4750,4840,5000,0.033,-160,4920,"Rep",0,500,TRUE,FALSE,TRUE,3.2,"young",34,165,68,"m"
6,"VERTICAL TRACTION",2,"Rep02",3760,3760,3800,3800,3760,3800,0.011,-40,3780,"Rep",0,0,FALSE,FALSE,FALSE,1.05,"young",34,165,68,"m"
6,"VERTICAL TRACTION",2,"Rep03",3820,3820,3900,3900,3820,3900,0.021,-80,3860,"Rep",0,0,FALSE,FALSE,FALSE,2.05,"young",34,165,68,"m"
6,"VERTICAL TRACTION",2,"Rep04",4060,4040,4100,3950,4050,4025,0.006,25,4037.5,"Rep",20,150,FALSE,FALSE,FALSE,0.62,"young",34,165,68,"m"
6,"VERTICAL TRACTION",2,"Rep05",3640,3660,3650,3750,3650,3700,0.014,-50,3675,"Rep",-20,-100,FALSE,FALSE,FALSE,1.35,"young",34,165,68,"m"
6,"VERTICAL TRACTION",2,"Rep06",3820,3900,3900,3900,3860,3900,0.01,-40,3880,"Rep",-80,0,FALSE,TRUE,FALSE,1.03,"young",34,165,68,"m"
6,"VERTICAL TRACTION",2,"Rep07",3740,3620,3600,3600,3680,3600,0.022,80,3640,"Rep",120,0,FALSE,TRUE,FALSE,2.22,"young",34,165,68,"m"
6,"VERTICAL TRACTION",2,"Rep08",3380,3480,3400,3450,3430,3425,0.001,5,3427.5,"Rep",-100,-50,FALSE,TRUE,FALSE,0.15,"young",34,165,68,"m"
6,"VERTICAL TRACTION",2,"Rep09",3400,3360,3400,3300,3380,3350,0.009,30,3365,"Rep",40,100,FALSE,FALSE,FALSE,0.9,"young",34,165,68,"m"
6,"VERTICAL TRACTION",2,"Rep10",5160,5200,4600,5350,5180,4975,0.04,205,5077.5,"Rep",-40,-750,TRUE,FALSE,TRUE,4.12,"young",34,165,68,"m"
6,"VERTICAL TRACTION",1,"TuT",39060,39120,39250,39350,39090,39300,0.005,-210,39195,"TuT",-60,-100,FALSE,FALSE,FALSE,0.53,"young",34,165,68,"m"
6,"VERTICAL TRACTION",2,"TuT",39620,39680,39600,39750,39650,39675,0.001,-25,39662.5,"TuT",-60,-150,FALSE,FALSE,FALSE,0.06,"young",34,165,68,"m"
6,"CHEST PRESS",1,"Con01",1780,1820,2350,1700,1800,2025,0.125,-225,1912.5,"Con",-40,650,FALSE,TRUE,TRUE,11.11,"young",34,165,68,"m"
6,"CHEST PRESS",1,"Con02",1180,1220,1250,1300,1200,1275,0.062,-75,1237.5,"Con",-40,-50,FALSE,TRUE,FALSE,5.88,"young",34,165,68,"m"
6,"CHEST PRESS",1,"Con03",1460,1500,1300,1600,1480,1450,0.02,30,1465,"Con",-40,-300,FALSE,TRUE,FALSE,2.07,"young",34,165,68,"m"
6,"CHEST PRESS",1,"Con04",1220,1240,1350,1350,1230,1350,0.098,-120,1290,"Con",-20,0,FALSE,FALSE,FALSE,8.89,"young",34,165,68,"m"
6,"CHEST PRESS",1,"Con05",1340,1360,1650,1350,1350,1500,0.111,-150,1425,"Con",-20,300,FALSE,FALSE,FALSE,10,"young",34,165,68,"m"
6,"CHEST PRESS",1,"Con06",1360,1320,1500,1250,1340,1375,0.026,-35,1357.5,"Con",40,250,FALSE,TRUE,FALSE,2.55,"young",34,165,68,"m"
6,"CHEST PRESS",1,"Con07",1460,1480,1500,1600,1470,1550,0.054,-80,1510,"Con",-20,-100,FALSE,FALSE,FALSE,5.16,"young",34,165,68,"m"
6,"CHEST PRESS",1,"Con08",1360,1380,1450,1450,1370,1450,0.058,-80,1410,"Con",-20,0,FALSE,FALSE,FALSE,5.52,"young",34,165,68,"m"
6,"CHEST PRESS",1,"Con09",1400,1380,1400,1500,1390,1450,0.043,-60,1420,"Con",20,-100,FALSE,FALSE,FALSE,4.14,"young",34,165,68,"m"
6,"CHEST PRESS",1,"Con10",1580,1600,1700,1750,1590,1725,0.085,-135,1657.5,"Con",-20,-50,FALSE,FALSE,FALSE,7.83,"young",34,165,68,"m"
6,"CHEST PRESS",2,"Con01",1740,1760,1950,1900,1750,1925,0.1,-175,1837.5,"Con",-20,50,FALSE,FALSE,FALSE,9.09,"young",34,165,68,"m"
6,"CHEST PRESS",2,"Con02",1220,1200,1450,1200,1210,1325,0.095,-115,1267.5,"Con",20,250,FALSE,FALSE,FALSE,8.68,"young",34,165,68,"m"
6,"CHEST PRESS",2,"Con03",1160,1160,1400,1150,1160,1275,0.099,-115,1217.5,"Con",0,250,FALSE,FALSE,FALSE,9.02,"young",34,165,68,"m"
6,"CHEST PRESS",2,"Con04",1240,1260,1300,1350,1250,1325,0.06,-75,1287.5,"Con",-20,-50,FALSE,FALSE,FALSE,5.66,"young",34,165,68,"m"
6,"CHEST PRESS",2,"Con05",1160,1180,1150,1250,1170,1200,0.026,-30,1185,"Con",-20,-100,FALSE,FALSE,FALSE,2.5,"young",34,165,68,"m"
6,"CHEST PRESS",2,"Con06",1260,1280,1200,1250,1270,1225,0.035,45,1247.5,"Con",-20,-50,FALSE,FALSE,FALSE,3.67,"young",34,165,68,"m"
6,"CHEST PRESS",2,"Con07",1920,1960,1250,1950,1940,1600,0.175,340,1770,"Con",-40,-700,FALSE,TRUE,TRUE,21.25,"young",34,165,68,"m"
6,"CHEST PRESS",2,"Con08",2220,2220,2250,1200,2220,1725,0.223,495,1972.5,"Con",0,1050,TRUE,FALSE,TRUE,28.7,"young",34,165,68,"m"
6,"CHEST PRESS",2,"Con09",820,820,900,1000,820,950,0.159,-130,885,"Con",0,-100,FALSE,FALSE,FALSE,13.68,"young",34,165,68,"m"
6,"CHEST PRESS",2,"Con10",680,720,950,1000,700,975,0.393,-275,837.5,"Con",-40,-50,FALSE,TRUE,FALSE,28.21,"young",34,165,68,"m"
6,"CHEST PRESS",1,"Ecc01",2260,2220,2250,2250,2240,2250,0.004,-10,2245,"Ecc",40,0,FALSE,TRUE,FALSE,0.44,"young",34,165,68,"m"
6,"CHEST PRESS",1,"Ecc02",2200,2160,2250,2050,2180,2150,0.014,30,2165,"Ecc",40,200,FALSE,TRUE,FALSE,1.4,"young",34,165,68,"m"
6,"CHEST PRESS",1,"Ecc03",2140,2120,2150,2000,2130,2075,0.026,55,2102.5,"Ecc",20,150,FALSE,FALSE,FALSE,2.65,"young",34,165,68,"m"
6,"CHEST PRESS",1,"Ecc04",2320,2300,2100,2250,2310,2175,0.058,135,2242.5,"Ecc",20,-150,FALSE,FALSE,FALSE,6.21,"young",34,165,68,"m"
6,"CHEST PRESS",1,"Ecc05",2160,2180,1950,2250,2170,2100,0.032,70,2135,"Ecc",-20,-300,FALSE,FALSE,TRUE,3.33,"young",34,165,68,"m"
6,"CHEST PRESS",1,"Ecc06",2080,2080,1950,2050,2080,2000,0.038,80,2040,"Ecc",0,-100,FALSE,FALSE,FALSE,4,"young",34,165,68,"m"
6,"CHEST PRESS",1,"Ecc07",1960,1940,1900,1850,1950,1875,0.038,75,1912.5,"Ecc",20,50,FALSE,FALSE,FALSE,4,"young",34,165,68,"m"
6,"CHEST PRESS",1,"Ecc08",2000,2000,1950,1900,2000,1925,0.038,75,1962.5,"Ecc",0,50,FALSE,FALSE,FALSE,3.9,"young",34,165,68,"m"
6,"CHEST PRESS",1,"Ecc09",1960,1960,1900,1850,1960,1875,0.043,85,1917.5,"Ecc",0,50,FALSE,FALSE,FALSE,4.53,"young",34,165,68,"m"
6,"CHEST PRESS",1,"Ecc10",2860,2860,2900,2800,2860,2850,0.003,10,2855,"Ecc",0,100,FALSE,FALSE,FALSE,0.35,"young",34,165,68,"m"
6,"CHEST PRESS",2,"Ecc01",2180,2160,1950,2100,2170,2025,0.067,145,2097.5,"Ecc",20,-150,FALSE,FALSE,FALSE,7.16,"young",34,165,68,"m"
6,"CHEST PRESS",2,"Ecc02",2120,2160,1950,2150,2140,2050,0.042,90,2095,"Ecc",-40,-200,FALSE,TRUE,FALSE,4.39,"young",34,165,68,"m"
6,"CHEST PRESS",2,"Ecc03",2140,2120,1950,2100,2130,2025,0.049,105,2077.5,"Ecc",20,-150,FALSE,FALSE,FALSE,5.19,"young",34,165,68,"m"
6,"CHEST PRESS",2,"Ecc04",2120,2100,2100,2000,2110,2050,0.028,60,2080,"Ecc",20,100,FALSE,FALSE,FALSE,2.93,"young",34,165,68,"m"
6,"CHEST PRESS",2,"Ecc05",1920,1900,1900,1850,1910,1875,0.018,35,1892.5,"Ecc",20,50,FALSE,FALSE,FALSE,1.87,"young",34,165,68,"m"
6,"CHEST PRESS",2,"Ecc06",1740,1720,1850,1750,1730,1800,0.04,-70,1765,"Ecc",20,100,FALSE,FALSE,FALSE,3.89,"young",34,165,68,"m"
6,"CHEST PRESS",2,"Ecc07",1900,1860,2500,1800,1880,2150,0.144,-270,2015,"Ecc",40,700,FALSE,TRUE,TRUE,12.56,"young",34,165,68,"m"
6,"CHEST PRESS",2,"Ecc08",1700,1700,1650,2700,1700,2175,0.279,-475,1937.5,"Ecc",0,-1050,TRUE,FALSE,TRUE,21.84,"young",34,165,68,"m"
6,"CHEST PRESS",2,"Ecc09",1760,1760,1600,1500,1760,1550,0.119,210,1655,"Ecc",0,100,FALSE,FALSE,FALSE,13.55,"young",34,165,68,"m"
6,"CHEST PRESS",2,"Ecc10",1700,1680,1650,1650,1690,1650,0.024,40,1670,"Ecc",20,0,FALSE,FALSE,FALSE,2.42,"young",34,165,68,"m"
6,"CHEST PRESS",1,"Rep01",4040,4040,4600,3950,4040,4275,0.058,-235,4157.5,"Rep",0,650,TRUE,FALSE,TRUE,5.5,"young",34,165,68,"m"
6,"CHEST PRESS",1,"Rep02",3380,3380,3500,3350,3380,3425,0.013,-45,3402.5,"Rep",0,150,FALSE,FALSE,FALSE,1.31,"young",34,165,68,"m"
6,"CHEST PRESS",1,"Rep03",3600,3620,3450,3600,3610,3525,0.024,85,3567.5,"Rep",-20,-150,FALSE,FALSE,FALSE,2.41,"young",34,165,68,"m"
6,"CHEST PRESS",1,"Rep04",3540,3540,3450,3600,3540,3525,0.004,15,3532.5,"Rep",0,-150,FALSE,FALSE,FALSE,0.43,"young",34,165,68,"m"
6,"CHEST PRESS",1,"Rep05",3500,3540,3600,3600,3520,3600,0.023,-80,3560,"Rep",-40,0,FALSE,FALSE,FALSE,2.22,"young",34,165,68,"m"
6,"CHEST PRESS",1,"Rep06",3440,3400,3450,3300,3420,3375,0.013,45,3397.5,"Rep",40,150,FALSE,FALSE,FALSE,1.33,"young",34,165,68,"m"
6,"CHEST PRESS",1,"Rep07",3420,3420,3400,3450,3420,3425,0.001,-5,3422.5,"Rep",0,-50,FALSE,FALSE,FALSE,0.15,"young",34,165,68,"m"
6,"CHEST PRESS",1,"Rep08",3360,3380,3400,3350,3370,3375,0.001,-5,3372.5,"Rep",-20,50,FALSE,FALSE,FALSE,0.15,"young",34,165,68,"m"
6,"CHEST PRESS",1,"Rep09",3360,3340,3300,3350,3350,3325,0.007,25,3337.5,"Rep",20,-50,FALSE,FALSE,FALSE,0.75,"young",34,165,68,"m"
6,"CHEST PRESS",1,"Rep10",4440,4460,4600,4550,4450,4575,0.028,-125,4512.5,"Rep",-20,50,FALSE,FALSE,FALSE,2.73,"young",34,165,68,"m"
6,"CHEST PRESS",2,"Rep01",3920,3920,3900,4000,3920,3950,0.008,-30,3935,"Rep",0,-100,FALSE,FALSE,FALSE,0.76,"young",34,165,68,"m"
6,"CHEST PRESS",2,"Rep02",3340,3360,3400,3350,3350,3375,0.007,-25,3362.5,"Rep",-20,50,FALSE,FALSE,FALSE,0.74,"young",34,165,68,"m"
6,"CHEST PRESS",2,"Rep03",3300,3280,3350,3250,3290,3300,0.003,-10,3295,"Rep",20,100,FALSE,FALSE,FALSE,0.3,"young",34,165,68,"m"
6,"CHEST PRESS",2,"Rep04",3360,3360,3400,3350,3360,3375,0.004,-15,3367.5,"Rep",0,50,FALSE,FALSE,FALSE,0.44,"young",34,165,68,"m"
6,"CHEST PRESS",2,"Rep05",3080,3080,3050,3100,3080,3075,0.002,5,3077.5,"Rep",0,-50,FALSE,FALSE,FALSE,0.16,"young",34,165,68,"m"
6,"CHEST PRESS",2,"Rep06",3000,3000,3050,3000,3000,3025,0.008,-25,3012.5,"Rep",0,50,FALSE,FALSE,FALSE,0.83,"young",34,165,68,"m"
6,"CHEST PRESS",2,"Rep07",3820,3820,3750,3750,3820,3750,0.018,70,3785,"Rep",0,0,FALSE,FALSE,FALSE,1.87,"young",34,165,68,"m"
6,"CHEST PRESS",2,"Rep08",3920,3920,3900,3900,3920,3900,0.005,20,3910,"Rep",0,0,FALSE,FALSE,FALSE,0.51,"young",34,165,68,"m"
6,"CHEST PRESS",2,"Rep09",2580,2580,2500,2500,2580,2500,0.031,80,2540,"Rep",0,0,FALSE,FALSE,FALSE,3.2,"young",34,165,68,"m"
6,"CHEST PRESS",2,"Rep10",2380,2400,2600,2650,2390,2625,0.098,-235,2507.5,"Rep",-20,-50,TRUE,FALSE,FALSE,8.95,"young",34,165,68,"m"
6,"CHEST PRESS",1,"TuT",36080,36120,36750,36100,36100,36425,0.009,-325,36262.5,"TuT",-40,650,FALSE,FALSE,FALSE,0.89,"young",34,165,68,"m"
6,"CHEST PRESS",2,"TuT",32700,32720,32900,32850,32710,32875,0.005,-165,32792.5,"TuT",-20,50,FALSE,FALSE,FALSE,0.5,"young",34,165,68,"m"
7,"LEG PRESS",1,"Con01",1600,1600,1850,1850,1600,1850,0.156,-250,1725,"Con",0,0,FALSE,FALSE,FALSE,13.51,"young",38,178,77,"f"
7,"LEG PRESS",1,"Con02",1780,1780,1950,1900,1780,1925,0.081,-145,1852.5,"Con",0,50,FALSE,FALSE,FALSE,7.53,"young",38,178,77,"f"
7,"LEG PRESS",1,"Con03",1880,1880,2200,2050,1880,2125,0.13,-245,2002.5,"Con",0,150,FALSE,FALSE,FALSE,11.53,"young",38,178,77,"f"
7,"LEG PRESS",1,"Con04",1860,1840,2050,2100,1850,2075,0.122,-225,1962.5,"Con",20,-50,FALSE,FALSE,FALSE,10.84,"young",38,178,77,"f"
7,"LEG PRESS",1,"Con05",1940,1920,2150,2200,1930,2175,0.127,-245,2052.5,"Con",20,-50,FALSE,FALSE,FALSE,11.26,"young",38,178,77,"f"
7,"LEG PRESS",1,"Con06",2080,2020,2150,2200,2050,2175,0.061,-125,2112.5,"Con",60,-50,FALSE,FALSE,FALSE,5.75,"young",38,178,77,"f"
7,"LEG PRESS",1,"Con07",1840,1860,1850,1950,1850,1900,0.027,-50,1875,"Con",-20,-100,FALSE,FALSE,FALSE,2.63,"young",38,178,77,"f"
7,"LEG PRESS",1,"Con08",1920,1860,2400,2500,1890,2450,0.296,-560,2170,"Con",60,-100,TRUE,FALSE,FALSE,22.86,"young",38,178,77,"f"
7,"LEG PRESS",1,"Con09",1860,1900,2250,2300,1880,2275,0.21,-395,2077.5,"Con",-40,-50,TRUE,FALSE,FALSE,17.36,"young",38,178,77,"f"
7,"LEG PRESS",1,"Con10",1960,1920,2300,2300,1940,2300,0.186,-360,2120,"Con",40,0,TRUE,FALSE,FALSE,15.65,"young",38,178,77,"f"
7,"LEG PRESS",2,"Con01",1640,1640,1800,1850,1640,1825,0.113,-185,1732.5,"Con",0,-50,FALSE,FALSE,FALSE,10.14,"young",38,178,77,"f"
7,"LEG PRESS",2,"Con02",2200,2180,2400,2300,2190,2350,0.073,-160,2270,"Con",20,100,FALSE,FALSE,FALSE,6.81,"young",38,178,77,"f"
7,"LEG PRESS",2,"Con03",2060,2080,2500,2400,2070,2450,0.184,-380,2260,"Con",-20,100,TRUE,FALSE,FALSE,15.51,"young",38,178,77,"f"
7,"LEG PRESS",2,"Con04",1980,1980,1700,1700,1980,1700,0.141,280,1840,"Con",0,0,FALSE,FALSE,FALSE,16.47,"young",38,178,77,"f"
7,"LEG PRESS",2,"Con05",1920,1900,1900,1900,1910,1900,0.005,10,1905,"Con",20,0,FALSE,FALSE,FALSE,0.53,"young",38,178,77,"f"
7,"LEG PRESS",2,"Con06",1660,1660,1800,1800,1660,1800,0.084,-140,1730,"Con",0,0,FALSE,FALSE,FALSE,7.78,"young",38,178,77,"f"
7,"LEG PRESS",2,"Con07",1540,1560,1700,1800,1550,1750,0.129,-200,1650,"Con",-20,-100,FALSE,FALSE,FALSE,11.43,"young",38,178,77,"f"
7,"LEG PRESS",2,"Con08",1740,1740,2000,2100,1740,2050,0.178,-310,1895,"Con",0,-100,FALSE,FALSE,FALSE,15.12,"young",38,178,77,"f"
7,"LEG PRESS",2,"Con09",1940,1960,2200,2200,1950,2200,0.128,-250,2075,"Con",-20,0,FALSE,FALSE,FALSE,11.36,"young",38,178,77,"f"
7,"LEG PRESS",2,"Con10",1660,1660,2050,2150,1660,2100,0.265,-440,1880,"Con",0,-100,TRUE,FALSE,FALSE,20.95,"young",38,178,77,"f"
7,"LEG PRESS",1,"Ecc01",3480,3460,3350,3350,3470,3350,0.035,120,3410,"Ecc",20,0,FALSE,FALSE,FALSE,3.58,"young",38,178,77,"f"
7,"LEG PRESS",1,"Ecc02",3460,3460,3250,3350,3460,3300,0.046,160,3380,"Ecc",0,-100,FALSE,FALSE,FALSE,4.85,"young",38,178,77,"f"
7,"LEG PRESS",1,"Ecc03",3080,3080,2800,2900,3080,2850,0.075,230,2965,"Ecc",0,-100,FALSE,FALSE,FALSE,8.07,"young",38,178,77,"f"
7,"LEG PRESS",1,"Ecc04",2860,2880,2650,2600,2870,2625,0.085,245,2747.5,"Ecc",-20,50,FALSE,FALSE,FALSE,9.33,"young",38,178,77,"f"
7,"LEG PRESS",1,"Ecc05",3180,3220,3000,2950,3200,2975,0.07,225,3087.5,"Ecc",-40,50,FALSE,FALSE,FALSE,7.56,"young",38,178,77,"f"
7,"LEG PRESS",1,"Ecc06",3240,3300,3200,3150,3270,3175,0.029,95,3222.5,"Ecc",-60,50,FALSE,FALSE,FALSE,2.99,"young",38,178,77,"f"
7,"LEG PRESS",1,"Ecc07",3200,3160,3100,3000,3180,3050,0.041,130,3115,"Ecc",40,100,FALSE,FALSE,FALSE,4.26,"young",38,178,77,"f"
7,"LEG PRESS",1,"Ecc08",3640,3700,3100,3000,3670,3050,0.169,620,3360,"Ecc",-60,100,TRUE,FALSE,FALSE,20.33,"young",38,178,77,"f"
7,"LEG PRESS",1,"Ecc09",3100,3060,2700,2650,3080,2675,0.131,405,2877.5,"Ecc",40,50,TRUE,FALSE,FALSE,15.14,"young",38,178,77,"f"
7,"LEG PRESS",1,"Ecc10",2760,2800,2600,2600,2780,2600,0.065,180,2690,"Ecc",-40,0,FALSE,FALSE,FALSE,6.92,"young",38,178,77,"f"
7,"LEG PRESS",2,"Ecc01",2840,2860,2700,2700,2850,2700,0.053,150,2775,"Ecc",-20,0,FALSE,FALSE,FALSE,5.56,"young",38,178,77,"f"
7,"LEG PRESS",2,"Ecc02",2660,2660,2400,2500,2660,2450,0.079,210,2555,"Ecc",0,-100,FALSE,FALSE,FALSE,8.57,"young",38,178,77,"f"
7,"LEG PRESS",2,"Ecc03",2780,2760,2500,2600,2770,2550,0.079,220,2660,"Ecc",20,-100,FALSE,FALSE,FALSE,8.63,"young",38,178,77,"f"
7,"LEG PRESS",2,"Ecc04",2720,2720,2950,2950,2720,2950,0.085,-230,2835,"Ecc",0,0,FALSE,FALSE,FALSE,7.8,"young",38,178,77,"f"
7,"LEG PRESS",2,"Ecc05",3020,3040,3000,3000,3030,3000,0.01,30,3015,"Ecc",-20,0,FALSE,FALSE,FALSE,1,"young",38,178,77,"f"
7,"LEG PRESS",2,"Ecc06",2980,3000,2800,2750,2990,2775,0.072,215,2882.5,"Ecc",-20,50,FALSE,FALSE,FALSE,7.75,"young",38,178,77,"f"
7,"LEG PRESS",2,"Ecc07",2980,2920,2750,2650,2950,2700,0.085,250,2825,"Ecc",60,100,FALSE,FALSE,FALSE,9.26,"young",38,178,77,"f"
7,"LEG PRESS",2,"Ecc08",2900,2920,2650,2600,2910,2625,0.098,285,2767.5,"Ecc",-20,50,FALSE,FALSE,FALSE,10.86,"young",38,178,77,"f"
7,"LEG PRESS",2,"Ecc09",2540,2520,2250,2200,2530,2225,0.121,305,2377.5,"Ecc",20,50,FALSE,FALSE,FALSE,13.71,"young",38,178,77,"f"
7,"LEG PRESS",2,"Ecc10",2720,2740,2550,2650,2730,2600,0.048,130,2665,"Ecc",-20,-100,FALSE,FALSE,FALSE,5,"young",38,178,77,"f"
7,"LEG PRESS",1,"Rep01",5080,5060,5200,5200,5070,5200,0.026,-130,5135,"Rep",20,0,TRUE,FALSE,FALSE,2.5,"young",38,178,77,"f"
7,"LEG PRESS",1,"Rep02",5240,5240,5200,5250,5240,5225,0.003,15,5232.5,"Rep",0,-50,FALSE,FALSE,FALSE,0.29,"young",38,178,77,"f"
7,"LEG PRESS",1,"Rep03",4960,4960,5000,4950,4960,4975,0.003,-15,4967.5,"Rep",0,50,FALSE,FALSE,FALSE,0.3,"young",38,178,77,"f"
7,"LEG PRESS",1,"Rep04",4720,4720,4700,4700,4720,4700,0.004,20,4710,"Rep",0,0,FALSE,FALSE,FALSE,0.43,"young",38,178,77,"f"
7,"LEG PRESS",1,"Rep05",5120,5140,5150,5150,5130,5150,0.004,-20,5140,"Rep",-20,0,FALSE,FALSE,FALSE,0.39,"young",38,178,77,"f"
7,"LEG PRESS",1,"Rep06",5320,5320,5350,5350,5320,5350,0.006,-30,5335,"Rep",0,0,FALSE,FALSE,FALSE,0.56,"young",38,178,77,"f"
7,"LEG PRESS",1,"Rep07",5040,5020,4950,4950,5030,4950,0.016,80,4990,"Rep",20,0,FALSE,FALSE,FALSE,1.62,"young",38,178,77,"f"
7,"LEG PRESS",1,"Rep08",5560,5560,5500,5500,5560,5500,0.011,60,5530,"Rep",0,0,FALSE,FALSE,FALSE,1.09,"young",38,178,77,"f"
7,"LEG PRESS",1,"Rep09",4960,4960,4950,4950,4960,4950,0.002,10,4955,"Rep",0,0,FALSE,FALSE,FALSE,0.2,"young",38,178,77,"f"
7,"LEG PRESS",1,"Rep10",4720,4720,4900,4900,4720,4900,0.038,-180,4810,"Rep",0,0,TRUE,FALSE,FALSE,3.67,"young",38,178,77,"f"
7,"LEG PRESS",2,"Rep01",4480,4500,4500,4550,4490,4525,0.008,-35,4507.5,"Rep",-20,-50,FALSE,FALSE,FALSE,0.77,"young",38,178,77,"f"
7,"LEG PRESS",2,"Rep02",4860,4840,4800,4800,4850,4800,0.01,50,4825,"Rep",20,0,FALSE,FALSE,FALSE,1.04,"young",38,178,77,"f"
7,"LEG PRESS",2,"Rep03",4840,4840,5000,5000,4840,5000,0.033,-160,4920,"Rep",0,0,TRUE,FALSE,FALSE,3.2,"young",38,178,77,"f"
7,"LEG PRESS",2,"Rep04",4700,4700,4650,4650,4700,4650,0.011,50,4675,"Rep",0,0,FALSE,FALSE,FALSE,1.08,"young",38,178,77,"f"
7,"LEG PRESS",2,"Rep05",4940,4940,4900,4900,4940,4900,0.008,40,4920,"Rep",0,0,FALSE,FALSE,FALSE,0.82,"young",38,178,77,"f"
7,"LEG PRESS",2,"Rep06",4640,4660,4600,4550,4650,4575,0.016,75,4612.5,"Rep",-20,50,FALSE,FALSE,FALSE,1.64,"young",38,178,77,"f"
7,"LEG PRESS",2,"Rep07",4520,4480,4450,4450,4500,4450,0.011,50,4475,"Rep",40,0,FALSE,FALSE,FALSE,1.12,"young",38,178,77,"f"
7,"LEG PRESS",2,"Rep08",4640,4660,4650,4700,4650,4675,0.005,-25,4662.5,"Rep",-20,-50,FALSE,FALSE,FALSE,0.53,"young",38,178,77,"f"
7,"LEG PRESS",2,"Rep09",4480,4480,4450,4400,4480,4425,0.012,55,4452.5,"Rep",0,50,FALSE,FALSE,FALSE,1.24,"young",38,178,77,"f"
7,"LEG PRESS",2,"Rep10",4380,4400,4600,4800,4390,4700,0.071,-310,4545,"Rep",-20,-200,TRUE,FALSE,TRUE,6.6,"young",38,178,77,"f"
7,"LEG PRESS",1,"TuT",50720,50700,50900,50900,50710,50900,0.004,-190,50805,"TuT",20,0,FALSE,FALSE,FALSE,0.37,"young",38,178,77,"f"
7,"LEG PRESS",2,"TuT",46480,46500,46600,46800,46490,46700,0.005,-210,46595,"TuT",-20,-200,FALSE,FALSE,FALSE,0.45,"young",38,178,77,"f"
7,"LEG EXTENSION",1,"Con01",1840,1860,2000,1750,1850,1875,0.014,-25,1862.5,"Con",-20,250,FALSE,FALSE,TRUE,1.33,"young",38,178,77,"f"
7,"LEG EXTENSION",1,"Con02",1800,1820,1800,1750,1810,1775,0.019,35,1792.5,"Con",-20,50,FALSE,FALSE,FALSE,1.97,"young",38,178,77,"f"
7,"LEG EXTENSION",1,"Con03",1820,1860,1900,1800,1840,1850,0.005,-10,1845,"Con",-40,100,FALSE,TRUE,FALSE,0.54,"young",38,178,77,"f"
7,"LEG EXTENSION",1,"Con04",1680,1680,1750,1750,1680,1750,0.042,-70,1715,"Con",0,0,FALSE,FALSE,FALSE,4,"young",38,178,77,"f"
7,"LEG EXTENSION",1,"Con05",1700,1720,1750,1750,1710,1750,0.023,-40,1730,"Con",-20,0,FALSE,FALSE,FALSE,2.29,"young",38,178,77,"f"
7,"LEG EXTENSION",1,"Con06",1500,1540,1600,1600,1520,1600,0.053,-80,1560,"Con",-40,0,FALSE,TRUE,FALSE,5,"young",38,178,77,"f"
7,"LEG EXTENSION",1,"Con07",1520,1560,1750,1850,1540,1800,0.169,-260,1670,"Con",-40,-100,TRUE,TRUE,FALSE,14.44,"young",38,178,77,"f"
7,"LEG EXTENSION",1,"Con08",1680,1680,1700,1950,1680,1825,0.086,-145,1752.5,"Con",0,-250,FALSE,FALSE,TRUE,7.95,"young",38,178,77,"f"
7,"LEG EXTENSION",1,"Con09",1600,1640,1750,1750,1620,1750,0.08,-130,1685,"Con",-40,0,FALSE,TRUE,FALSE,7.43,"young",38,178,77,"f"
7,"LEG EXTENSION",1,"Con10",1640,1600,1950,2000,1620,1975,0.219,-355,1797.5,"Con",40,-50,TRUE,TRUE,FALSE,17.97,"young",38,178,77,"f"
7,"LEG EXTENSION",2,"Con01",1940,1940,2050,2000,1940,2025,0.044,-85,1982.5,"Con",0,50,FALSE,FALSE,FALSE,4.2,"young",38,178,77,"f"
7,"LEG EXTENSION",2,"Con02",1960,2000,2000,2000,1980,2000,0.01,-20,1990,"Con",-40,0,FALSE,TRUE,FALSE,1,"young",38,178,77,"f"
7,"LEG EXTENSION",2,"Con03",1820,1820,1850,1850,1820,1850,0.016,-30,1835,"Con",0,0,FALSE,FALSE,FALSE,1.62,"young",38,178,77,"f"
7,"LEG EXTENSION",2,"Con04",1840,1860,1900,1950,1850,1925,0.041,-75,1887.5,"Con",-20,-50,FALSE,FALSE,FALSE,3.9,"young",38,178,77,"f"
7,"LEG EXTENSION",2,"Con05",1860,1880,2000,2000,1870,2000,0.07,-130,1935,"Con",-20,0,FALSE,FALSE,FALSE,6.5,"young",38,178,77,"f"
7,"LEG EXTENSION",2,"Con06",1980,1960,2050,2050,1970,2050,0.041,-80,2010,"Con",20,0,FALSE,FALSE,FALSE,3.9,"young",38,178,77,"f"
7,"LEG EXTENSION",2,"Con07",1860,1860,1950,1900,1860,1925,0.035,-65,1892.5,"Con",0,50,FALSE,FALSE,FALSE,3.38,"young",38,178,77,"f"
7,"LEG EXTENSION",2,"Con08",1820,1840,2050,2100,1830,2075,0.134,-245,1952.5,"Con",-20,-50,TRUE,FALSE,FALSE,11.81,"young",38,178,77,"f"
7,"LEG EXTENSION",2,"Con09",1740,1740,1950,1900,1740,1925,0.106,-185,1832.5,"Con",0,50,TRUE,FALSE,FALSE,9.61,"young",38,178,77,"f"
7,"LEG EXTENSION",2,"Con10",1500,1500,1900,1850,1500,1875,0.25,-375,1687.5,"Con",0,50,TRUE,FALSE,FALSE,20,"young",38,178,77,"f"
7,"LEG EXTENSION",1,"Ecc01",3260,3260,3200,3250,3260,3225,0.011,35,3242.5,"Ecc",0,-50,FALSE,FALSE,FALSE,1.09,"young",38,178,77,"f"
7,"LEG EXTENSION",1,"Ecc02",3180,3160,3200,3250,3170,3225,0.017,-55,3197.5,"Ecc",20,-50,FALSE,FALSE,FALSE,1.71,"young",38,178,77,"f"
7,"LEG EXTENSION",1,"Ecc03",3200,3180,3100,3150,3190,3125,0.02,65,3157.5,"Ecc",20,-50,FALSE,FALSE,FALSE,2.08,"young",38,178,77,"f"
7,"LEG EXTENSION",1,"Ecc04",3260,3220,3200,3200,3240,3200,0.012,40,3220,"Ecc",40,0,FALSE,TRUE,FALSE,1.25,"young",38,178,77,"f"
7,"LEG EXTENSION",1,"Ecc05",3180,3160,3100,3100,3170,3100,0.022,70,3135,"Ecc",20,0,FALSE,FALSE,FALSE,2.26,"young",38,178,77,"f"
7,"LEG EXTENSION",1,"Ecc06",3180,3140,3000,2950,3160,2975,0.059,185,3067.5,"Ecc",40,50,FALSE,TRUE,FALSE,6.22,"young",38,178,77,"f"
7,"LEG EXTENSION",1,"Ecc07",3560,3540,3500,3150,3550,3325,0.063,225,3437.5,"Ecc",20,350,TRUE,FALSE,TRUE,6.77,"young",38,178,77,"f"
7,"LEG EXTENSION",1,"Ecc08",3500,3480,3350,3400,3490,3375,0.033,115,3432.5,"Ecc",20,-50,FALSE,FALSE,FALSE,3.41,"young",38,178,77,"f"
7,"LEG EXTENSION",1,"Ecc09",3720,3740,3450,3400,3730,3425,0.082,305,3577.5,"Ecc",-20,50,TRUE,FALSE,FALSE,8.91,"young",38,178,77,"f"
7,"LEG EXTENSION",1,"Ecc10",3480,3500,3500,3450,3490,3475,0.004,15,3482.5,"Ecc",-20,50,FALSE,FALSE,FALSE,0.43,"young",38,178,77,"f"
7,"LEG EXTENSION",2,"Ecc01",3360,3360,3350,3400,3360,3375,0.004,-15,3367.5,"Ecc",0,-50,FALSE,FALSE,FALSE,0.44,"young",38,178,77,"f"
7,"LEG EXTENSION",2,"Ecc02",3580,3540,3550,3500,3560,3525,0.01,35,3542.5,"Ecc",40,50,FALSE,TRUE,FALSE,0.99,"young",38,178,77,"f"
7,"LEG EXTENSION",2,"Ecc03",3880,3900,3800,3800,3890,3800,0.023,90,3845,"Ecc",-20,0,FALSE,FALSE,FALSE,2.37,"young",38,178,77,"f"
7,"LEG EXTENSION",2,"Ecc04",3580,3540,3500,3450,3560,3475,0.024,85,3517.5,"Ecc",40,50,FALSE,TRUE,FALSE,2.45,"young",38,178,77,"f"
7,"LEG EXTENSION",2,"Ecc05",3560,3560,3450,3500,3560,3475,0.024,85,3517.5,"Ecc",0,-50,FALSE,FALSE,FALSE,2.45,"young",38,178,77,"f"
7,"LEG EXTENSION",2,"Ecc06",3780,3760,3700,3700,3770,3700,0.019,70,3735,"Ecc",20,0,FALSE,FALSE,FALSE,1.89,"young",38,178,77,"f"
7,"LEG EXTENSION",2,"Ecc07",3800,3820,3550,3500,3810,3525,0.075,285,3667.5,"Ecc",-20,50,TRUE,FALSE,FALSE,8.09,"young",38,178,77,"f"
7,"LEG EXTENSION",2,"Ecc08",3620,3620,3450,3500,3620,3475,0.04,145,3547.5,"Ecc",0,-50,FALSE,FALSE,FALSE,4.17,"young",38,178,77,"f"
7,"LEG EXTENSION",2,"Ecc09",3300,3300,2900,3000,3300,2950,0.106,350,3125,"Ecc",0,-100,TRUE,FALSE,FALSE,11.86,"young",38,178,77,"f"
7,"LEG EXTENSION",2,"Ecc10",3140,3160,3150,3150,3150,3150,0,0,3150,"Ecc",-20,0,FALSE,FALSE,FALSE,0,"young",38,178,77,"f"
7,"LEG EXTENSION",1,"Rep01",5100,5120,5200,5000,5110,5100,0.002,10,5105,"Rep",-20,200,FALSE,FALSE,TRUE,0.2,"young",38,178,77,"f"
7,"LEG EXTENSION",1,"Rep02",4980,4980,5000,5000,4980,5000,0.004,-20,4990,"Rep",0,0,FALSE,FALSE,FALSE,0.4,"young",38,178,77,"f"
7,"LEG EXTENSION",1,"Rep03",5020,5040,5000,4950,5030,4975,0.011,55,5002.5,"Rep",-20,50,FALSE,FALSE,FALSE,1.11,"young",38,178,77,"f"
7,"LEG EXTENSION",1,"Rep04",4940,4900,4950,4950,4920,4950,0.006,-30,4935,"Rep",40,0,FALSE,FALSE,FALSE,0.61,"young",38,178,77,"f"
7,"LEG EXTENSION",1,"Rep05",4880,4880,4850,4850,4880,4850,0.006,30,4865,"Rep",0,0,FALSE,FALSE,FALSE,0.62,"young",38,178,77,"f"
7,"LEG EXTENSION",1,"Rep06",4680,4680,4600,4550,4680,4575,0.022,105,4627.5,"Rep",0,50,FALSE,FALSE,FALSE,2.3,"young",38,178,77,"f"
7,"LEG EXTENSION",1,"Rep07",5080,5100,5250,5000,5090,5125,0.007,-35,5107.5,"Rep",-20,250,FALSE,FALSE,TRUE,0.68,"young",38,178,77,"f"
7,"LEG EXTENSION",1,"Rep08",5180,5160,5050,5350,5170,5200,0.006,-30,5185,"Rep",20,-300,FALSE,FALSE,TRUE,0.58,"young",38,178,77,"f"
7,"LEG EXTENSION",1,"Rep09",5320,5380,5200,5150,5350,5175,0.033,175,5262.5,"Rep",-60,50,TRUE,FALSE,FALSE,3.38,"young",38,178,77,"f"
7,"LEG EXTENSION",1,"Rep10",5120,5100,5450,5450,5110,5450,0.067,-340,5280,"Rep",20,0,TRUE,FALSE,FALSE,6.24,"young",38,178,77,"f"
7,"LEG EXTENSION",2,"Rep01",5300,5300,5400,5400,5300,5400,0.019,-100,5350,"Rep",0,0,FALSE,FALSE,FALSE,1.85,"young",38,178,77,"f"
7,"LEG EXTENSION",2,"Rep02",5540,5540,5550,5500,5540,5525,0.003,15,5532.5,"Rep",0,50,FALSE,FALSE,FALSE,0.27,"young",38,178,77,"f"
7,"LEG EXTENSION",2,"Rep03",5700,5720,5650,5650,5710,5650,0.011,60,5680,"Rep",-20,0,FALSE,FALSE,FALSE,1.06,"young",38,178,77,"f"
7,"LEG EXTENSION",2,"Rep04",5420,5400,5400,5400,5410,5400,0.002,10,5405,"Rep",20,0,FALSE,FALSE,FALSE,0.19,"young",38,178,77,"f"
7,"LEG EXTENSION",2,"Rep05",5420,5440,5450,5500,5430,5475,0.008,-45,5452.5,"Rep",-20,-50,FALSE,FALSE,FALSE,0.82,"young",38,178,77,"f"
7,"LEG EXTENSION",2,"Rep06",5760,5720,5750,5750,5740,5750,0.002,-10,5745,"Rep",40,0,FALSE,FALSE,FALSE,0.17,"young",38,178,77,"f"
7,"LEG EXTENSION",2,"Rep07",5660,5680,5500,5400,5670,5450,0.039,220,5560,"Rep",-20,100,TRUE,FALSE,FALSE,4.04,"young",38,178,77,"f"
7,"LEG EXTENSION",2,"Rep08",5440,5460,5500,5600,5450,5550,0.018,-100,5500,"Rep",-20,-100,FALSE,FALSE,FALSE,1.8,"young",38,178,77,"f"
7,"LEG EXTENSION",2,"Rep09",5040,5040,4850,4900,5040,4875,0.033,165,4957.5,"Rep",0,-50,TRUE,FALSE,FALSE,3.38,"young",38,178,77,"f"
7,"LEG EXTENSION",2,"Rep10",4640,4660,5050,5000,4650,5025,0.081,-375,4837.5,"Rep",-20,50,TRUE,FALSE,FALSE,7.46,"young",38,178,77,"f"
7,"LEG EXTENSION",1,"TuT",50300,50340,50550,50250,50320,50400,0.002,-80,50360,"TuT",-40,300,FALSE,FALSE,TRUE,0.16,"young",38,178,77,"f"
7,"LEG EXTENSION",2,"TuT",53920,53960,54100,54100,53940,54100,0.003,-160,54020,"TuT",-40,0,FALSE,FALSE,FALSE,0.3,"young",38,178,77,"f"
7,"LEG CURL",1,"Con01",2860,2880,2850,2900,2870,2875,0.002,-5,2872.5,"Con",-20,-50,FALSE,FALSE,FALSE,0.17,"young",38,178,77,"f"
7,"LEG CURL",1,"Con02",2540,2500,2400,2550,2520,2475,0.018,45,2497.5,"Con",40,-150,FALSE,FALSE,FALSE,1.82,"young",38,178,77,"f"
7,"LEG CURL",1,"Con03",2220,2220,2300,2200,2220,2250,0.014,-30,2235,"Con",0,100,FALSE,FALSE,FALSE,1.33,"young",38,178,77,"f"
7,"LEG CURL",1,"Con04",2100,2120,2200,2050,2110,2125,0.007,-15,2117.5,"Con",-20,150,FALSE,FALSE,FALSE,0.71,"young",38,178,77,"f"
7,"LEG CURL",1,"Con05",2220,2240,2250,2250,2230,2250,0.009,-20,2240,"Con",-20,0,FALSE,FALSE,FALSE,0.89,"young",38,178,77,"f"
7,"LEG CURL",1,"Con06",2180,2140,2300,2250,2160,2275,0.053,-115,2217.5,"Con",40,50,FALSE,FALSE,FALSE,5.05,"young",38,178,77,"f"
7,"LEG CURL",1,"Con07",1940,1920,2200,2100,1930,2150,0.114,-220,2040,"Con",20,100,FALSE,FALSE,FALSE,10.23,"young",38,178,77,"f"
7,"LEG CURL",1,"Con08",2160,2160,2400,2400,2160,2400,0.111,-240,2280,"Con",0,0,TRUE,FALSE,FALSE,10,"young",38,178,77,"f"
7,"LEG CURL",1,"Con09",2240,2180,2450,2550,2210,2500,0.131,-290,2355,"Con",60,-100,TRUE,FALSE,FALSE,11.6,"young",38,178,77,"f"
7,"LEG CURL",1,"Con10",2240,2240,2400,2550,2240,2475,0.105,-235,2357.5,"Con",0,-150,TRUE,FALSE,FALSE,9.49,"young",38,178,77,"f"
7,"LEG CURL",2,"Con01",2320,2300,2300,2300,2310,2300,0.004,10,2305,"Con",20,0,FALSE,FALSE,FALSE,0.43,"young",38,178,77,"f"
7,"LEG CURL",2,"Con02",2260,2260,2300,2250,2260,2275,0.007,-15,2267.5,"Con",0,50,FALSE,FALSE,FALSE,0.66,"young",38,178,77,"f"
7,"LEG CURL",2,"Con03",2400,2380,2400,2400,2390,2400,0.004,-10,2395,"Con",20,0,FALSE,FALSE,FALSE,0.42,"young",38,178,77,"f"
7,"LEG CURL",2,"Con04",2120,2100,2150,2200,2110,2175,0.031,-65,2142.5,"Con",20,-50,FALSE,FALSE,FALSE,2.99,"young",38,178,77,"f"
7,"LEG CURL",2,"Con05",2180,2200,2250,2300,2190,2275,0.039,-85,2232.5,"Con",-20,-50,FALSE,FALSE,FALSE,3.74,"young",38,178,77,"f"
7,"LEG CURL",2,"Con06",2000,2000,2050,2100,2000,2075,0.038,-75,2037.5,"Con",0,-50,FALSE,FALSE,FALSE,3.61,"young",38,178,77,"f"
7,"LEG CURL",2,"Con07",2460,2420,2700,2600,2440,2650,0.086,-210,2545,"Con",40,100,FALSE,FALSE,FALSE,7.92,"young",38,178,77,"f"
7,"LEG CURL",2,"Con08",1880,1860,2050,2000,1870,2025,0.083,-155,1947.5,"Con",20,50,FALSE,FALSE,FALSE,7.65,"young",38,178,77,"f"
7,"LEG CURL",2,"Con09",2080,2080,2600,2350,2080,2475,0.19,-395,2277.5,"Con",0,250,TRUE,FALSE,TRUE,15.96,"young",38,178,77,"f"
7,"LEG CURL",2,"Con10",1960,1960,2700,2600,1960,2650,0.352,-690,2305,"Con",0,100,TRUE,FALSE,FALSE,26.04,"young",38,178,77,"f"
7,"LEG CURL",1,"Ecc01",3740,3760,3850,3700,3750,3775,0.007,-25,3762.5,"Ecc",-20,150,FALSE,FALSE,FALSE,0.66,"young",38,178,77,"f"
7,"LEG CURL",1,"Ecc02",3560,3560,3550,3550,3560,3550,0.003,10,3555,"Ecc",0,0,FALSE,FALSE,FALSE,0.28,"young",38,178,77,"f"
7,"LEG CURL",1,"Ecc03",3740,3760,3700,3850,3750,3775,0.007,-25,3762.5,"Ecc",-20,-150,FALSE,FALSE,FALSE,0.66,"young",38,178,77,"f"
7,"LEG CURL",1,"Ecc04",3700,3660,3600,3700,3680,3650,0.008,30,3665,"Ecc",40,-100,FALSE,FALSE,FALSE,0.82,"young",38,178,77,"f"
7,"LEG CURL",1,"Ecc05",3760,3800,3650,3650,3780,3650,0.034,130,3715,"Ecc",-40,0,FALSE,FALSE,FALSE,3.56,"young",38,178,77,"f"
7,"LEG CURL",1,"Ecc06",3460,3460,3250,3350,3460,3300,0.046,160,3380,"Ecc",0,-100,FALSE,FALSE,FALSE,4.85,"young",38,178,77,"f"
7,"LEG CURL",1,"Ecc07",3680,3700,3450,3450,3690,3450,0.065,240,3570,"Ecc",-20,0,TRUE,FALSE,FALSE,6.96,"young",38,178,77,"f"
7,"LEG CURL",1,"Ecc08",3880,3920,3700,3600,3900,3650,0.064,250,3775,"Ecc",-40,100,TRUE,FALSE,FALSE,6.85,"young",38,178,77,"f"
7,"LEG CURL",1,"Ecc09",4040,4060,3850,3750,4050,3800,0.062,250,3925,"Ecc",-20,100,TRUE,FALSE,FALSE,6.58,"young",38,178,77,"f"
7,"LEG CURL",1,"Ecc10",3600,3580,3550,3600,3590,3575,0.004,15,3582.5,"Ecc",20,-50,FALSE,FALSE,FALSE,0.42,"young",38,178,77,"f"
7,"LEG CURL",2,"Ecc01",2880,2900,2900,2950,2890,2925,0.012,-35,2907.5,"Ecc",-20,-50,FALSE,FALSE,FALSE,1.2,"young",38,178,77,"f"
7,"LEG CURL",2,"Ecc02",3580,3600,3550,3550,3590,3550,0.011,40,3570,"Ecc",-20,0,FALSE,FALSE,FALSE,1.13,"young",38,178,77,"f"
7,"LEG CURL",2,"Ecc03",3300,3320,3250,3250,3310,3250,0.018,60,3280,"Ecc",-20,0,FALSE,FALSE,FALSE,1.85,"young",38,178,77,"f"
7,"LEG CURL",2,"Ecc04",4160,4140,4100,4050,4150,4075,0.018,75,4112.5,"Ecc",20,50,FALSE,FALSE,FALSE,1.84,"young",38,178,77,"f"
7,"LEG CURL",2,"Ecc05",3720,3720,3650,3600,3720,3625,0.026,95,3672.5,"Ecc",0,50,FALSE,FALSE,FALSE,2.62,"young",38,178,77,"f"
7,"LEG CURL",2,"Ecc06",3720,3740,3500,3600,3730,3550,0.048,180,3640,"Ecc",-20,-100,FALSE,FALSE,FALSE,5.07,"young",38,178,77,"f"
7,"LEG CURL",2,"Ecc07",4220,4240,4100,4100,4230,4100,0.031,130,4165,"Ecc",-20,0,FALSE,FALSE,FALSE,3.17,"young",38,178,77,"f"
7,"LEG CURL",2,"Ecc08",4280,4320,3800,4050,4300,3925,0.087,375,4112.5,"Ecc",-40,-250,TRUE,FALSE,TRUE,9.55,"young",38,178,77,"f"
7,"LEG CURL",2,"Ecc09",4200,4200,3450,3550,4200,3500,0.167,700,3850,"Ecc",0,-100,TRUE,FALSE,FALSE,20,"young",38,178,77,"f"
7,"LEG CURL",2,"Ecc10",3160,3160,3150,3200,3160,3175,0.005,-15,3167.5,"Ecc",0,-50,FALSE,FALSE,FALSE,0.47,"young",38,178,77,"f"
7,"LEG CURL",1,"Rep01",6600,6640,6700,6600,6620,6650,0.005,-30,6635,"Rep",-40,100,FALSE,FALSE,FALSE,0.45,"young",38,178,77,"f"
7,"LEG CURL",1,"Rep02",6100,6060,5950,6100,6080,6025,0.009,55,6052.5,"Rep",40,-150,FALSE,FALSE,FALSE,0.91,"young",38,178,77,"f"
7,"LEG CURL",1,"Rep03",5960,5980,6000,6050,5970,6025,0.009,-55,5997.5,"Rep",-20,-50,FALSE,FALSE,FALSE,0.91,"young",38,178,77,"f"
7,"LEG CURL",1,"Rep04",5800,5780,5800,5750,5790,5775,0.003,15,5782.5,"Rep",20,50,FALSE,FALSE,FALSE,0.26,"young",38,178,77,"f"
7,"LEG CURL",1,"Rep05",5980,6040,5900,5900,6010,5900,0.018,110,5955,"Rep",-60,0,FALSE,FALSE,FALSE,1.86,"young",38,178,77,"f"
7,"LEG CURL",1,"Rep06",5640,5600,5550,5600,5620,5575,0.008,45,5597.5,"Rep",40,-50,FALSE,FALSE,FALSE,0.81,"young",38,178,77,"f"
7,"LEG CURL",1,"Rep07",5620,5620,5650,5550,5620,5600,0.004,20,5610,"Rep",0,100,FALSE,FALSE,FALSE,0.36,"young",38,178,77,"f"
7,"LEG CURL",1,"Rep08",6040,6080,6100,6000,6060,6050,0.002,10,6055,"Rep",-40,100,FALSE,FALSE,FALSE,0.17,"young",38,178,77,"f"
7,"LEG CURL",1,"Rep09",6280,6240,6300,6300,6260,6300,0.006,-40,6280,"Rep",40,0,FALSE,FALSE,FALSE,0.63,"young",38,178,77,"f"
7,"LEG CURL",1,"Rep10",5840,5820,5950,6150,5830,6050,0.038,-220,5940,"Rep",20,-200,TRUE,FALSE,TRUE,3.64,"young",38,178,77,"f"
7,"LEG CURL",2,"Rep01",5200,5200,5200,5250,5200,5225,0.005,-25,5212.5,"Rep",0,-50,FALSE,FALSE,FALSE,0.48,"young",38,178,77,"f"
7,"LEG CURL",2,"Rep02",5840,5860,5850,5800,5850,5825,0.004,25,5837.5,"Rep",-20,50,FALSE,FALSE,FALSE,0.43,"young",38,178,77,"f"
7,"LEG CURL",2,"Rep03",5700,5700,5650,5650,5700,5650,0.009,50,5675,"Rep",0,0,FALSE,FALSE,FALSE,0.88,"young",38,178,77,"f"
7,"LEG CURL",2,"Rep04",6280,6240,6250,6250,6260,6250,0.002,10,6255,"Rep",40,0,FALSE,FALSE,FALSE,0.16,"young",38,178,77,"f"
7,"LEG CURL",2,"Rep05",5900,5920,5900,5900,5910,5900,0.002,10,5905,"Rep",-20,0,FALSE,FALSE,FALSE,0.17,"young",38,178,77,"f"
7,"LEG CURL",2,"Rep06",5720,5740,5550,5700,5730,5625,0.018,105,5677.5,"Rep",-20,-150,FALSE,FALSE,FALSE,1.87,"young",38,178,77,"f"
7,"LEG CURL",2,"Rep07",6680,6660,6800,6700,6670,6750,0.012,-80,6710,"Rep",20,100,FALSE,FALSE,FALSE,1.19,"young",38,178,77,"f"
7,"LEG CURL",2,"Rep08",6160,6180,5850,6050,6170,5950,0.036,220,6060,"Rep",-20,-200,TRUE,FALSE,TRUE,3.7,"young",38,178,77,"f"
7,"LEG CURL",2,"Rep09",6280,6280,6050,5900,6280,5975,0.049,305,6127.5,"Rep",0,150,TRUE,FALSE,FALSE,5.1,"young",38,178,77,"f"
7,"LEG CURL",2,"Rep10",5120,5120,5850,5800,5120,5825,0.138,-705,5472.5,"Rep",0,50,TRUE,FALSE,FALSE,12.1,"young",38,178,77,"f"
7,"LEG CURL",1,"TuT",59860,59860,59900,60000,59860,59950,0.002,-90,59905,"TuT",0,-100,FALSE,FALSE,FALSE,0.15,"young",38,178,77,"f"
7,"LEG CURL",2,"TuT",58880,58900,58950,59000,58890,58975,0.001,-85,58932.5,"TuT",-20,-50,FALSE,FALSE,FALSE,0.14,"young",38,178,77,"f"
7,"ABDUCTOR",1,"Con01",1820,1760,1800,1850,1790,1825,0.02,-35,1807.5,"Con",60,-50,FALSE,TRUE,FALSE,1.92,"young",38,178,77,"f"
7,"ABDUCTOR",1,"Con02",1640,1660,1700,1550,1650,1625,0.015,25,1637.5,"Con",-20,150,FALSE,FALSE,FALSE,1.54,"young",38,178,77,"f"
7,"ABDUCTOR",1,"Con03",1600,1560,1750,1750,1580,1750,0.108,-170,1665,"Con",40,0,FALSE,TRUE,FALSE,9.71,"young",38,178,77,"f"
7,"ABDUCTOR",1,"Con04",1340,1360,1550,1550,1350,1550,0.148,-200,1450,"Con",-20,0,FALSE,FALSE,FALSE,12.9,"young",38,178,77,"f"
7,"ABDUCTOR",1,"Con05",1320,1320,1650,1800,1320,1725,0.307,-405,1522.5,"Con",0,-150,TRUE,FALSE,FALSE,23.48,"young",38,178,77,"f"
7,"ABDUCTOR",1,"Con06",1440,1500,1750,1700,1470,1725,0.173,-255,1597.5,"Con",-60,50,FALSE,TRUE,FALSE,14.78,"young",38,178,77,"f"
7,"ABDUCTOR",1,"Con07",1460,1420,1650,1500,1440,1575,0.094,-135,1507.5,"Con",40,150,FALSE,TRUE,FALSE,8.57,"young",38,178,77,"f"
7,"ABDUCTOR",1,"Con08",1540,1580,1650,1550,1560,1600,0.026,-40,1580,"Con",-40,100,FALSE,TRUE,FALSE,2.5,"young",38,178,77,"f"
7,"ABDUCTOR",1,"Con09",1380,1360,1450,1450,1370,1450,0.058,-80,1410,"Con",20,0,FALSE,FALSE,FALSE,5.52,"young",38,178,77,"f"
7,"ABDUCTOR",1,"Con10",1280,1280,1200,1650,1280,1425,0.113,-145,1352.5,"Con",0,-450,FALSE,FALSE,TRUE,10.18,"young",38,178,77,"f"
7,"ABDUCTOR",2,"Con01",1500,1520,1600,1650,1510,1625,0.076,-115,1567.5,"Con",-20,-50,FALSE,FALSE,FALSE,7.08,"young",38,178,77,"f"
7,"ABDUCTOR",2,"Con02",1460,1480,1550,1900,1470,1725,0.173,-255,1597.5,"Con",-20,-350,FALSE,FALSE,TRUE,14.78,"young",38,178,77,"f"
7,"ABDUCTOR",2,"Con03",1820,1800,2050,1850,1810,1950,0.077,-140,1880,"Con",20,200,FALSE,FALSE,FALSE,7.18,"young",38,178,77,"f"
7,"ABDUCTOR",2,"Con04",1520,1460,1800,1550,1490,1675,0.124,-185,1582.5,"Con",60,250,FALSE,TRUE,TRUE,11.04,"young",38,178,77,"f"
7,"ABDUCTOR",2,"Con05",1640,1620,1800,1750,1630,1775,0.089,-145,1702.5,"Con",20,50,FALSE,FALSE,FALSE,8.17,"young",38,178,77,"f"
7,"ABDUCTOR",2,"Con06",1320,1280,1550,1500,1300,1525,0.173,-225,1412.5,"Con",40,50,FALSE,TRUE,FALSE,14.75,"young",38,178,77,"f"
7,"ABDUCTOR",2,"Con07",1360,1380,1500,1550,1370,1525,0.113,-155,1447.5,"Con",-20,-50,FALSE,FALSE,FALSE,10.16,"young",38,178,77,"f"
7,"ABDUCTOR",2,"Con08",1360,1340,1450,1650,1350,1550,0.148,-200,1450,"Con",20,-200,FALSE,FALSE,FALSE,12.9,"young",38,178,77,"f"
7,"ABDUCTOR",2,"Con09",1300,1280,1500,1650,1290,1575,0.221,-285,1432.5,"Con",20,-150,FALSE,FALSE,FALSE,18.1,"young",38,178,77,"f"
7,"ABDUCTOR",2,"Con10",1400,1380,1650,1750,1390,1700,0.223,-310,1545,"Con",20,-100,TRUE,FALSE,FALSE,18.24,"young",38,178,77,"f"
7,"ABDUCTOR",1,"Ecc01",2620,2620,2600,2650,2620,2625,0.002,-5,2622.5,"Ecc",0,-50,FALSE,FALSE,FALSE,0.19,"young",38,178,77,"f"
7,"ABDUCTOR",1,"Ecc02",2860,2880,2800,2850,2870,2825,0.016,45,2847.5,"Ecc",-20,-50,FALSE,FALSE,FALSE,1.59,"young",38,178,77,"f"
7,"ABDUCTOR",1,"Ecc03",2780,2800,2550,2600,2790,2575,0.077,215,2682.5,"Ecc",-20,-50,FALSE,FALSE,FALSE,8.35,"young",38,178,77,"f"
7,"ABDUCTOR",1,"Ecc04",2920,2900,2650,2500,2910,2575,0.115,335,2742.5,"Ecc",20,150,TRUE,FALSE,FALSE,13.01,"young",38,178,77,"f"
7,"ABDUCTOR",1,"Ecc05",2780,2740,2450,2450,2760,2450,0.112,310,2605,"Ecc",40,0,TRUE,TRUE,FALSE,12.65,"young",38,178,77,"f"
7,"ABDUCTOR",1,"Ecc06",3100,3120,2900,3000,3110,2950,0.051,160,3030,"Ecc",-20,-100,FALSE,FALSE,FALSE,5.42,"young",38,178,77,"f"
7,"ABDUCTOR",1,"Ecc07",2800,2800,2650,2800,2800,2725,0.027,75,2762.5,"Ecc",0,-150,FALSE,FALSE,FALSE,2.75,"young",38,178,77,"f"
7,"ABDUCTOR",1,"Ecc08",3140,3100,3050,3150,3120,3100,0.006,20,3110,"Ecc",40,-100,FALSE,TRUE,FALSE,0.65,"young",38,178,77,"f"
7,"ABDUCTOR",1,"Ecc09",2940,2960,2950,2600,2950,2775,0.059,175,2862.5,"Ecc",-20,350,FALSE,FALSE,TRUE,6.31,"young",38,178,77,"f"
7,"ABDUCTOR",1,"Ecc10",2400,2420,2500,2350,2410,2425,0.006,-15,2417.5,"Ecc",-20,150,FALSE,FALSE,FALSE,0.62,"young",38,178,77,"f"
7,"ABDUCTOR",2,"Ecc01",3060,3020,2950,2600,3040,2775,0.087,265,2907.5,"Ecc",40,350,FALSE,TRUE,TRUE,9.55,"young",38,178,77,"f"
7,"ABDUCTOR",2,"Ecc02",2740,2780,2550,2700,2760,2625,0.049,135,2692.5,"Ecc",-40,-150,FALSE,TRUE,FALSE,5.14,"young",38,178,77,"f"
7,"ABDUCTOR",2,"Ecc03",3080,3120,2750,3000,3100,2875,0.073,225,2987.5,"Ecc",-40,-250,FALSE,TRUE,FALSE,7.83,"young",38,178,77,"f"
7,"ABDUCTOR",2,"Ecc04",3220,3260,3100,3200,3240,3150,0.028,90,3195,"Ecc",-40,-100,FALSE,TRUE,FALSE,2.86,"young",38,178,77,"f"
7,"ABDUCTOR",2,"Ecc05",2940,2960,2700,2750,2950,2725,0.076,225,2837.5,"Ecc",-20,-50,FALSE,FALSE,FALSE,8.26,"young",38,178,77,"f"
7,"ABDUCTOR",2,"Ecc06",3120,3140,2950,2900,3130,2925,0.065,205,3027.5,"Ecc",-20,50,FALSE,FALSE,FALSE,7.01,"young",38,178,77,"f"
7,"ABDUCTOR",2,"Ecc07",2820,2800,2700,2550,2810,2625,0.066,185,2717.5,"Ecc",20,150,FALSE,FALSE,FALSE,7.05,"young",38,178,77,"f"
7,"ABDUCTOR",2,"Ecc08",2680,2720,2550,2400,2700,2475,0.083,225,2587.5,"Ecc",-40,150,FALSE,TRUE,FALSE,9.09,"young",38,178,77,"f"
7,"ABDUCTOR",2,"Ecc09",2880,2900,2600,2500,2890,2550,0.118,340,2720,"Ecc",-20,100,TRUE,FALSE,FALSE,13.33,"young",38,178,77,"f"
7,"ABDUCTOR",2,"Ecc10",2800,2800,2800,2700,2800,2750,0.018,50,2775,"Ecc",0,100,FALSE,FALSE,FALSE,1.82,"young",38,178,77,"f"
7,"ABDUCTOR",1,"Rep01",4440,4380,4400,4500,4410,4450,0.009,-40,4430,"Rep",60,-100,FALSE,FALSE,FALSE,0.9,"young",38,178,77,"f"
7,"ABDUCTOR",1,"Rep02",4500,4540,4500,4400,4520,4450,0.015,70,4485,"Rep",-40,100,FALSE,FALSE,FALSE,1.57,"young",38,178,77,"f"
7,"ABDUCTOR",1,"Rep03",4380,4360,4300,4350,4370,4325,0.01,45,4347.5,"Rep",20,-50,FALSE,FALSE,FALSE,1.04,"young",38,178,77,"f"
7,"ABDUCTOR",1,"Rep04",4260,4260,4200,4050,4260,4125,0.032,135,4192.5,"Rep",0,150,FALSE,FALSE,FALSE,3.27,"young",38,178,77,"f"
7,"ABDUCTOR",1,"Rep05",4100,4060,4100,4250,4080,4175,0.023,-95,4127.5,"Rep",40,-150,FALSE,FALSE,FALSE,2.28,"young",38,178,77,"f"
7,"ABDUCTOR",1,"Rep06",4540,4620,4650,4700,4580,4675,0.021,-95,4627.5,"Rep",-80,-50,FALSE,TRUE,FALSE,2.03,"young",38,178,77,"f"
7,"ABDUCTOR",1,"Rep07",4260,4220,4300,4300,4240,4300,0.014,-60,4270,"Rep",40,0,FALSE,FALSE,FALSE,1.4,"young",38,178,77,"f"
7,"ABDUCTOR",1,"Rep08",4680,4680,4700,4700,4680,4700,0.004,-20,4690,"Rep",0,0,FALSE,FALSE,FALSE,0.43,"young",38,178,77,"f"
7,"ABDUCTOR",1,"Rep09",4320,4320,4400,4050,4320,4225,0.022,95,4272.5,"Rep",0,350,FALSE,FALSE,TRUE,2.25,"young",38,178,77,"f"
7,"ABDUCTOR",1,"Rep10",3680,3700,3700,4000,3690,3850,0.043,-160,3770,"Rep",-20,-300,FALSE,FALSE,FALSE,4.16,"young",38,178,77,"f"
7,"ABDUCTOR",2,"Rep01",4560,4540,4550,4250,4550,4400,0.033,150,4475,"Rep",20,300,FALSE,FALSE,FALSE,3.41,"young",38,178,77,"f"
7,"ABDUCTOR",2,"Rep02",4200,4260,4100,4600,4230,4350,0.028,-120,4290,"Rep",-60,-500,FALSE,FALSE,TRUE,2.76,"young",38,178,77,"f"
7,"ABDUCTOR",2,"Rep03",4900,4920,4800,4850,4910,4825,0.017,85,4867.5,"Rep",-20,-50,FALSE,FALSE,FALSE,1.76,"young",38,178,77,"f"
7,"ABDUCTOR",2,"Rep04",4740,4720,4900,4750,4730,4825,0.02,-95,4777.5,"Rep",20,150,FALSE,FALSE,FALSE,1.97,"young",38,178,77,"f"
7,"ABDUCTOR",2,"Rep05",4580,4580,4500,4500,4580,4500,0.017,80,4540,"Rep",0,0,FALSE,FALSE,FALSE,1.78,"young",38,178,77,"f"
7,"ABDUCTOR",2,"Rep06",4440,4420,4500,4400,4430,4450,0.005,-20,4440,"Rep",20,100,FALSE,FALSE,FALSE,0.45,"young",38,178,77,"f"
7,"ABDUCTOR",2,"Rep07",4180,4180,4200,4100,4180,4150,0.007,30,4165,"Rep",0,100,FALSE,FALSE,FALSE,0.72,"young",38,178,77,"f"
7,"ABDUCTOR",2,"Rep08",4040,4060,4000,4050,4050,4025,0.006,25,4037.5,"Rep",-20,-50,FALSE,FALSE,FALSE,0.62,"young",38,178,77,"f"
7,"ABDUCTOR",2,"Rep09",4180,4180,4100,4150,4180,4125,0.013,55,4152.5,"Rep",0,-50,FALSE,FALSE,FALSE,1.33,"young",38,178,77,"f"
7,"ABDUCTOR",2,"Rep10",4200,4180,4450,4450,4190,4450,0.062,-260,4320,"Rep",20,0,FALSE,FALSE,FALSE,5.84,"young",38,178,77,"f"
7,"ABDUCTOR",1,"TuT",43160,43140,43250,43300,43150,43275,0.003,-125,43212.5,"TuT",20,-50,FALSE,FALSE,FALSE,0.29,"young",38,178,77,"f"
7,"ABDUCTOR",2,"TuT",44020,44040,44100,44100,44030,44100,0.002,-70,44065,"TuT",-20,0,FALSE,FALSE,FALSE,0.16,"young",38,178,77,"f"
7,"ADDUCTOR",1,"Con01",1560,1580,1800,750,1570,1275,0.188,295,1422.5,"Con",-20,1050,FALSE,FALSE,TRUE,23.14,"young",38,178,77,"f"
7,"ADDUCTOR",1,"Con02",1620,1660,2000,2250,1640,2125,0.296,-485,1882.5,"Con",-40,-250,FALSE,TRUE,FALSE,22.82,"young",38,178,77,"f"
7,"ADDUCTOR",1,"Con03",1500,1480,2250,3450,1490,2850,0.913,-1360,2170,"Con",20,-1200,TRUE,FALSE,TRUE,47.72,"young",38,178,77,"f"
7,"ADDUCTOR",1,"Con04",1920,1840,3100,4250,1880,3675,0.955,-1795,2777.5,"Con",80,-1150,TRUE,TRUE,TRUE,48.84,"young",38,178,77,"f"
7,"ADDUCTOR",1,"Con05",1940,1920,2100,1900,1930,2000,0.036,-70,1965,"Con",20,200,FALSE,FALSE,FALSE,3.5,"young",38,178,77,"f"
7,"ADDUCTOR",1,"Con06",1780,1760,1850,1800,1770,1825,0.031,-55,1797.5,"Con",20,50,FALSE,FALSE,FALSE,3.01,"young",38,178,77,"f"
7,"ADDUCTOR",1,"Con07",1680,1700,1650,1600,1690,1625,0.038,65,1657.5,"Con",-20,50,FALSE,FALSE,FALSE,4,"young",38,178,77,"f"
7,"ADDUCTOR",1,"Con08",1600,1620,1850,1700,1610,1775,0.102,-165,1692.5,"Con",-20,150,FALSE,FALSE,FALSE,9.3,"young",38,178,77,"f"
7,"ADDUCTOR",1,"Con09",1660,1660,2150,1900,1660,2025,0.22,-365,1842.5,"Con",0,250,FALSE,FALSE,FALSE,18.02,"young",38,178,77,"f"
7,"ADDUCTOR",1,"Con10",1700,1720,2300,2050,1710,2175,0.272,-465,1942.5,"Con",-20,250,FALSE,FALSE,FALSE,21.38,"young",38,178,77,"f"
7,"ADDUCTOR",2,"Con01",1340,1340,1400,1400,1340,1400,0.045,-60,1370,"Con",0,0,FALSE,FALSE,FALSE,4.29,"young",38,178,77,"f"
7,"ADDUCTOR",2,"Con02",1760,1800,1550,1600,1780,1575,0.115,205,1677.5,"Con",-40,-50,FALSE,TRUE,FALSE,13.02,"young",38,178,77,"f"
7,"ADDUCTOR",2,"Con03",1820,1760,1950,1950,1790,1950,0.089,-160,1870,"Con",60,0,FALSE,TRUE,FALSE,8.21,"young",38,178,77,"f"
7,"ADDUCTOR",2,"Con04",1660,1640,1850,1800,1650,1825,0.106,-175,1737.5,"Con",20,50,FALSE,FALSE,FALSE,9.59,"young",38,178,77,"f"
7,"ADDUCTOR",2,"Con05",1740,1740,2050,2000,1740,2025,0.164,-285,1882.5,"Con",0,50,FALSE,FALSE,FALSE,14.07,"young",38,178,77,"f"
7,"ADDUCTOR",2,"Con06",1500,1460,1750,1700,1480,1725,0.166,-245,1602.5,"Con",40,50,FALSE,TRUE,FALSE,14.2,"young",38,178,77,"f"
7,"ADDUCTOR",2,"Con07",1440,1480,1350,1450,1460,1400,0.041,60,1430,"Con",-40,-100,FALSE,TRUE,FALSE,4.29,"young",38,178,77,"f"
7,"ADDUCTOR",2,"Con08",1640,1580,1600,1700,1610,1650,0.025,-40,1630,"Con",60,-100,FALSE,TRUE,FALSE,2.42,"young",38,178,77,"f"
7,"ADDUCTOR",2,"Con09",1400,1440,2050,1800,1420,1925,0.356,-505,1672.5,"Con",-40,250,FALSE,TRUE,FALSE,26.23,"young",38,178,77,"f"
7,"ADDUCTOR",2,"Con10",1340,1320,1800,1750,1330,1775,0.335,-445,1552.5,"Con",20,50,FALSE,FALSE,FALSE,25.07,"young",38,178,77,"f"
7,"ADDUCTOR",1,"Ecc01",2440,2420,1800,2750,2430,2275,0.064,155,2352.5,"Ecc",20,-950,FALSE,FALSE,TRUE,6.81,"young",38,178,77,"f"
7,"ADDUCTOR",1,"Ecc02",2620,2620,2150,950,2620,1550,0.408,1070,2085,"Ecc",0,1200,TRUE,FALSE,TRUE,69.03,"young",38,178,77,"f"
7,"ADDUCTOR",1,"Ecc03",3020,3080,1550,300,3050,925,0.697,2125,1987.5,"Ecc",-60,1250,TRUE,TRUE,TRUE,229.73,"young",38,178,77,"f"
7,"ADDUCTOR",1,"Ecc04",3880,3920,3700,3600,3900,3650,0.064,250,3775,"Ecc",-40,100,FALSE,TRUE,FALSE,6.85,"young",38,178,77,"f"
7,"ADDUCTOR",1,"Ecc05",3940,3960,3750,3950,3950,3850,0.025,100,3900,"Ecc",-20,-200,FALSE,FALSE,FALSE,2.6,"young",38,178,77,"f"
7,"ADDUCTOR",1,"Ecc06",3800,3800,3850,3800,3800,3825,0.007,-25,3812.5,"Ecc",0,50,FALSE,FALSE,FALSE,0.65,"young",38,178,77,"f"
7,"ADDUCTOR",1,"Ecc07",3860,3820,3800,3850,3840,3825,0.004,15,3832.5,"Ecc",40,-50,FALSE,TRUE,FALSE,0.39,"young",38,178,77,"f"
7,"ADDUCTOR",1,"Ecc08",3280,3280,2900,3100,3280,3000,0.085,280,3140,"Ecc",0,-200,FALSE,FALSE,FALSE,9.33,"young",38,178,77,"f"
7,"ADDUCTOR",1,"Ecc09",3020,3000,2350,2750,3010,2550,0.153,460,2780,"Ecc",20,-400,FALSE,FALSE,TRUE,18.04,"young",38,178,77,"f"
7,"ADDUCTOR",1,"Ecc10",2440,2440,2250,2250,2440,2250,0.078,190,2345,"Ecc",0,0,FALSE,FALSE,FALSE,8.44,"young",38,178,77,"f"
7,"ADDUCTOR",2,"Ecc01",2420,2400,2800,2600,2410,2700,0.12,-290,2555,"Ecc",20,200,FALSE,FALSE,FALSE,10.74,"young",38,178,77,"f"
7,"ADDUCTOR",2,"Ecc02",2400,2400,2350,2350,2400,2350,0.021,50,2375,"Ecc",0,0,FALSE,FALSE,FALSE,2.13,"young",38,178,77,"f"
7,"ADDUCTOR",2,"Ecc03",2580,2640,2400,2450,2610,2425,0.071,185,2517.5,"Ecc",-60,-50,FALSE,TRUE,FALSE,7.63,"young",38,178,77,"f"
7,"ADDUCTOR",2,"Ecc04",2300,2320,2000,2000,2310,2000,0.134,310,2155,"Ecc",-20,0,FALSE,FALSE,FALSE,15.5,"young",38,178,77,"f"
7,"ADDUCTOR",2,"Ecc05",2180,2180,1950,2050,2180,2000,0.083,180,2090,"Ecc",0,-100,FALSE,FALSE,FALSE,9,"young",38,178,77,"f"
7,"ADDUCTOR",2,"Ecc06",2660,2660,2600,2550,2660,2575,0.032,85,2617.5,"Ecc",0,50,FALSE,FALSE,FALSE,3.3,"young",38,178,77,"f"
7,"ADDUCTOR",2,"Ecc07",2740,2780,2850,2750,2760,2800,0.014,-40,2780,"Ecc",-40,100,FALSE,TRUE,FALSE,1.43,"young",38,178,77,"f"
7,"ADDUCTOR",2,"Ecc08",2820,2800,2550,2600,2810,2575,0.084,235,2692.5,"Ecc",20,-50,FALSE,FALSE,FALSE,9.13,"young",38,178,77,"f"
7,"ADDUCTOR",2,"Ecc09",2780,2780,2100,2350,2780,2225,0.2,555,2502.5,"Ecc",0,-250,TRUE,FALSE,FALSE,24.94,"young",38,178,77,"f"
7,"ADDUCTOR",2,"Ecc10",2160,2160,2050,1250,2160,1650,0.236,510,1905,"Ecc",0,800,FALSE,FALSE,TRUE,30.91,"young",38,178,77,"f"
7,"ADDUCTOR",1,"Rep01",4000,4000,3600,3500,4000,3550,0.112,450,3775,"Rep",0,100,TRUE,FALSE,FALSE,12.68,"young",38,178,77,"f"
7,"ADDUCTOR",1,"Rep02",4240,4280,4150,3200,4260,3675,0.137,585,3967.5,"Rep",-40,950,TRUE,FALSE,TRUE,15.92,"young",38,178,77,"f"
7,"ADDUCTOR",1,"Rep03",4520,4560,3800,3750,4540,3775,0.169,765,4157.5,"Rep",-40,50,TRUE,FALSE,FALSE,20.26,"young",38,178,77,"f"
7,"ADDUCTOR",1,"Rep04",5800,5760,6800,7850,5780,7325,0.267,-1545,6552.5,"Rep",40,-1050,TRUE,FALSE,TRUE,21.09,"young",38,178,77,"f"
7,"ADDUCTOR",1,"Rep05",5880,5880,5850,5850,5880,5850,0.005,30,5865,"Rep",0,0,FALSE,FALSE,FALSE,0.51,"young",38,178,77,"f"
7,"ADDUCTOR",1,"Rep06",5580,5560,5700,5600,5570,5650,0.014,-80,5610,"Rep",20,100,FALSE,FALSE,FALSE,1.42,"young",38,178,77,"f"
7,"ADDUCTOR",1,"Rep07",5540,5520,5450,5450,5530,5450,0.014,80,5490,"Rep",20,0,FALSE,FALSE,FALSE,1.47,"young",38,178,77,"f"
7,"ADDUCTOR",1,"Rep08",4880,4900,4750,4800,4890,4775,0.024,115,4832.5,"Rep",-20,-50,FALSE,FALSE,FALSE,2.41,"young",38,178,77,"f"
7,"ADDUCTOR",1,"Rep09",4680,4660,4500,4650,4670,4575,0.02,95,4622.5,"Rep",20,-150,FALSE,FALSE,FALSE,2.08,"young",38,178,77,"f"
7,"ADDUCTOR",1,"Rep10",4140,4160,4550,4300,4150,4425,0.066,-275,4287.5,"Rep",-20,250,FALSE,FALSE,TRUE,6.21,"young",38,178,77,"f"
7,"ADDUCTOR",2,"Rep01",3760,3740,4200,4000,3750,4100,0.093,-350,3925,"Rep",20,200,FALSE,FALSE,FALSE,8.54,"young",38,178,77,"f"
7,"ADDUCTOR",2,"Rep02",4160,4200,3900,3950,4180,3925,0.061,255,4052.5,"Rep",-40,-50,FALSE,FALSE,FALSE,6.5,"young",38,178,77,"f"
7,"ADDUCTOR",2,"Rep03",4400,4400,4350,4400,4400,4375,0.006,25,4387.5,"Rep",0,-50,FALSE,FALSE,FALSE,0.57,"young",38,178,77,"f"
7,"ADDUCTOR",2,"Rep04",3960,3960,3850,3800,3960,3825,0.034,135,3892.5,"Rep",0,50,FALSE,FALSE,FALSE,3.53,"young",38,178,77,"f"
7,"ADDUCTOR",2,"Rep05",3920,3920,4000,4050,3920,4025,0.027,-105,3972.5,"Rep",0,-50,FALSE,FALSE,FALSE,2.61,"young",38,178,77,"f"
7,"ADDUCTOR",2,"Rep06",4160,4120,4350,4250,4140,4300,0.039,-160,4220,"Rep",40,100,FALSE,FALSE,FALSE,3.72,"young",38,178,77,"f"
7,"ADDUCTOR",2,"Rep07",4180,4260,4200,4200,4220,4200,0.005,20,4210,"Rep",-80,0,FALSE,TRUE,FALSE,0.48,"young",38,178,77,"f"
7,"ADDUCTOR",2,"Rep08",4460,4380,4150,4300,4420,4225,0.044,195,4322.5,"Rep",80,-150,FALSE,TRUE,FALSE,4.62,"young",38,178,77,"f"
7,"ADDUCTOR",2,"Rep09",4180,4220,4150,4150,4200,4150,0.012,50,4175,"Rep",-40,0,FALSE,FALSE,FALSE,1.2,"young",38,178,77,"f"
7,"ADDUCTOR",2,"Rep10",3500,3480,3850,3000,3490,3425,0.019,65,3457.5,"Rep",20,850,FALSE,FALSE,TRUE,1.9,"young",38,178,77,"f"
7,"ADDUCTOR",1,"TuT",49260,49280,49150,48950,49270,49050,0.004,220,49160,"TuT",-20,200,FALSE,FALSE,FALSE,0.45,"young",38,178,77,"f"
7,"ADDUCTOR",2,"TuT",40680,40680,41000,40100,40680,40550,0.003,130,40615,"TuT",0,900,FALSE,FALSE,TRUE,0.32,"young",38,178,77,"f"
7,"LOWER BACK",1,"Con01",2240,2260,2350,2300,2250,2325,0.033,-75,2287.5,"Con",-20,50,FALSE,FALSE,FALSE,3.23,"young",38,178,77,"f"
7,"LOWER BACK",1,"Con02",1940,1940,2050,2000,1940,2025,0.044,-85,1982.5,"Con",0,50,FALSE,FALSE,FALSE,4.2,"young",38,178,77,"f"
7,"LOWER BACK",1,"Con03",2380,2360,2350,2450,2370,2400,0.013,-30,2385,"Con",20,-100,FALSE,FALSE,FALSE,1.25,"young",38,178,77,"f"
7,"LOWER BACK",1,"Con04",2260,2200,2350,2350,2230,2350,0.054,-120,2290,"Con",60,0,FALSE,TRUE,FALSE,5.11,"young",38,178,77,"f"
7,"LOWER BACK",1,"Con05",2300,2320,2300,2350,2310,2325,0.006,-15,2317.5,"Con",-20,-50,FALSE,FALSE,FALSE,0.65,"young",38,178,77,"f"
7,"LOWER BACK",1,"Con06",2320,2320,2300,2350,2320,2325,0.002,-5,2322.5,"Con",0,-50,FALSE,FALSE,FALSE,0.22,"young",38,178,77,"f"
7,"LOWER BACK",1,"Con07",2500,2480,2600,2600,2490,2600,0.044,-110,2545,"Con",20,0,FALSE,FALSE,FALSE,4.23,"young",38,178,77,"f"
7,"LOWER BACK",1,"Con08",2060,2060,2250,2200,2060,2225,0.08,-165,2142.5,"Con",0,50,FALSE,FALSE,FALSE,7.42,"young",38,178,77,"f"
7,"LOWER BACK",1,"Con09",2280,2280,2550,2500,2280,2525,0.107,-245,2402.5,"Con",0,50,TRUE,FALSE,FALSE,9.7,"young",38,178,77,"f"
7,"LOWER BACK",1,"Con10",2160,2100,2350,2500,2130,2425,0.138,-295,2277.5,"Con",60,-150,TRUE,TRUE,FALSE,12.16,"young",38,178,77,"f"
7,"LOWER BACK",2,"Con01",1960,1960,2050,2050,1960,2050,0.046,-90,2005,"Con",0,0,FALSE,FALSE,FALSE,4.39,"young",38,178,77,"f"
7,"LOWER BACK",2,"Con02",2040,2040,2050,2000,2040,2025,0.007,15,2032.5,"Con",0,50,FALSE,FALSE,FALSE,0.74,"young",38,178,77,"f"
7,"LOWER BACK",2,"Con03",2020,1960,2000,2050,1990,2025,0.018,-35,2007.5,"Con",60,-50,FALSE,TRUE,FALSE,1.73,"young",38,178,77,"f"
7,"LOWER BACK",2,"Con04",2080,2020,2100,2050,2050,2075,0.012,-25,2062.5,"Con",60,50,FALSE,TRUE,FALSE,1.2,"young",38,178,77,"f"
7,"LOWER BACK",2,"Con05",2180,2160,2200,2150,2170,2175,0.002,-5,2172.5,"Con",20,50,FALSE,FALSE,FALSE,0.23,"young",38,178,77,"f"
7,"LOWER BACK",2,"Con06",2000,1980,2050,2050,1990,2050,0.03,-60,2020,"Con",20,0,FALSE,FALSE,FALSE,2.93,"young",38,178,77,"f"
7,"LOWER BACK",2,"Con07",1880,1880,1950,2000,1880,1975,0.051,-95,1927.5,"Con",0,-50,FALSE,FALSE,FALSE,4.81,"young",38,178,77,"f"
7,"LOWER BACK",2,"Con08",2040,2020,2150,2200,2030,2175,0.071,-145,2102.5,"Con",20,-50,FALSE,FALSE,FALSE,6.67,"young",38,178,77,"f"
7,"LOWER BACK",2,"Con09",1960,1960,2200,2150,1960,2175,0.11,-215,2067.5,"Con",0,50,TRUE,FALSE,FALSE,9.89,"young",38,178,77,"f"
7,"LOWER BACK",2,"Con10",1800,1760,1950,2050,1780,2000,0.124,-220,1890,"Con",40,-100,TRUE,TRUE,FALSE,11,"young",38,178,77,"f"
7,"LOWER BACK",1,"Ecc01",3040,3000,2950,3000,3020,2975,0.015,45,2997.5,"Ecc",40,-50,FALSE,FALSE,FALSE,1.51,"young",38,178,77,"f"
7,"LOWER BACK",1,"Ecc02",3380,3420,3300,3250,3400,3275,0.037,125,3337.5,"Ecc",-40,50,FALSE,FALSE,FALSE,3.82,"young",38,178,77,"f"
7,"LOWER BACK",1,"Ecc03",3520,3540,3500,3450,3530,3475,0.016,55,3502.5,"Ecc",-20,50,FALSE,FALSE,FALSE,1.58,"young",38,178,77,"f"
7,"LOWER BACK",1,"Ecc04",3520,3540,3500,3500,3530,3500,0.008,30,3515,"Ecc",-20,0,FALSE,FALSE,FALSE,0.86,"young",38,178,77,"f"
7,"LOWER BACK",1,"Ecc05",3580,3560,3600,3500,3570,3550,0.006,20,3560,"Ecc",20,100,FALSE,FALSE,FALSE,0.56,"young",38,178,77,"f"
7,"LOWER BACK",1,"Ecc06",3580,3580,3500,3500,3580,3500,0.022,80,3540,"Ecc",0,0,FALSE,FALSE,FALSE,2.29,"young",38,178,77,"f"
7,"LOWER BACK",1,"Ecc07",3120,3180,3000,3050,3150,3025,0.04,125,3087.5,"Ecc",-60,-50,FALSE,FALSE,FALSE,4.13,"young",38,178,77,"f"
7,"LOWER BACK",1,"Ecc08",3200,3180,2950,3000,3190,2975,0.067,215,3082.5,"Ecc",20,-50,TRUE,FALSE,FALSE,7.23,"young",38,178,77,"f"
7,"LOWER BACK",1,"Ecc09",3120,3160,2950,2900,3140,2925,0.068,215,3032.5,"Ecc",-40,50,TRUE,FALSE,FALSE,7.35,"young",38,178,77,"f"
7,"LOWER BACK",1,"Ecc10",3300,3320,3200,3100,3310,3150,0.048,160,3230,"Ecc",-20,100,FALSE,FALSE,FALSE,5.08,"young",38,178,77,"f"
7,"LOWER BACK",2,"Ecc01",2740,2740,2700,2750,2740,2725,0.005,15,2732.5,"Ecc",0,-50,FALSE,FALSE,FALSE,0.55,"young",38,178,77,"f"
7,"LOWER BACK",2,"Ecc02",2700,2740,2700,2700,2720,2700,0.007,20,2710,"Ecc",-40,0,FALSE,FALSE,FALSE,0.74,"young",38,178,77,"f"
7,"LOWER BACK",2,"Ecc03",2820,2880,2800,2800,2850,2800,0.018,50,2825,"Ecc",-60,0,FALSE,FALSE,FALSE,1.79,"young",38,178,77,"f"
7,"LOWER BACK",2,"Ecc04",2840,2860,2800,2850,2850,2825,0.009,25,2837.5,"Ecc",-20,-50,FALSE,FALSE,FALSE,0.88,"young",38,178,77,"f"
7,"LOWER BACK",2,"Ecc05",2400,2440,2400,2400,2420,2400,0.008,20,2410,"Ecc",-40,0,FALSE,FALSE,FALSE,0.83,"young",38,178,77,"f"
7,"LOWER BACK",2,"Ecc06",2720,2720,2650,2650,2720,2650,0.026,70,2685,"Ecc",0,0,FALSE,FALSE,FALSE,2.64,"young",38,178,77,"f"
7,"LOWER BACK",2,"Ecc07",2980,3000,2900,2850,2990,2875,0.038,115,2932.5,"Ecc",-20,50,FALSE,FALSE,FALSE,4,"young",38,178,77,"f"
7,"LOWER BACK",2,"Ecc08",3000,3000,2750,2750,3000,2750,0.083,250,2875,"Ecc",0,0,TRUE,FALSE,FALSE,9.09,"young",38,178,77,"f"
7,"LOWER BACK",2,"Ecc09",2680,2720,2550,2500,2700,2525,0.065,175,2612.5,"Ecc",-40,50,TRUE,FALSE,FALSE,6.93,"young",38,178,77,"f"
7,"LOWER BACK",2,"Ecc10",4220,4220,2300,2250,4220,2275,0.461,1945,3247.5,"Ecc",0,50,TRUE,FALSE,FALSE,85.49,"young",38,178,77,"f"
7,"LOWER BACK",1,"Rep01",5280,5260,5300,5300,5270,5300,0.006,-30,5285,"Rep",20,0,FALSE,FALSE,FALSE,0.57,"young",38,178,77,"f"
7,"LOWER BACK",1,"Rep02",5320,5360,5350,5250,5340,5300,0.007,40,5320,"Rep",-40,100,FALSE,FALSE,FALSE,0.75,"young",38,178,77,"f"
7,"LOWER BACK",1,"Rep03",5900,5900,5850,5900,5900,5875,0.004,25,5887.5,"Rep",0,-50,FALSE,FALSE,FALSE,0.43,"young",38,178,77,"f"
7,"LOWER BACK",1,"Rep04",5780,5740,5850,5850,5760,5850,0.016,-90,5805,"Rep",40,0,FALSE,FALSE,FALSE,1.54,"young",38,178,77,"f"
7,"LOWER BACK",1,"Rep05",5880,5880,5900,5850,5880,5875,0.001,5,5877.5,"Rep",0,50,FALSE,FALSE,FALSE,0.09,"young",38,178,77,"f"
7,"LOWER BACK",1,"Rep06",5900,5900,5800,5850,5900,5825,0.013,75,5862.5,"Rep",0,-50,FALSE,FALSE,FALSE,1.29,"young",38,178,77,"f"
7,"LOWER BACK",1,"Rep07",5620,5660,5600,5650,5640,5625,0.003,15,5632.5,"Rep",-40,-50,FALSE,FALSE,FALSE,0.27,"young",38,178,77,"f"
7,"LOWER BACK",1,"Rep08",5260,5240,5200,5200,5250,5200,0.01,50,5225,"Rep",20,0,FALSE,FALSE,FALSE,0.96,"young",38,178,77,"f"
7,"LOWER BACK",1,"Rep09",5400,5440,5500,5400,5420,5450,0.006,-30,5435,"Rep",-40,100,FALSE,FALSE,FALSE,0.55,"young",38,178,77,"f"
7,"LOWER BACK",1,"Rep10",5460,5420,5550,5600,5440,5575,0.025,-135,5507.5,"Rep",40,-50,TRUE,FALSE,FALSE,2.42,"young",38,178,77,"f"
7,"LOWER BACK",2,"Rep01",4700,4700,4750,4800,4700,4775,0.016,-75,4737.5,"Rep",0,-50,FALSE,FALSE,FALSE,1.57,"young",38,178,77,"f"
7,"LOWER BACK",2,"Rep02",4740,4780,4750,4700,4760,4725,0.007,35,4742.5,"Rep",-40,50,FALSE,FALSE,FALSE,0.74,"young",38,178,77,"f"
7,"LOWER BACK",2,"Rep03",4840,4840,4800,4850,4840,4825,0.003,15,4832.5,"Rep",0,-50,FALSE,FALSE,FALSE,0.31,"young",38,178,77,"f"
7,"LOWER BACK",2,"Rep04",4920,4880,4900,4900,4900,4900,0,0,4900,"Rep",40,0,FALSE,FALSE,FALSE,0,"young",38,178,77,"f"
7,"LOWER BACK",2,"Rep05",4580,4600,4600,4550,4590,4575,0.003,15,4582.5,"Rep",-20,50,FALSE,FALSE,FALSE,0.33,"young",38,178,77,"f"
7,"LOWER BACK",2,"Rep06",4720,4700,4700,4700,4710,4700,0.002,10,4705,"Rep",20,0,FALSE,FALSE,FALSE,0.21,"young",38,178,77,"f"
7,"LOWER BACK",2,"Rep07",4860,4880,4850,4850,4870,4850,0.004,20,4860,"Rep",-20,0,FALSE,FALSE,FALSE,0.41,"young",38,178,77,"f"
7,"LOWER BACK",2,"Rep08",5040,5020,4900,4950,5030,4925,0.021,105,4977.5,"Rep",20,-50,TRUE,FALSE,FALSE,2.13,"young",38,178,77,"f"
7,"LOWER BACK",2,"Rep09",4640,4680,4750,4650,4660,4700,0.009,-40,4680,"Rep",-40,100,FALSE,FALSE,FALSE,0.85,"young",38,178,77,"f"
7,"LOWER BACK",2,"Rep10",6020,5980,4250,4300,6000,4275,0.288,1725,5137.5,"Rep",40,-50,TRUE,FALSE,FALSE,40.35,"young",38,178,77,"f"
7,"LOWER BACK",1,"TuT",55800,55800,55900,55850,55800,55875,0.001,-75,55837.5,"TuT",0,50,FALSE,FALSE,FALSE,0.13,"young",38,178,77,"f"
7,"LOWER BACK",2,"TuT",49060,49060,47250,47250,49060,47250,0.037,1810,48155,"TuT",0,0,TRUE,FALSE,FALSE,3.83,"young",38,178,77,"f"
7,"TOTAL ABDOMINAL",1,"Con01",1420,1400,1800,1400,1410,1600,0.135,-190,1505,"Con",20,400,TRUE,FALSE,TRUE,11.88,"young",38,178,77,"f"
7,"TOTAL ABDOMINAL",1,"Con02",1560,1560,1550,1700,1560,1625,0.042,-65,1592.5,"Con",0,-150,FALSE,FALSE,FALSE,4,"young",38,178,77,"f"
7,"TOTAL ABDOMINAL",1,"Con03",1480,1480,1350,1600,1480,1475,0.003,5,1477.5,"Con",0,-250,FALSE,FALSE,TRUE,0.34,"young",38,178,77,"f"
7,"TOTAL ABDOMINAL",1,"Con04",1620,1640,1650,1750,1630,1700,0.043,-70,1665,"Con",-20,-100,FALSE,FALSE,FALSE,4.12,"young",38,178,77,"f"
7,"TOTAL ABDOMINAL",1,"Con05",1660,1640,1850,1600,1650,1725,0.045,-75,1687.5,"Con",20,250,FALSE,FALSE,TRUE,4.35,"young",38,178,77,"f"
7,"TOTAL ABDOMINAL",1,"Con06",1700,1700,1800,1600,1700,1700,0,0,1700,"Con",0,200,FALSE,FALSE,TRUE,0,"young",38,178,77,"f"
7,"TOTAL ABDOMINAL",1,"Con07",1900,1860,2000,1850,1880,1925,0.024,-45,1902.5,"Con",40,150,FALSE,TRUE,FALSE,2.34,"young",38,178,77,"f"
7,"TOTAL ABDOMINAL",1,"Con08",1820,1800,2050,1950,1810,2000,0.105,-190,1905,"Con",20,100,TRUE,FALSE,FALSE,9.5,"young",38,178,77,"f"
7,"TOTAL ABDOMINAL",1,"Con09",1720,1700,2200,1950,1710,2075,0.213,-365,1892.5,"Con",20,250,TRUE,FALSE,TRUE,17.59,"young",38,178,77,"f"
7,"TOTAL ABDOMINAL",1,"Con10",1600,1580,1900,1900,1590,1900,0.195,-310,1745,"Con",20,0,TRUE,FALSE,FALSE,16.32,"young",38,178,77,"f"
7,"TOTAL ABDOMINAL",2,"Con01",1300,1320,1450,1350,1310,1400,0.069,-90,1355,"Con",-20,100,FALSE,FALSE,FALSE,6.43,"young",38,178,77,"f"
7,"TOTAL ABDOMINAL",2,"Con02",1320,1340,1350,1400,1330,1375,0.034,-45,1352.5,"Con",-20,-50,FALSE,FALSE,FALSE,3.27,"young",38,178,77,"f"
7,"TOTAL ABDOMINAL",2,"Con03",1360,1380,1450,1450,1370,1450,0.058,-80,1410,"Con",-20,0,FALSE,FALSE,FALSE,5.52,"young",38,178,77,"f"
7,"TOTAL ABDOMINAL",2,"Con04",1660,1680,1750,1700,1670,1725,0.033,-55,1697.5,"Con",-20,50,FALSE,FALSE,FALSE,3.19,"young",38,178,77,"f"
7,"TOTAL ABDOMINAL",2,"Con05",1840,1860,2000,2000,1850,2000,0.081,-150,1925,"Con",-20,0,TRUE,FALSE,FALSE,7.5,"young",38,178,77,"f"
7,"TOTAL ABDOMINAL",2,"Con06",1800,1800,1850,1850,1800,1850,0.028,-50,1825,"Con",0,0,FALSE,FALSE,FALSE,2.7,"young",38,178,77,"f"
7,"TOTAL ABDOMINAL",2,"Con07",1840,1840,1850,1850,1840,1850,0.005,-10,1845,"Con",0,0,FALSE,FALSE,FALSE,0.54,"young",38,178,77,"f"
7,"TOTAL ABDOMINAL",2,"Con08",1660,1640,1700,1700,1650,1700,0.03,-50,1675,"Con",20,0,FALSE,FALSE,FALSE,2.94,"young",38,178,77,"f"
7,"TOTAL ABDOMINAL",2,"Con09",1720,1760,1800,1800,1740,1800,0.034,-60,1770,"Con",-40,0,FALSE,TRUE,FALSE,3.33,"young",38,178,77,"f"
7,"TOTAL ABDOMINAL",2,"Con10",1660,1680,1800,1950,1670,1875,0.123,-205,1772.5,"Con",-20,-150,TRUE,FALSE,FALSE,10.93,"young",38,178,77,"f"
7,"TOTAL ABDOMINAL",1,"Ecc01",2940,2960,2900,2850,2950,2875,0.025,75,2912.5,"Ecc",-20,50,FALSE,FALSE,FALSE,2.61,"young",38,178,77,"f"
7,"TOTAL ABDOMINAL",1,"Ecc02",3320,3300,3400,3200,3310,3300,0.003,10,3305,"Ecc",20,200,FALSE,FALSE,TRUE,0.3,"young",38,178,77,"f"
7,"TOTAL ABDOMINAL",1,"Ecc03",3220,3240,3300,3050,3230,3175,0.017,55,3202.5,"Ecc",-20,250,FALSE,FALSE,TRUE,1.73,"young",38,178,77,"f"
7,"TOTAL ABDOMINAL",1,"Ecc04",3100,3100,2950,3100,3100,3025,0.024,75,3062.5,"Ecc",0,-150,FALSE,FALSE,FALSE,2.48,"young",38,178,77,"f"
7,"TOTAL ABDOMINAL",1,"Ecc05",2900,2900,2750,3000,2900,2875,0.009,25,2887.5,"Ecc",0,-250,FALSE,FALSE,TRUE,0.87,"young",38,178,77,"f"
7,"TOTAL ABDOMINAL",1,"Ecc06",2660,2680,2550,2750,2670,2650,0.007,20,2660,"Ecc",-20,-200,FALSE,FALSE,TRUE,0.75,"young",38,178,77,"f"
7,"TOTAL ABDOMINAL",1,"Ecc07",2620,2660,2550,2600,2640,2575,0.025,65,2607.5,"Ecc",-40,-50,FALSE,TRUE,FALSE,2.52,"young",38,178,77,"f"
7,"TOTAL ABDOMINAL",1,"Ecc08",2920,2920,2350,2650,2920,2500,0.144,420,2710,"Ecc",0,-300,TRUE,FALSE,TRUE,16.8,"young",38,178,77,"f"
7,"TOTAL ABDOMINAL",1,"Ecc09",2620,2660,2300,2300,2640,2300,0.129,340,2470,"Ecc",-40,0,TRUE,TRUE,FALSE,14.78,"young",38,178,77,"f"
7,"TOTAL ABDOMINAL",1,"Ecc10",2560,2560,2450,2500,2560,2475,0.033,85,2517.5,"Ecc",0,-50,FALSE,FALSE,FALSE,3.43,"young",38,178,77,"f"
7,"TOTAL ABDOMINAL",2,"Ecc01",2420,2400,2350,2300,2410,2325,0.035,85,2367.5,"Ecc",20,50,FALSE,FALSE,FALSE,3.66,"young",38,178,77,"f"
7,"TOTAL ABDOMINAL",2,"Ecc02",1940,1920,1900,1900,1930,1900,0.016,30,1915,"Ecc",20,0,FALSE,FALSE,FALSE,1.58,"young",38,178,77,"f"
7,"TOTAL ABDOMINAL",2,"Ecc03",2140,2120,2050,2100,2130,2075,0.026,55,2102.5,"Ecc",20,-50,FALSE,FALSE,FALSE,2.65,"young",38,178,77,"f"
7,"TOTAL ABDOMINAL",2,"Ecc04",1980,1960,1800,1800,1970,1800,0.086,170,1885,"Ecc",20,0,TRUE,FALSE,FALSE,9.44,"young",38,178,77,"f"
7,"TOTAL ABDOMINAL",2,"Ecc05",2200,2200,2150,2150,2200,2150,0.023,50,2175,"Ecc",0,0,FALSE,FALSE,FALSE,2.33,"young",38,178,77,"f"
7,"TOTAL ABDOMINAL",2,"Ecc06",2440,2440,2450,2450,2440,2450,0.004,-10,2445,"Ecc",0,0,FALSE,FALSE,FALSE,0.41,"young",38,178,77,"f"
7,"TOTAL ABDOMINAL",2,"Ecc07",2560,2560,2500,2500,2560,2500,0.023,60,2530,"Ecc",0,0,FALSE,FALSE,FALSE,2.4,"young",38,178,77,"f"
7,"TOTAL ABDOMINAL",2,"Ecc08",2260,2280,2200,2200,2270,2200,0.031,70,2235,"Ecc",-20,0,FALSE,FALSE,FALSE,3.18,"young",38,178,77,"f"
7,"TOTAL ABDOMINAL",2,"Ecc09",2180,2120,2050,2000,2150,2025,0.058,125,2087.5,"Ecc",60,50,FALSE,TRUE,FALSE,6.17,"young",38,178,77,"f"
7,"TOTAL ABDOMINAL",2,"Ecc10",2040,2040,2050,1900,2040,1975,0.032,65,2007.5,"Ecc",0,150,FALSE,FALSE,FALSE,3.29,"young",38,178,77,"f"
7,"TOTAL ABDOMINAL",1,"Rep01",4360,4360,4700,4250,4360,4475,0.026,-115,4417.5,"Rep",0,450,FALSE,FALSE,TRUE,2.57,"young",38,178,77,"f"
7,"TOTAL ABDOMINAL",1,"Rep02",4880,4860,4950,4900,4870,4925,0.011,-55,4897.5,"Rep",20,50,FALSE,FALSE,FALSE,1.12,"young",38,178,77,"f"
7,"TOTAL ABDOMINAL",1,"Rep03",4700,4720,4650,4650,4710,4650,0.013,60,4680,"Rep",-20,0,FALSE,FALSE,FALSE,1.29,"young",38,178,77,"f"
7,"TOTAL ABDOMINAL",1,"Rep04",4720,4740,4600,4850,4730,4725,0.001,5,4727.5,"Rep",-20,-250,FALSE,FALSE,TRUE,0.11,"young",38,178,77,"f"
7,"TOTAL ABDOMINAL",1,"Rep05",4560,4540,4600,4600,4550,4600,0.011,-50,4575,"Rep",20,0,FALSE,FALSE,FALSE,1.09,"young",38,178,77,"f"
7,"TOTAL ABDOMINAL",1,"Rep06",4360,4380,4350,4350,4370,4350,0.005,20,4360,"Rep",-20,0,FALSE,FALSE,FALSE,0.46,"young",38,178,77,"f"
7,"TOTAL ABDOMINAL",1,"Rep07",4520,4520,4550,4450,4520,4500,0.004,20,4510,"Rep",0,100,FALSE,FALSE,FALSE,0.44,"young",38,178,77,"f"
7,"TOTAL ABDOMINAL",1,"Rep08",4740,4720,4400,4600,4730,4500,0.049,230,4615,"Rep",20,-200,TRUE,FALSE,TRUE,5.11,"young",38,178,77,"f"
7,"TOTAL ABDOMINAL",1,"Rep09",4340,4360,4500,4250,4350,4375,0.006,-25,4362.5,"Rep",-20,250,FALSE,FALSE,TRUE,0.57,"young",38,178,77,"f"
7,"TOTAL ABDOMINAL",1,"Rep10",4160,4140,4350,4400,4150,4375,0.054,-225,4262.5,"Rep",20,-50,TRUE,FALSE,FALSE,5.14,"young",38,178,77,"f"
7,"TOTAL ABDOMINAL",2,"Rep01",3720,3720,3800,3650,3720,3725,0.001,-5,3722.5,"Rep",0,150,FALSE,FALSE,FALSE,0.13,"young",38,178,77,"f"
7,"TOTAL ABDOMINAL",2,"Rep02",3260,3260,3250,3300,3260,3275,0.005,-15,3267.5,"Rep",0,-50,FALSE,FALSE,FALSE,0.46,"young",38,178,77,"f"
7,"TOTAL ABDOMINAL",2,"Rep03",3500,3500,3500,3550,3500,3525,0.007,-25,3512.5,"Rep",0,-50,FALSE,FALSE,FALSE,0.71,"young",38,178,77,"f"
7,"TOTAL ABDOMINAL",2,"Rep04",3640,3640,3550,3500,3640,3525,0.032,115,3582.5,"Rep",0,50,FALSE,FALSE,FALSE,3.26,"young",38,178,77,"f"
7,"TOTAL ABDOMINAL",2,"Rep05",4040,4060,4150,4150,4050,4150,0.025,-100,4100,"Rep",-20,0,FALSE,FALSE,FALSE,2.41,"young",38,178,77,"f"
7,"TOTAL ABDOMINAL",2,"Rep06",4240,4240,4300,4300,4240,4300,0.014,-60,4270,"Rep",0,0,FALSE,FALSE,FALSE,1.4,"young",38,178,77,"f"
7,"TOTAL ABDOMINAL",2,"Rep07",4400,4400,4350,4350,4400,4350,0.011,50,4375,"Rep",0,0,FALSE,FALSE,FALSE,1.15,"young",38,178,77,"f"
7,"TOTAL ABDOMINAL",2,"Rep08",3920,3920,3900,3900,3920,3900,0.005,20,3910,"Rep",0,0,FALSE,FALSE,FALSE,0.51,"young",38,178,77,"f"
7,"TOTAL ABDOMINAL",2,"Rep09",3900,3880,3850,3800,3890,3825,0.017,65,3857.5,"Rep",20,50,FALSE,FALSE,FALSE,1.7,"young",38,178,77,"f"
7,"TOTAL ABDOMINAL",2,"Rep10",3700,3720,3850,3850,3710,3850,0.038,-140,3780,"Rep",-20,0,TRUE,FALSE,FALSE,3.64,"young",38,178,77,"f"
7,"TOTAL ABDOMINAL",1,"TuT",45340,45340,45650,45300,45340,45475,0.003,-135,45407.5,"TuT",0,350,FALSE,FALSE,TRUE,0.3,"young",38,178,77,"f"
7,"TOTAL ABDOMINAL",2,"TuT",38320,38340,38500,38350,38330,38425,0.002,-95,38377.5,"TuT",-20,150,FALSE,FALSE,FALSE,0.25,"young",38,178,77,"f"
7,"VERTICAL TRACTION",1,"Con01",2240,2220,6300,3150,2230,4725,1.119,-2495,3477.5,"Con",20,3150,TRUE,FALSE,TRUE,52.8,"young",38,178,77,"f"
7,"VERTICAL TRACTION",1,"Con02",2060,2020,2400,2100,2040,2250,0.103,-210,2145,"Con",40,300,FALSE,FALSE,TRUE,9.33,"young",38,178,77,"f"
7,"VERTICAL TRACTION",1,"Con03",1940,1920,2150,1850,1930,2000,0.036,-70,1965,"Con",20,300,FALSE,FALSE,TRUE,3.5,"young",38,178,77,"f"
7,"VERTICAL TRACTION",1,"Con04",1980,1960,2050,1900,1970,1975,0.003,-5,1972.5,"Con",20,150,FALSE,FALSE,FALSE,0.25,"young",38,178,77,"f"
7,"VERTICAL TRACTION",1,"Con05",1920,1900,2050,2000,1910,2025,0.06,-115,1967.5,"Con",20,50,FALSE,FALSE,FALSE,5.68,"young",38,178,77,"f"
7,"VERTICAL TRACTION",1,"Con06",2020,2000,2250,2150,2010,2200,0.095,-190,2105,"Con",20,100,FALSE,FALSE,FALSE,8.64,"young",38,178,77,"f"
7,"VERTICAL TRACTION",1,"Con07",1980,1940,2150,2100,1960,2125,0.084,-165,2042.5,"Con",40,50,FALSE,FALSE,FALSE,7.76,"young",38,178,77,"f"
7,"VERTICAL TRACTION",1,"Con08",2040,2000,2000,2100,2020,2050,0.015,-30,2035,"Con",40,-100,FALSE,FALSE,FALSE,1.46,"young",38,178,77,"f"
7,"VERTICAL TRACTION",1,"Con09",2000,1960,2150,2600,1980,2375,0.199,-395,2177.5,"Con",40,-450,TRUE,FALSE,TRUE,16.63,"young",38,178,77,"f"
7,"VERTICAL TRACTION",1,"Con10",1980,1960,2100,2950,1970,2525,0.282,-555,2247.5,"Con",20,-850,TRUE,FALSE,TRUE,21.98,"young",38,178,77,"f"
7,"VERTICAL TRACTION",2,"Con01",2300,2260,4100,2650,2280,3375,0.48,-1095,2827.5,"Con",40,1450,TRUE,FALSE,TRUE,32.44,"young",38,178,77,"f"
7,"VERTICAL TRACTION",2,"Con02",2020,2040,2200,2500,2030,2350,0.158,-320,2190,"Con",-20,-300,TRUE,FALSE,TRUE,13.62,"young",38,178,77,"f"
7,"VERTICAL TRACTION",2,"Con03",2520,2480,2600,2600,2500,2600,0.04,-100,2550,"Con",40,0,FALSE,FALSE,FALSE,3.85,"young",38,178,77,"f"
7,"VERTICAL TRACTION",2,"Con04",2020,2000,2350,2250,2010,2300,0.144,-290,2155,"Con",20,100,TRUE,FALSE,FALSE,12.61,"young",38,178,77,"f"
7,"VERTICAL TRACTION",2,"Con05",2140,2080,2550,2400,2110,2475,0.173,-365,2292.5,"Con",60,150,TRUE,FALSE,FALSE,14.75,"young",38,178,77,"f"
7,"VERTICAL TRACTION",2,"Con06",2080,2080,2300,2250,2080,2275,0.094,-195,2177.5,"Con",0,50,FALSE,FALSE,FALSE,8.57,"young",38,178,77,"f"
7,"VERTICAL TRACTION",2,"Con07",2120,2080,2300,2250,2100,2275,0.083,-175,2187.5,"Con",40,50,FALSE,FALSE,FALSE,7.69,"young",38,178,77,"f"
7,"VERTICAL TRACTION",2,"Con08",2040,2000,2050,2050,2020,2050,0.015,-30,2035,"Con",40,0,FALSE,FALSE,FALSE,1.46,"young",38,178,77,"f"
7,"VERTICAL TRACTION",2,"Con09",2340,2320,2100,2300,2330,2200,0.056,130,2265,"Con",20,-200,FALSE,FALSE,TRUE,5.91,"young",38,178,77,"f"
7,"VERTICAL TRACTION",2,"Con10",2220,2220,2100,2200,2220,2150,0.032,70,2185,"Con",0,-100,FALSE,FALSE,FALSE,3.26,"young",38,178,77,"f"
7,"VERTICAL TRACTION",1,"Ecc01",2840,2900,2500,2800,2870,2650,0.077,220,2760,"Ecc",-60,-300,FALSE,FALSE,TRUE,8.3,"young",38,178,77,"f"
7,"VERTICAL TRACTION",1,"Ecc02",2820,2780,2550,2850,2800,2700,0.036,100,2750,"Ecc",40,-300,FALSE,FALSE,TRUE,3.7,"young",38,178,77,"f"
7,"VERTICAL TRACTION",1,"Ecc03",2980,3040,2950,3100,3010,3025,0.005,-15,3017.5,"Ecc",-60,-150,FALSE,FALSE,FALSE,0.5,"young",38,178,77,"f"
7,"VERTICAL TRACTION",1,"Ecc04",2940,2960,2800,2900,2950,2850,0.034,100,2900,"Ecc",-20,-100,FALSE,FALSE,FALSE,3.51,"young",38,178,77,"f"
7,"VERTICAL TRACTION",1,"Ecc05",3080,3100,2850,2950,3090,2900,0.061,190,2995,"Ecc",-20,-100,FALSE,FALSE,FALSE,6.55,"young",38,178,77,"f"
7,"VERTICAL TRACTION",1,"Ecc06",3040,3080,2900,2950,3060,2925,0.044,135,2992.5,"Ecc",-40,-50,FALSE,FALSE,FALSE,4.62,"young",38,178,77,"f"
7,"VERTICAL TRACTION",1,"Ecc07",3160,3200,3050,3050,3180,3050,0.041,130,3115,"Ecc",-40,0,FALSE,FALSE,FALSE,4.26,"young",38,178,77,"f"
7,"VERTICAL TRACTION",1,"Ecc08",3240,3260,3200,2800,3250,3000,0.077,250,3125,"Ecc",-20,400,FALSE,FALSE,TRUE,8.33,"young",38,178,77,"f"
7,"VERTICAL TRACTION",1,"Ecc09",3660,3700,3550,2900,3680,3225,0.124,455,3452.5,"Ecc",-40,650,TRUE,FALSE,TRUE,14.11,"young",38,178,77,"f"
7,"VERTICAL TRACTION",1,"Ecc10",3200,3200,3200,2800,3200,3000,0.062,200,3100,"Ecc",0,400,FALSE,FALSE,TRUE,6.67,"young",38,178,77,"f"
7,"VERTICAL TRACTION",2,"Ecc01",3000,3000,2850,2700,3000,2775,0.075,225,2887.5,"Ecc",0,150,FALSE,FALSE,FALSE,8.11,"young",38,178,77,"f"
7,"VERTICAL TRACTION",2,"Ecc02",3380,3440,3150,2950,3410,3050,0.106,360,3230,"Ecc",-60,200,TRUE,FALSE,TRUE,11.8,"young",38,178,77,"f"
7,"VERTICAL TRACTION",2,"Ecc03",3140,3120,2950,3050,3130,3000,0.042,130,3065,"Ecc",20,-100,FALSE,FALSE,FALSE,4.33,"young",38,178,77,"f"
7,"VERTICAL TRACTION",2,"Ecc04",3640,3700,3250,3400,3670,3325,0.094,345,3497.5,"Ecc",-60,-150,TRUE,FALSE,FALSE,10.38,"young",38,178,77,"f"
7,"VERTICAL TRACTION",2,"Ecc05",3520,3540,3300,3300,3530,3300,0.065,230,3415,"Ecc",-20,0,FALSE,FALSE,FALSE,6.97,"young",38,178,77,"f"
7,"VERTICAL TRACTION",2,"Ecc06",3580,3620,3350,3450,3600,3400,0.056,200,3500,"Ecc",-40,-100,FALSE,FALSE,FALSE,5.88,"young",38,178,77,"f"
7,"VERTICAL TRACTION",2,"Ecc07",3720,3760,3650,3650,3740,3650,0.024,90,3695,"Ecc",-40,0,FALSE,FALSE,FALSE,2.47,"young",38,178,77,"f"
7,"VERTICAL TRACTION",2,"Ecc08",3180,3180,3300,3200,3180,3250,0.022,-70,3215,"Ecc",0,100,FALSE,FALSE,FALSE,2.15,"young",38,178,77,"f"
7,"VERTICAL TRACTION",2,"Ecc09",3180,3180,3350,3200,3180,3275,0.03,-95,3227.5,"Ecc",0,150,FALSE,FALSE,FALSE,2.9,"young",38,178,77,"f"
7,"VERTICAL TRACTION",2,"Ecc10",3740,3780,3900,4850,3760,4375,0.164,-615,4067.5,"Ecc",-40,-950,TRUE,FALSE,TRUE,14.06,"young",38,178,77,"f"
7,"VERTICAL TRACTION",1,"Rep01",5080,5120,8800,5950,5100,7375,0.446,-2275,6237.5,"Rep",-40,2850,TRUE,FALSE,TRUE,30.85,"young",38,178,77,"f"
7,"VERTICAL TRACTION",1,"Rep02",4880,4800,4950,4950,4840,4950,0.023,-110,4895,"Rep",80,0,FALSE,TRUE,FALSE,2.22,"young",38,178,77,"f"
7,"VERTICAL TRACTION",1,"Rep03",4920,4960,5100,4950,4940,5025,0.017,-85,4982.5,"Rep",-40,150,FALSE,FALSE,FALSE,1.69,"young",38,178,77,"f"
7,"VERTICAL TRACTION",1,"Rep04",4920,4920,4850,4800,4920,4825,0.019,95,4872.5,"Rep",0,50,FALSE,FALSE,FALSE,1.97,"young",38,178,77,"f"
7,"VERTICAL TRACTION",1,"Rep05",5000,5000,4900,4950,5000,4925,0.015,75,4962.5,"Rep",0,-50,FALSE,FALSE,FALSE,1.52,"young",38,178,77,"f"
7,"VERTICAL TRACTION",1,"Rep06",5060,5080,5150,5100,5070,5125,0.011,-55,5097.5,"Rep",-20,50,FALSE,FALSE,FALSE,1.07,"young",38,178,77,"f"
7,"VERTICAL TRACTION",1,"Rep07",5140,5140,5200,5150,5140,5175,0.007,-35,5157.5,"Rep",0,50,FALSE,FALSE,FALSE,0.68,"young",38,178,77,"f"
7,"VERTICAL TRACTION",1,"Rep08",5280,5260,5200,4900,5270,5050,0.042,220,5160,"Rep",20,300,TRUE,FALSE,TRUE,4.36,"young",38,178,77,"f"
7,"VERTICAL TRACTION",1,"Rep09",5660,5660,5700,5500,5660,5600,0.011,60,5630,"Rep",0,200,FALSE,FALSE,TRUE,1.07,"young",38,178,77,"f"
7,"VERTICAL TRACTION",1,"Rep10",5180,5160,5300,5750,5170,5525,0.069,-355,5347.5,"Rep",20,-450,TRUE,FALSE,TRUE,6.43,"young",38,178,77,"f"
7,"VERTICAL TRACTION",2,"Rep01",5300,5260,6950,5350,5280,6150,0.165,-870,5715,"Rep",40,1600,TRUE,FALSE,TRUE,14.15,"young",38,178,77,"f"
7,"VERTICAL TRACTION",2,"Rep02",5400,5480,5350,5450,5440,5400,0.007,40,5420,"Rep",-80,-100,FALSE,TRUE,FALSE,0.74,"young",38,178,77,"f"
7,"VERTICAL TRACTION",2,"Rep03",5660,5600,5550,5650,5630,5600,0.005,30,5615,"Rep",60,-100,FALSE,FALSE,FALSE,0.54,"young",38,178,77,"f"
7,"VERTICAL TRACTION",2,"Rep04",5660,5700,5600,5650,5680,5625,0.01,55,5652.5,"Rep",-40,-50,FALSE,FALSE,FALSE,0.98,"young",38,178,77,"f"
7,"VERTICAL TRACTION",2,"Rep05",5660,5620,5850,5700,5640,5775,0.024,-135,5707.5,"Rep",40,150,FALSE,FALSE,FALSE,2.34,"young",38,178,77,"f"
7,"VERTICAL TRACTION",2,"Rep06",5660,5700,5650,5700,5680,5675,0.001,5,5677.5,"Rep",-40,-50,FALSE,FALSE,FALSE,0.09,"young",38,178,77,"f"
7,"VERTICAL TRACTION",2,"Rep07",5840,5840,5950,5900,5840,5925,0.015,-85,5882.5,"Rep",0,50,FALSE,FALSE,FALSE,1.43,"young",38,178,77,"f"
7,"VERTICAL TRACTION",2,"Rep08",5220,5180,5350,5250,5200,5300,0.019,-100,5250,"Rep",40,100,FALSE,FALSE,FALSE,1.89,"young",38,178,77,"f"
7,"VERTICAL TRACTION",2,"Rep09",5520,5500,5450,5500,5510,5475,0.006,35,5492.5,"Rep",20,-50,FALSE,FALSE,FALSE,0.64,"young",38,178,77,"f"
7,"VERTICAL TRACTION",2,"Rep10",5960,6000,6000,7050,5980,6525,0.091,-545,6252.5,"Rep",-40,-1050,TRUE,FALSE,TRUE,8.35,"young",38,178,77,"f"
7,"VERTICAL TRACTION",1,"TuT",51120,51100,55150,52000,51110,53575,0.048,-2465,52342.5,"TuT",20,3150,TRUE,FALSE,TRUE,4.6,"young",38,178,77,"f"
7,"VERTICAL TRACTION",2,"TuT",55880,55880,57700,57200,55880,57450,0.028,-1570,56665,"TuT",0,500,FALSE,FALSE,FALSE,2.73,"young",38,178,77,"f"
7,"CHEST PRESS",1,"Con01",2560,2600,2250,2500,2580,2375,0.079,205,2477.5,"Con",-40,-250,FALSE,TRUE,FALSE,8.63,"young",38,178,77,"f"
7,"CHEST PRESS",1,"Con02",2320,2280,2300,2400,2300,2350,0.022,-50,2325,"Con",40,-100,FALSE,TRUE,FALSE,2.13,"young",38,178,77,"f"
7,"CHEST PRESS",1,"Con03",1780,1800,1650,2000,1790,1825,0.02,-35,1807.5,"Con",-20,-350,FALSE,FALSE,TRUE,1.92,"young",38,178,77,"f"
7,"CHEST PRESS",1,"Con04",2160,2180,2250,2300,2170,2275,0.048,-105,2222.5,"Con",-20,-50,FALSE,FALSE,FALSE,4.62,"young",38,178,77,"f"
7,"CHEST PRESS",1,"Con05",1980,2000,2400,2150,1990,2275,0.143,-285,2132.5,"Con",-20,250,FALSE,FALSE,FALSE,12.53,"young",38,178,77,"f"
7,"CHEST PRESS",1,"Con06",2360,2340,2750,2250,2350,2500,0.064,-150,2425,"Con",20,500,FALSE,FALSE,TRUE,6,"young",38,178,77,"f"
7,"CHEST PRESS",1,"Con07",1860,1860,2150,2200,1860,2175,0.169,-315,2017.5,"Con",0,-50,FALSE,FALSE,FALSE,14.48,"young",38,178,77,"f"
7,"CHEST PRESS",1,"Con08",1820,1840,2150,2400,1830,2275,0.243,-445,2052.5,"Con",-20,-250,TRUE,FALSE,FALSE,19.56,"young",38,178,77,"f"
7,"CHEST PRESS",1,"Con09",1920,1980,2500,2450,1950,2475,0.269,-525,2212.5,"Con",-60,50,TRUE,TRUE,FALSE,21.21,"young",38,178,77,"f"
7,"CHEST PRESS",1,"Con10",1900,1900,2100,2150,1900,2125,0.118,-225,2012.5,"Con",0,-50,FALSE,FALSE,FALSE,10.59,"young",38,178,77,"f"
7,"CHEST PRESS",2,"Con01",2660,2720,2750,2600,2690,2675,0.006,15,2682.5,"Con",-60,150,FALSE,TRUE,FALSE,0.56,"young",38,178,77,"f"
7,"CHEST PRESS",2,"Con02",2080,2060,2050,2200,2070,2125,0.027,-55,2097.5,"Con",20,-150,FALSE,FALSE,FALSE,2.59,"young",38,178,77,"f"
7,"CHEST PRESS",2,"Con03",2100,2080,2350,2200,2090,2275,0.089,-185,2182.5,"Con",20,150,FALSE,FALSE,FALSE,8.13,"young",38,178,77,"f"
7,"CHEST PRESS",2,"Con04",2000,1980,2100,2100,1990,2100,0.055,-110,2045,"Con",20,0,FALSE,FALSE,FALSE,5.24,"young",38,178,77,"f"
7,"CHEST PRESS",2,"Con05",2000,2040,1900,2150,2020,2025,0.002,-5,2022.5,"Con",-40,-250,FALSE,TRUE,FALSE,0.25,"young",38,178,77,"f"
7,"CHEST PRESS",2,"Con06",2160,2160,2150,2450,2160,2300,0.065,-140,2230,"Con",0,-300,FALSE,FALSE,FALSE,6.09,"young",38,178,77,"f"
7,"CHEST PRESS",2,"Con07",2120,2140,2500,2400,2130,2450,0.15,-320,2290,"Con",-20,100,FALSE,FALSE,FALSE,13.06,"young",38,178,77,"f"
7,"CHEST PRESS",2,"Con08",2000,2000,2450,2150,2000,2300,0.15,-300,2150,"Con",0,300,FALSE,FALSE,FALSE,13.04,"young",38,178,77,"f"
7,"CHEST PRESS",2,"Con09",1800,1800,2150,2050,1800,2100,0.167,-300,1950,"Con",0,100,FALSE,FALSE,FALSE,14.29,"young",38,178,77,"f"
7,"CHEST PRESS",2,"Con10",1980,1920,2250,2200,1950,2225,0.141,-275,2087.5,"Con",60,50,FALSE,TRUE,FALSE,12.36,"young",38,178,77,"f"
7,"CHEST PRESS",1,"Ecc01",3360,3360,3300,3350,3360,3325,0.01,35,3342.5,"Ecc",0,-50,FALSE,FALSE,FALSE,1.05,"young",38,178,77,"f"
7,"CHEST PRESS",1,"Ecc02",2980,2980,3050,2850,2980,2950,0.01,30,2965,"Ecc",0,200,FALSE,FALSE,FALSE,1.02,"young",38,178,77,"f"
7,"CHEST PRESS",1,"Ecc03",3340,3340,3400,3100,3340,3250,0.027,90,3295,"Ecc",0,300,FALSE,FALSE,TRUE,2.77,"young",38,178,77,"f"
7,"CHEST PRESS",1,"Ecc04",3560,3540,3300,3450,3550,3375,0.049,175,3462.5,"Ecc",20,-150,FALSE,FALSE,FALSE,5.19,"young",38,178,77,"f"
7,"CHEST PRESS",1,"Ecc05",3460,3440,2900,3300,3450,3100,0.101,350,3275,"Ecc",20,-400,TRUE,FALSE,TRUE,11.29,"young",38,178,77,"f"
7,"CHEST PRESS",1,"Ecc06",2880,2900,2700,2950,2890,2825,0.022,65,2857.5,"Ecc",-20,-250,FALSE,FALSE,TRUE,2.3,"young",38,178,77,"f"
7,"CHEST PRESS",1,"Ecc07",3580,3560,3250,3100,3570,3175,0.111,395,3372.5,"Ecc",20,150,TRUE,FALSE,FALSE,12.44,"young",38,178,77,"f"
7,"CHEST PRESS",1,"Ecc08",3280,3220,2950,2800,3250,2875,0.115,375,3062.5,"Ecc",60,150,TRUE,TRUE,FALSE,13.04,"young",38,178,77,"f"
7,"CHEST PRESS",1,"Ecc09",3040,3020,2500,2550,3030,2525,0.167,505,2777.5,"Ecc",20,-50,TRUE,FALSE,FALSE,20,"young",38,178,77,"f"
7,"CHEST PRESS",1,"Ecc10",3260,3260,3300,3150,3260,3225,0.011,35,3242.5,"Ecc",0,150,FALSE,FALSE,FALSE,1.09,"young",38,178,77,"f"
7,"CHEST PRESS",2,"Ecc01",3080,3080,3100,3000,3080,3050,0.01,30,3065,"Ecc",0,100,FALSE,FALSE,FALSE,0.98,"young",38,178,77,"f"
7,"CHEST PRESS",2,"Ecc02",2860,2900,2850,2800,2880,2825,0.019,55,2852.5,"Ecc",-40,50,FALSE,TRUE,FALSE,1.95,"young",38,178,77,"f"
7,"CHEST PRESS",2,"Ecc03",3200,3180,2950,3100,3190,3025,0.052,165,3107.5,"Ecc",20,-150,FALSE,FALSE,FALSE,5.45,"young",38,178,77,"f"
7,"CHEST PRESS",2,"Ecc04",3160,3180,3100,3000,3170,3050,0.038,120,3110,"Ecc",-20,100,FALSE,FALSE,FALSE,3.93,"young",38,178,77,"f"
7,"CHEST PRESS",2,"Ecc05",3100,3080,3300,2950,3090,3125,0.011,-35,3107.5,"Ecc",20,350,FALSE,FALSE,TRUE,1.12,"young",38,178,77,"f"
7,"CHEST PRESS",2,"Ecc06",3200,3200,3000,2850,3200,2925,0.086,275,3062.5,"Ecc",0,150,FALSE,FALSE,FALSE,9.4,"young",38,178,77,"f"
7,"CHEST PRESS",2,"Ecc07",3120,3080,2600,2900,3100,2750,0.113,350,2925,"Ecc",40,-300,TRUE,TRUE,TRUE,12.73,"young",38,178,77,"f"
7,"CHEST PRESS",2,"Ecc08",2620,2640,2250,2450,2630,2350,0.106,280,2490,"Ecc",-20,-200,FALSE,FALSE,FALSE,11.91,"young",38,178,77,"f"
7,"CHEST PRESS",2,"Ecc09",2700,2700,2400,2450,2700,2425,0.102,275,2562.5,"Ecc",0,-50,FALSE,FALSE,FALSE,11.34,"young",38,178,77,"f"
7,"CHEST PRESS",2,"Ecc10",3920,3980,3100,3800,3950,3450,0.127,500,3700,"Ecc",-60,-700,TRUE,TRUE,TRUE,14.49,"young",38,178,77,"f"
7,"CHEST PRESS",1,"Rep01",5920,5960,5550,5850,5940,5700,0.04,240,5820,"Rep",-40,-300,TRUE,FALSE,TRUE,4.21,"young",38,178,77,"f"
7,"CHEST PRESS",1,"Rep02",5300,5260,5350,5250,5280,5300,0.004,-20,5290,"Rep",40,100,FALSE,FALSE,FALSE,0.38,"young",38,178,77,"f"
7,"CHEST PRESS",1,"Rep03",5120,5140,5050,5100,5130,5075,0.011,55,5102.5,"Rep",-20,-50,FALSE,FALSE,FALSE,1.08,"young",38,178,77,"f"
7,"CHEST PRESS",1,"Rep04",5720,5720,5550,5750,5720,5650,0.012,70,5685,"Rep",0,-200,FALSE,FALSE,TRUE,1.24,"young",38,178,77,"f"
7,"CHEST PRESS",1,"Rep05",5440,5440,5300,5450,5440,5375,0.012,65,5407.5,"Rep",0,-150,FALSE,FALSE,FALSE,1.21,"young",38,178,77,"f"
7,"CHEST PRESS",1,"Rep06",5240,5240,5450,5200,5240,5325,0.016,-85,5282.5,"Rep",0,250,FALSE,FALSE,TRUE,1.6,"young",38,178,77,"f"
7,"CHEST PRESS",1,"Rep07",5440,5420,5400,5300,5430,5350,0.015,80,5390,"Rep",20,100,FALSE,FALSE,FALSE,1.5,"young",38,178,77,"f"
7,"CHEST PRESS",1,"Rep08",5100,5060,5100,5200,5080,5150,0.014,-70,5115,"Rep",40,-100,FALSE,FALSE,FALSE,1.36,"young",38,178,77,"f"
7,"CHEST PRESS",1,"Rep09",4960,5000,5000,5000,4980,5000,0.004,-20,4990,"Rep",-40,0,FALSE,FALSE,FALSE,0.4,"young",38,178,77,"f"
7,"CHEST PRESS",1,"Rep10",5160,5160,5400,5300,5160,5350,0.037,-190,5255,"Rep",0,100,TRUE,FALSE,FALSE,3.55,"young",38,178,77,"f"
7,"CHEST PRESS",2,"Rep01",5740,5800,5850,5600,5770,5725,0.008,45,5747.5,"Rep",-60,250,FALSE,FALSE,TRUE,0.79,"young",38,178,77,"f"
7,"CHEST PRESS",2,"Rep02",4940,4960,4900,5000,4950,4950,0,0,4950,"Rep",-20,-100,FALSE,FALSE,FALSE,0,"young",38,178,77,"f"
7,"CHEST PRESS",2,"Rep03",5300,5260,5300,5300,5280,5300,0.004,-20,5290,"Rep",40,0,FALSE,FALSE,FALSE,0.38,"young",38,178,77,"f"
7,"CHEST PRESS",2,"Rep04",5160,5160,5200,5100,5160,5150,0.002,10,5155,"Rep",0,100,FALSE,FALSE,FALSE,0.19,"young",38,178,77,"f"
7,"CHEST PRESS",2,"Rep05",5100,5120,5200,5100,5110,5150,0.008,-40,5130,"Rep",-20,100,FALSE,FALSE,FALSE,0.78,"young",38,178,77,"f"
7,"CHEST PRESS",2,"Rep06",5360,5360,5150,5300,5360,5225,0.025,135,5292.5,"Rep",0,-150,FALSE,FALSE,FALSE,2.58,"young",38,178,77,"f"
7,"CHEST PRESS",2,"Rep07",5240,5220,5100,5300,5230,5200,0.006,30,5215,"Rep",20,-200,FALSE,FALSE,TRUE,0.58,"young",38,178,77,"f"
7,"CHEST PRESS",2,"Rep08",4620,4640,4700,4600,4630,4650,0.004,-20,4640,"Rep",-20,100,FALSE,FALSE,FALSE,0.43,"young",38,178,77,"f"
7,"CHEST PRESS",2,"Rep09",4500,4500,4550,4500,4500,4525,0.006,-25,4512.5,"Rep",0,50,FALSE,FALSE,FALSE,0.55,"young",38,178,77,"f"
7,"CHEST PRESS",2,"Rep10",5900,5900,5350,6000,5900,5675,0.038,225,5787.5,"Rep",0,-650,TRUE,FALSE,TRUE,3.96,"young",38,178,77,"f"
7,"CHEST PRESS",1,"TuT",53400,53400,53150,53400,53400,53275,0.002,125,53337.5,"TuT",0,-250,FALSE,FALSE,FALSE,0.23,"young",38,178,77,"f"
7,"CHEST PRESS",2,"TuT",51860,51920,51300,51800,51890,51550,0.007,340,51720,"TuT",-60,-500,FALSE,FALSE,FALSE,0.66,"young",38,178,77,"f"
8,"LEG PRESS",1,"Con01",1280,1280,2200,1450,1280,1825,0.426,-545,1552.5,"Con",0,750,TRUE,FALSE,TRUE,29.86,"old",60,181,91,"m"
8,"LEG PRESS",1,"Con02",1340,1360,1450,1400,1350,1425,0.056,-75,1387.5,"Con",-20,50,FALSE,FALSE,FALSE,5.26,"old",60,181,91,"m"
8,"LEG PRESS",1,"Con03",1300,1260,1350,1350,1280,1350,0.055,-70,1315,"Con",40,0,FALSE,FALSE,FALSE,5.19,"old",60,181,91,"m"
8,"LEG PRESS",1,"Con04",1240,1260,1400,1350,1250,1375,0.1,-125,1312.5,"Con",-20,50,FALSE,FALSE,FALSE,9.09,"old",60,181,91,"m"
8,"LEG PRESS",1,"Con05",1260,1280,1400,1400,1270,1400,0.102,-130,1335,"Con",-20,0,FALSE,FALSE,FALSE,9.29,"old",60,181,91,"m"
8,"LEG PRESS",1,"Con06",1260,1240,1350,1450,1250,1400,0.12,-150,1325,"Con",20,-100,FALSE,FALSE,FALSE,10.71,"old",60,181,91,"m"
8,"LEG PRESS",1,"Con07",1200,1200,1550,1550,1200,1550,0.292,-350,1375,"Con",0,0,FALSE,FALSE,FALSE,22.58,"old",60,181,91,"m"
8,"LEG PRESS",1,"Con08",1340,1280,2000,1850,1310,1925,0.469,-615,1617.5,"Con",60,150,TRUE,FALSE,FALSE,31.95,"old",60,181,91,"m"
8,"LEG PRESS",1,"Con09",1160,1180,1900,1700,1170,1800,0.538,-630,1485,"Con",-20,200,TRUE,FALSE,TRUE,35,"old",60,181,91,"m"
8,"LEG PRESS",1,"Con10",1260,1280,1500,1450,1270,1475,0.161,-205,1372.5,"Con",-20,50,FALSE,FALSE,FALSE,13.9,"old",60,181,91,"m"
8,"LEG PRESS",2,"Con01",1280,1260,1650,1450,1270,1550,0.22,-280,1410,"Con",20,200,FALSE,FALSE,TRUE,18.06,"old",60,181,91,"m"
8,"LEG PRESS",2,"Con02",1280,1260,1400,1350,1270,1375,0.083,-105,1322.5,"Con",20,50,FALSE,FALSE,FALSE,7.64,"old",60,181,91,"m"
8,"LEG PRESS",2,"Con03",1240,1220,1350,1350,1230,1350,0.098,-120,1290,"Con",20,0,FALSE,FALSE,FALSE,8.89,"old",60,181,91,"m"
8,"LEG PRESS",2,"Con04",1340,1360,1550,1550,1350,1550,0.148,-200,1450,"Con",-20,0,FALSE,FALSE,FALSE,12.9,"old",60,181,91,"m"
8,"LEG PRESS",2,"Con05",1300,1300,1600,1600,1300,1600,0.231,-300,1450,"Con",0,0,FALSE,FALSE,FALSE,18.75,"old",60,181,91,"m"
8,"LEG PRESS",2,"Con06",1240,1240,1550,1500,1240,1525,0.23,-285,1382.5,"Con",0,50,FALSE,FALSE,FALSE,18.69,"old",60,181,91,"m"
8,"LEG PRESS",2,"Con07",1260,1260,1550,1500,1260,1525,0.21,-265,1392.5,"Con",0,50,FALSE,FALSE,FALSE,17.38,"old",60,181,91,"m"
8,"LEG PRESS",2,"Con08",1240,1240,1750,1750,1240,1750,0.411,-510,1495,"Con",0,0,TRUE,FALSE,FALSE,29.14,"old",60,181,91,"m"
8,"LEG PRESS",2,"Con09",1340,1320,1600,1650,1330,1625,0.222,-295,1477.5,"Con",20,-50,FALSE,FALSE,FALSE,18.15,"old",60,181,91,"m"
8,"LEG PRESS",2,"Con10",1520,1520,2000,2200,1520,2100,0.382,-580,1810,"Con",0,-200,TRUE,FALSE,TRUE,27.62,"old",60,181,91,"m"
8,"LEG PRESS",1,"Ecc01",3340,3340,3150,3200,3340,3175,0.049,165,3257.5,"Ecc",0,-50,FALSE,FALSE,FALSE,5.2,"old",60,181,91,"m"
8,"LEG PRESS",1,"Ecc02",3380,3400,3350,3350,3390,3350,0.012,40,3370,"Ecc",-20,0,FALSE,FALSE,FALSE,1.19,"old",60,181,91,"m"
8,"LEG PRESS",1,"Ecc03",3340,3320,3200,3250,3330,3225,0.032,105,3277.5,"Ecc",20,-50,FALSE,FALSE,FALSE,3.26,"old",60,181,91,"m"
8,"LEG PRESS",1,"Ecc04",3160,3140,3000,3050,3150,3025,0.04,125,3087.5,"Ecc",20,-50,FALSE,FALSE,FALSE,4.13,"old",60,181,91,"m"
8,"LEG PRESS",1,"Ecc05",3140,3160,3050,2950,3150,3000,0.048,150,3075,"Ecc",-20,100,FALSE,FALSE,FALSE,5,"old",60,181,91,"m"
8,"LEG PRESS",1,"Ecc06",3260,3260,3000,2950,3260,2975,0.087,285,3117.5,"Ecc",0,50,FALSE,FALSE,FALSE,9.58,"old",60,181,91,"m"
8,"LEG PRESS",1,"Ecc07",3140,3200,2450,2600,3170,2525,0.203,645,2847.5,"Ecc",-60,-150,TRUE,FALSE,FALSE,25.54,"old",60,181,91,"m"
8,"LEG PRESS",1,"Ecc08",3200,3180,2450,2650,3190,2550,0.201,640,2870,"Ecc",20,-200,TRUE,FALSE,TRUE,25.1,"old",60,181,91,"m"
8,"LEG PRESS",1,"Ecc09",2920,2920,2650,2750,2920,2700,0.075,220,2810,"Ecc",0,-100,FALSE,FALSE,FALSE,8.15,"old",60,181,91,"m"
8,"LEG PRESS",1,"Ecc10",3040,3020,3000,2950,3030,2975,0.018,55,3002.5,"Ecc",20,50,FALSE,FALSE,FALSE,1.85,"old",60,181,91,"m"
8,"LEG PRESS",2,"Ecc01",3000,3000,2850,2900,3000,2875,0.042,125,2937.5,"Ecc",0,-50,FALSE,FALSE,FALSE,4.35,"old",60,181,91,"m"
8,"LEG PRESS",2,"Ecc02",2700,2720,2650,2650,2710,2650,0.022,60,2680,"Ecc",-20,0,FALSE,FALSE,FALSE,2.26,"old",60,181,91,"m"
8,"LEG PRESS",2,"Ecc03",2520,2520,2350,2300,2520,2325,0.077,195,2422.5,"Ecc",0,50,FALSE,FALSE,FALSE,8.39,"old",60,181,91,"m"
8,"LEG PRESS",2,"Ecc04",3060,3060,2800,2800,3060,2800,0.085,260,2930,"Ecc",0,0,FALSE,FALSE,FALSE,9.29,"old",60,181,91,"m"
8,"LEG PRESS",2,"Ecc05",3160,3160,2800,2900,3160,2850,0.098,310,3005,"Ecc",0,-100,FALSE,FALSE,FALSE,10.88,"old",60,181,91,"m"
8,"LEG PRESS",2,"Ecc06",2820,2800,2550,2550,2810,2550,0.093,260,2680,"Ecc",20,0,FALSE,FALSE,FALSE,10.2,"old",60,181,91,"m"
8,"LEG PRESS",2,"Ecc07",2880,2900,2400,2450,2890,2425,0.161,465,2657.5,"Ecc",-20,-50,TRUE,FALSE,FALSE,19.18,"old",60,181,91,"m"
8,"LEG PRESS",2,"Ecc08",2800,2820,2500,2450,2810,2475,0.119,335,2642.5,"Ecc",-20,50,TRUE,FALSE,FALSE,13.54,"old",60,181,91,"m"
8,"LEG PRESS",2,"Ecc09",3160,3160,2800,2600,3160,2700,0.146,460,2930,"Ecc",0,200,TRUE,FALSE,TRUE,17.04,"old",60,181,91,"m"
8,"LEG PRESS",2,"Ecc10",3000,3000,2800,2800,3000,2800,0.067,200,2900,"Ecc",0,0,FALSE,FALSE,FALSE,7.14,"old",60,181,91,"m"
8,"LEG PRESS",1,"Rep01",4620,4620,5350,4650,4620,5000,0.082,-380,4810,"Rep",0,700,TRUE,FALSE,TRUE,7.6,"old",60,181,91,"m"
8,"LEG PRESS",1,"Rep02",4720,4760,4800,4750,4740,4775,0.007,-35,4757.5,"Rep",-40,50,FALSE,FALSE,FALSE,0.73,"old",60,181,91,"m"
8,"LEG PRESS",1,"Rep03",4640,4580,4550,4600,4610,4575,0.008,35,4592.5,"Rep",60,-50,FALSE,FALSE,FALSE,0.77,"old",60,181,91,"m"
8,"LEG PRESS",1,"Rep04",4400,4400,4400,4400,4400,4400,0,0,4400,"Rep",0,0,FALSE,FALSE,FALSE,0,"old",60,181,91,"m"
8,"LEG PRESS",1,"Rep05",4400,4440,4450,4350,4420,4400,0.005,20,4410,"Rep",-40,100,FALSE,FALSE,TRUE,0.45,"old",60,181,91,"m"
8,"LEG PRESS",1,"Rep06",4520,4500,4350,4400,4510,4375,0.03,135,4442.5,"Rep",20,-50,TRUE,FALSE,FALSE,3.09,"old",60,181,91,"m"
8,"LEG PRESS",1,"Rep07",4340,4400,4000,4150,4370,4075,0.068,295,4222.5,"Rep",-60,-150,TRUE,FALSE,TRUE,7.24,"old",60,181,91,"m"
8,"LEG PRESS",1,"Rep08",4540,4460,4450,4500,4500,4475,0.006,25,4487.5,"Rep",80,-50,FALSE,TRUE,FALSE,0.56,"old",60,181,91,"m"
8,"LEG PRESS",1,"Rep09",4080,4100,4550,4450,4090,4500,0.1,-410,4295,"Rep",-20,100,TRUE,FALSE,TRUE,9.11,"old",60,181,91,"m"
8,"LEG PRESS",1,"Rep10",4300,4300,4500,4400,4300,4450,0.035,-150,4375,"Rep",0,100,TRUE,FALSE,TRUE,3.37,"old",60,181,91,"m"
8,"LEG PRESS",2,"Rep01",4280,4260,4500,4350,4270,4425,0.036,-155,4347.5,"Rep",20,150,TRUE,FALSE,TRUE,3.5,"old",60,181,91,"m"
8,"LEG PRESS",2,"Rep02",3980,3980,4050,4000,3980,4025,0.011,-45,4002.5,"Rep",0,50,FALSE,FALSE,FALSE,1.12,"old",60,181,91,"m"
8,"LEG PRESS",2,"Rep03",3760,3740,3700,3650,3750,3675,0.02,75,3712.5,"Rep",20,50,FALSE,FALSE,FALSE,2.04,"old",60,181,91,"m"
8,"LEG PRESS",2,"Rep04",4400,4420,4350,4350,4410,4350,0.014,60,4380,"Rep",-20,0,FALSE,FALSE,FALSE,1.38,"old",60,181,91,"m"
8,"LEG PRESS",2,"Rep05",4460,4460,4400,4500,4460,4450,0.002,10,4455,"Rep",0,-100,FALSE,FALSE,TRUE,0.22,"old",60,181,91,"m"
8,"LEG PRESS",2,"Rep06",4060,4040,4100,4050,4050,4075,0.006,-25,4062.5,"Rep",20,50,FALSE,FALSE,FALSE,0.61,"old",60,181,91,"m"
8,"LEG PRESS",2,"Rep07",4140,4160,3950,3950,4150,3950,0.048,200,4050,"Rep",-20,0,TRUE,FALSE,FALSE,5.06,"old",60,181,91,"m"
8,"LEG PRESS",2,"Rep08",4040,4060,4250,4200,4050,4225,0.043,-175,4137.5,"Rep",-20,50,TRUE,FALSE,FALSE,4.14,"old",60,181,91,"m"
8,"LEG PRESS",2,"Rep09",4500,4480,4400,4250,4490,4325,0.037,165,4407.5,"Rep",20,150,TRUE,FALSE,TRUE,3.82,"old",60,181,91,"m"
8,"LEG PRESS",2,"Rep10",4520,4520,4800,5000,4520,4900,0.084,-380,4710,"Rep",0,-200,TRUE,FALSE,TRUE,7.76,"old",60,181,91,"m"
8,"LEG PRESS",1,"TuT",44560,44560,45400,44650,44560,45025,0.01,-465,44792.5,"TuT",0,750,FALSE,FALSE,TRUE,1.03,"old",60,181,91,"m"
8,"LEG PRESS",2,"TuT",42140,42120,42500,42300,42130,42400,0.006,-270,42265,"TuT",20,200,FALSE,FALSE,FALSE,0.64,"old",60,181,91,"m"
8,"LEG EXTENSION",1,"Con01",2200,2240,2300,1550,2220,1925,0.133,295,2072.5,"Con",-40,750,TRUE,TRUE,TRUE,15.32,"old",60,181,91,"m"
8,"LEG EXTENSION",1,"Con02",1500,1500,1550,1350,1500,1450,0.033,50,1475,"Con",0,200,FALSE,FALSE,TRUE,3.45,"old",60,181,91,"m"
8,"LEG EXTENSION",1,"Con03",1260,1260,1400,1300,1260,1350,0.071,-90,1305,"Con",0,100,FALSE,FALSE,FALSE,6.67,"old",60,181,91,"m"
8,"LEG EXTENSION",1,"Con04",1060,1080,1150,1100,1070,1125,0.051,-55,1097.5,"Con",-20,50,FALSE,FALSE,FALSE,4.89,"old",60,181,91,"m"
8,"LEG EXTENSION",1,"Con05",1240,1240,1400,1550,1240,1475,0.19,-235,1357.5,"Con",0,-150,TRUE,FALSE,FALSE,15.93,"old",60,181,91,"m"
8,"LEG EXTENSION",1,"Con06",1260,1300,1450,1750,1280,1600,0.25,-320,1440,"Con",-40,-300,TRUE,TRUE,TRUE,20,"old",60,181,91,"m"
8,"LEG EXTENSION",1,"Con07",1200,1220,1350,1350,1210,1350,0.116,-140,1280,"Con",-20,0,FALSE,FALSE,FALSE,10.37,"old",60,181,91,"m"
8,"LEG EXTENSION",1,"Con08",1300,1320,1350,1550,1310,1450,0.107,-140,1380,"Con",-20,-200,FALSE,FALSE,TRUE,9.66,"old",60,181,91,"m"
8,"LEG EXTENSION",1,"Con09",1200,1220,1350,1750,1210,1550,0.281,-340,1380,"Con",-20,-400,TRUE,FALSE,TRUE,21.94,"old",60,181,91,"m"
8,"LEG EXTENSION",1,"Con10",1280,1260,1550,2250,1270,1900,0.496,-630,1585,"Con",20,-700,TRUE,FALSE,TRUE,33.16,"old",60,181,91,"m"
8,"LEG EXTENSION",2,"Con01",1540,1560,1500,1650,1550,1575,0.016,-25,1562.5,"Con",-20,-150,FALSE,FALSE,FALSE,1.59,"old",60,181,91,"m"
8,"LEG EXTENSION",2,"Con02",1300,1360,1300,1700,1330,1500,0.128,-170,1415,"Con",-60,-400,FALSE,TRUE,TRUE,11.33,"old",60,181,91,"m"
8,"LEG EXTENSION",2,"Con03",1360,1320,1500,1400,1340,1450,0.082,-110,1395,"Con",40,100,FALSE,TRUE,FALSE,7.59,"old",60,181,91,"m"
8,"LEG EXTENSION",2,"Con04",1500,1520,3050,1600,1510,2325,0.54,-815,1917.5,"Con",-20,1450,TRUE,FALSE,TRUE,35.05,"old",60,181,91,"m"
8,"LEG EXTENSION",2,"Con05",1300,1320,1200,1350,1310,1275,0.027,35,1292.5,"Con",-20,-150,FALSE,FALSE,FALSE,2.75,"old",60,181,91,"m"
8,"LEG EXTENSION",2,"Con06",1220,1240,1200,1300,1230,1250,0.016,-20,1240,"Con",-20,-100,FALSE,FALSE,FALSE,1.6,"old",60,181,91,"m"
8,"LEG EXTENSION",2,"Con07",1220,1240,1250,1400,1230,1325,0.077,-95,1277.5,"Con",-20,-150,FALSE,FALSE,FALSE,7.17,"old",60,181,91,"m"
8,"LEG EXTENSION",2,"Con08",1340,1340,1400,1550,1340,1475,0.101,-135,1407.5,"Con",0,-150,FALSE,FALSE,FALSE,9.15,"old",60,181,91,"m"
8,"LEG EXTENSION",2,"Con09",1380,1380,1500,1750,1380,1625,0.178,-245,1502.5,"Con",0,-250,TRUE,FALSE,TRUE,15.08,"old",60,181,91,"m"
8,"LEG EXTENSION",2,"Con10",1340,1340,1850,1850,1340,1850,0.381,-510,1595,"Con",0,0,TRUE,FALSE,FALSE,27.57,"old",60,181,91,"m"
8,"LEG EXTENSION",1,"Ecc01",2680,2660,2650,2700,2670,2675,0.002,-5,2672.5,"Ecc",20,-50,FALSE,FALSE,FALSE,0.19,"old",60,181,91,"m"
8,"LEG EXTENSION",1,"Ecc02",3560,3540,3450,3650,3550,3550,0,0,3550,"Ecc",20,-200,FALSE,FALSE,TRUE,0,"old",60,181,91,"m"
8,"LEG EXTENSION",1,"Ecc03",3520,3500,3400,3450,3510,3425,0.024,85,3467.5,"Ecc",20,-50,FALSE,FALSE,FALSE,2.48,"old",60,181,91,"m"
8,"LEG EXTENSION",1,"Ecc04",3780,3800,3650,3550,3790,3600,0.05,190,3695,"Ecc",-20,100,TRUE,FALSE,FALSE,5.28,"old",60,181,91,"m"
8,"LEG EXTENSION",1,"Ecc05",3040,3000,2850,2550,3020,2700,0.106,320,2860,"Ecc",40,300,TRUE,TRUE,TRUE,11.85,"old",60,181,91,"m"
8,"LEG EXTENSION",1,"Ecc06",3280,3260,3150,3100,3270,3125,0.044,145,3197.5,"Ecc",20,50,FALSE,FALSE,FALSE,4.64,"old",60,181,91,"m"
8,"LEG EXTENSION",1,"Ecc07",3200,3160,3100,2950,3180,3025,0.049,155,3102.5,"Ecc",40,150,FALSE,TRUE,FALSE,5.12,"old",60,181,91,"m"
8,"LEG EXTENSION",1,"Ecc08",3020,3020,2900,2550,3020,2725,0.098,295,2872.5,"Ecc",0,350,TRUE,FALSE,TRUE,10.83,"old",60,181,91,"m"
8,"LEG EXTENSION",1,"Ecc09",3120,3120,2900,2050,3120,2475,0.207,645,2797.5,"Ecc",0,850,TRUE,FALSE,TRUE,26.06,"old",60,181,91,"m"
8,"LEG EXTENSION",1,"Ecc10",2720,2720,2650,2650,2720,2650,0.026,70,2685,"Ecc",0,0,FALSE,FALSE,FALSE,2.64,"old",60,181,91,"m"
8,"LEG EXTENSION",2,"Ecc01",2980,2940,3000,2600,2960,2800,0.054,160,2880,"Ecc",40,400,FALSE,TRUE,TRUE,5.71,"old",60,181,91,"m"
8,"LEG EXTENSION",2,"Ecc02",3360,3380,3300,3250,3370,3275,0.028,95,3322.5,"Ecc",-20,50,FALSE,FALSE,FALSE,2.9,"old",60,181,91,"m"
8,"LEG EXTENSION",2,"Ecc03",4000,3980,2550,3950,3990,3250,0.185,740,3620,"Ecc",20,-1400,TRUE,FALSE,TRUE,22.77,"old",60,181,91,"m"
8,"LEG EXTENSION",2,"Ecc04",4340,4340,4200,4250,4340,4225,0.026,115,4282.5,"Ecc",0,-50,FALSE,FALSE,FALSE,2.72,"old",60,181,91,"m"
8,"LEG EXTENSION",2,"Ecc05",3400,3360,3450,3350,3380,3400,0.006,-20,3390,"Ecc",40,100,FALSE,TRUE,FALSE,0.59,"old",60,181,91,"m"
8,"LEG EXTENSION",2,"Ecc06",3580,3580,3600,3450,3580,3525,0.015,55,3552.5,"Ecc",0,150,FALSE,FALSE,FALSE,1.56,"old",60,181,91,"m"
8,"LEG EXTENSION",2,"Ecc07",3620,3600,3550,3350,3610,3450,0.044,160,3530,"Ecc",20,200,FALSE,FALSE,TRUE,4.64,"old",60,181,91,"m"
8,"LEG EXTENSION",2,"Ecc08",3680,3680,3600,3400,3680,3500,0.049,180,3590,"Ecc",0,200,FALSE,FALSE,TRUE,5.14,"old",60,181,91,"m"
8,"LEG EXTENSION",2,"Ecc09",3460,3440,3000,2900,3450,2950,0.145,500,3200,"Ecc",20,100,TRUE,FALSE,FALSE,16.95,"old",60,181,91,"m"
8,"LEG EXTENSION",2,"Ecc10",3240,3260,3200,3150,3250,3175,0.023,75,3212.5,"Ecc",-20,50,FALSE,FALSE,FALSE,2.36,"old",60,181,91,"m"
8,"LEG EXTENSION",1,"Rep01",4880,4900,4950,4250,4890,4600,0.059,290,4745,"Rep",-20,700,TRUE,FALSE,TRUE,6.3,"old",60,181,91,"m"
8,"LEG EXTENSION",1,"Rep02",5060,5040,5000,5000,5050,5000,0.01,50,5025,"Rep",20,0,FALSE,FALSE,FALSE,1,"old",60,181,91,"m"
8,"LEG EXTENSION",1,"Rep03",4780,4760,4800,4750,4770,4775,0.001,-5,4772.5,"Rep",20,50,FALSE,FALSE,FALSE,0.1,"old",60,181,91,"m"
8,"LEG EXTENSION",1,"Rep04",4840,4880,4800,4650,4860,4725,0.028,135,4792.5,"Rep",-40,150,TRUE,FALSE,FALSE,2.86,"old",60,181,91,"m"
8,"LEG EXTENSION",1,"Rep05",4280,4240,4250,4100,4260,4175,0.02,85,4217.5,"Rep",40,150,FALSE,FALSE,FALSE,2.04,"old",60,181,91,"m"
8,"LEG EXTENSION",1,"Rep06",4540,4560,4600,4850,4550,4725,0.038,-175,4637.5,"Rep",-20,-250,TRUE,FALSE,TRUE,3.7,"old",60,181,91,"m"
8,"LEG EXTENSION",1,"Rep07",4400,4380,4450,4300,4390,4375,0.003,15,4382.5,"Rep",20,150,FALSE,FALSE,FALSE,0.34,"old",60,181,91,"m"
8,"LEG EXTENSION",1,"Rep08",4320,4340,4250,4100,4330,4175,0.036,155,4252.5,"Rep",-20,150,TRUE,FALSE,FALSE,3.71,"old",60,181,91,"m"
8,"LEG EXTENSION",1,"Rep09",4320,4340,4250,3800,4330,4025,0.07,305,4177.5,"Rep",-20,450,TRUE,FALSE,TRUE,7.58,"old",60,181,91,"m"
8,"LEG EXTENSION",1,"Rep10",4000,3980,4200,4900,3990,4550,0.14,-560,4270,"Rep",20,-700,TRUE,FALSE,TRUE,12.31,"old",60,181,91,"m"
8,"LEG EXTENSION",2,"Rep01",4520,4500,4500,4250,4510,4375,0.03,135,4442.5,"Rep",20,250,TRUE,FALSE,TRUE,3.09,"old",60,181,91,"m"
8,"LEG EXTENSION",2,"Rep02",4660,4740,4600,4950,4700,4775,0.016,-75,4737.5,"Rep",-80,-350,FALSE,TRUE,TRUE,1.57,"old",60,181,91,"m"
8,"LEG EXTENSION",2,"Rep03",5360,5300,4050,5350,5330,4700,0.118,630,5015,"Rep",60,-1300,TRUE,FALSE,TRUE,13.4,"old",60,181,91,"m"
8,"LEG EXTENSION",2,"Rep04",5840,5860,7250,5850,5850,6550,0.12,-700,6200,"Rep",-20,1400,TRUE,FALSE,TRUE,10.69,"old",60,181,91,"m"
8,"LEG EXTENSION",2,"Rep05",4700,4680,4650,4700,4690,4675,0.003,15,4682.5,"Rep",20,-50,FALSE,FALSE,FALSE,0.32,"old",60,181,91,"m"
8,"LEG EXTENSION",2,"Rep06",4800,4820,4800,4750,4810,4775,0.007,35,4792.5,"Rep",-20,50,FALSE,FALSE,FALSE,0.73,"old",60,181,91,"m"
8,"LEG EXTENSION",2,"Rep07",4840,4840,4800,4750,4840,4775,0.013,65,4807.5,"Rep",0,50,FALSE,FALSE,FALSE,1.36,"old",60,181,91,"m"
8,"LEG EXTENSION",2,"Rep08",5020,5020,5000,4950,5020,4975,0.009,45,4997.5,"Rep",0,50,FALSE,FALSE,FALSE,0.9,"old",60,181,91,"m"
8,"LEG EXTENSION",2,"Rep09",4840,4820,4500,4650,4830,4575,0.053,255,4702.5,"Rep",20,-150,TRUE,FALSE,FALSE,5.57,"old",60,181,91,"m"
8,"LEG EXTENSION",2,"Rep10",4580,4600,5050,5000,4590,5025,0.095,-435,4807.5,"Rep",-20,50,TRUE,FALSE,FALSE,8.66,"old",60,181,91,"m"
8,"LEG EXTENSION",1,"TuT",45420,45420,45550,44700,45420,45125,0.006,295,45272.5,"TuT",0,850,TRUE,FALSE,TRUE,0.65,"old",60,181,91,"m"
8,"LEG EXTENSION",2,"TuT",49160,49180,49200,49200,49170,49200,0.001,-30,49185,"TuT",-20,0,FALSE,FALSE,FALSE,0.06,"old",60,181,91,"m"
8,"LEG CURL",1,"Con01",2060,2080,2200,2150,2070,2175,0.051,-105,2122.5,"Con",-20,50,FALSE,FALSE,FALSE,4.83,"old",60,181,91,"m"
8,"LEG CURL",1,"Con02",1840,1840,1850,1850,1840,1850,0.005,-10,1845,"Con",0,0,FALSE,FALSE,FALSE,0.54,"old",60,181,91,"m"
8,"LEG CURL",1,"Con03",1600,1600,1750,1800,1600,1775,0.109,-175,1687.5,"Con",0,-50,FALSE,FALSE,FALSE,9.86,"old",60,181,91,"m"
8,"LEG CURL",1,"Con04",1840,1780,1800,1900,1810,1850,0.022,-40,1830,"Con",60,-100,FALSE,FALSE,FALSE,2.16,"old",60,181,91,"m"
8,"LEG CURL",1,"Con05",1900,1900,2200,2000,1900,2100,0.105,-200,2000,"Con",0,200,FALSE,FALSE,TRUE,9.52,"old",60,181,91,"m"
8,"LEG CURL",1,"Con06",1860,1800,1950,1950,1830,1950,0.066,-120,1890,"Con",60,0,FALSE,FALSE,FALSE,6.15,"old",60,181,91,"m"
8,"LEG CURL",1,"Con07",1720,1720,1800,1700,1720,1750,0.017,-30,1735,"Con",0,100,FALSE,FALSE,FALSE,1.71,"old",60,181,91,"m"
8,"LEG CURL",1,"Con08",1660,1660,1750,1750,1660,1750,0.054,-90,1705,"Con",0,0,FALSE,FALSE,FALSE,5.14,"old",60,181,91,"m"
8,"LEG CURL",1,"Con09",1620,1620,2550,2550,1620,2550,0.574,-930,2085,"Con",0,0,TRUE,FALSE,FALSE,36.47,"old",60,181,91,"m"
8,"LEG CURL",1,"Con10",1640,1660,2300,2350,1650,2325,0.409,-675,1987.5,"Con",-20,-50,TRUE,FALSE,FALSE,29.03,"old",60,181,91,"m"
8,"LEG CURL",2,"Con01",1960,1920,1900,1800,1940,1850,0.046,90,1895,"Con",40,100,FALSE,FALSE,FALSE,4.86,"old",60,181,91,"m"
8,"LEG CURL",2,"Con02",1520,1520,1550,1650,1520,1600,0.053,-80,1560,"Con",0,-100,FALSE,FALSE,FALSE,5,"old",60,181,91,"m"
8,"LEG CURL",2,"Con03",1920,1880,2250,2100,1900,2175,0.145,-275,2037.5,"Con",40,150,TRUE,FALSE,FALSE,12.64,"old",60,181,91,"m"
8,"LEG CURL",2,"Con04",1620,1580,1750,1750,1600,1750,0.094,-150,1675,"Con",40,0,FALSE,FALSE,FALSE,8.57,"old",60,181,91,"m"
8,"LEG CURL",2,"Con05",1840,1800,1850,1850,1820,1850,0.016,-30,1835,"Con",40,0,FALSE,FALSE,FALSE,1.62,"old",60,181,91,"m"
8,"LEG CURL",2,"Con06",1880,1860,1850,1900,1870,1875,0.003,-5,1872.5,"Con",20,-50,FALSE,FALSE,FALSE,0.27,"old",60,181,91,"m"
8,"LEG CURL",2,"Con07",1520,1540,1600,1600,1530,1600,0.046,-70,1565,"Con",-20,0,FALSE,FALSE,FALSE,4.38,"old",60,181,91,"m"
8,"LEG CURL",2,"Con08",1560,1580,1750,1750,1570,1750,0.115,-180,1660,"Con",-20,0,FALSE,FALSE,FALSE,10.29,"old",60,181,91,"m"
8,"LEG CURL",2,"Con09",1780,1800,1800,1800,1790,1800,0.006,-10,1795,"Con",-20,0,FALSE,FALSE,FALSE,0.56,"old",60,181,91,"m"
8,"LEG CURL",2,"Con10",1460,1440,1750,1750,1450,1750,0.207,-300,1600,"Con",20,0,TRUE,FALSE,FALSE,17.14,"old",60,181,91,"m"
8,"LEG CURL",1,"Ecc01",3200,3200,3150,3100,3200,3125,0.023,75,3162.5,"Ecc",0,50,FALSE,FALSE,FALSE,2.4,"old",60,181,91,"m"
8,"LEG CURL",1,"Ecc02",4100,4100,3900,3950,4100,3925,0.043,175,4012.5,"Ecc",0,-50,FALSE,FALSE,FALSE,4.46,"old",60,181,91,"m"
8,"LEG CURL",1,"Ecc03",3320,3360,3350,3200,3340,3275,0.019,65,3307.5,"Ecc",-40,150,FALSE,FALSE,FALSE,1.98,"old",60,181,91,"m"
8,"LEG CURL",1,"Ecc04",3540,3560,3250,3400,3550,3325,0.063,225,3437.5,"Ecc",-20,-150,FALSE,FALSE,FALSE,6.77,"old",60,181,91,"m"
8,"LEG CURL",1,"Ecc05",3420,3460,3300,3350,3440,3325,0.033,115,3382.5,"Ecc",-40,-50,FALSE,FALSE,FALSE,3.46,"old",60,181,91,"m"
8,"LEG CURL",1,"Ecc06",3080,3080,2950,3000,3080,2975,0.034,105,3027.5,"Ecc",0,-50,FALSE,FALSE,FALSE,3.53,"old",60,181,91,"m"
8,"LEG CURL",1,"Ecc07",2940,2940,3000,3050,2940,3025,0.029,-85,2982.5,"Ecc",0,-50,FALSE,FALSE,FALSE,2.81,"old",60,181,91,"m"
8,"LEG CURL",1,"Ecc08",3220,3220,2400,2350,3220,2375,0.262,845,2797.5,"Ecc",0,50,TRUE,FALSE,FALSE,35.58,"old",60,181,91,"m"
8,"LEG CURL",1,"Ecc09",3460,3440,2700,2750,3450,2725,0.21,725,3087.5,"Ecc",20,-50,TRUE,FALSE,FALSE,26.61,"old",60,181,91,"m"
8,"LEG CURL",1,"Ecc10",3200,3200,3100,3050,3200,3075,0.039,125,3137.5,"Ecc",0,50,FALSE,FALSE,FALSE,4.07,"old",60,181,91,"m"
8,"LEG CURL",2,"Ecc01",3000,3020,3050,3000,3010,3025,0.005,-15,3017.5,"Ecc",-20,50,FALSE,FALSE,FALSE,0.5,"old",60,181,91,"m"
8,"LEG CURL",2,"Ecc02",3280,3300,3050,3100,3290,3075,0.065,215,3182.5,"Ecc",-20,-50,FALSE,FALSE,FALSE,6.99,"old",60,181,91,"m"
8,"LEG CURL",2,"Ecc03",3800,3860,3550,3650,3830,3600,0.06,230,3715,"Ecc",-60,-100,TRUE,FALSE,FALSE,6.39,"old",60,181,91,"m"
8,"LEG CURL",2,"Ecc04",3180,3200,3150,3100,3190,3125,0.02,65,3157.5,"Ecc",-20,50,FALSE,FALSE,FALSE,2.08,"old",60,181,91,"m"
8,"LEG CURL",2,"Ecc05",2980,2980,3050,3050,2980,3050,0.023,-70,3015,"Ecc",0,0,FALSE,FALSE,FALSE,2.3,"old",60,181,91,"m"
8,"LEG CURL",2,"Ecc06",3940,3960,3850,3800,3950,3825,0.032,125,3887.5,"Ecc",-20,50,FALSE,FALSE,FALSE,3.27,"old",60,181,91,"m"
8,"LEG CURL",2,"Ecc07",2780,2760,2650,2650,2770,2650,0.043,120,2710,"Ecc",20,0,FALSE,FALSE,FALSE,4.53,"old",60,181,91,"m"
8,"LEG CURL",2,"Ecc08",2940,2920,2900,2900,2930,2900,0.01,30,2915,"Ecc",20,0,FALSE,FALSE,FALSE,1.03,"old",60,181,91,"m"
8,"LEG CURL",2,"Ecc09",3880,3880,3650,3650,3880,3650,0.059,230,3765,"Ecc",0,0,TRUE,FALSE,FALSE,6.3,"old",60,181,91,"m"
8,"LEG CURL",2,"Ecc10",3460,3460,3400,3000,3460,3200,0.075,260,3330,"Ecc",0,400,TRUE,FALSE,TRUE,8.12,"old",60,181,91,"m"
8,"LEG CURL",1,"Rep01",5260,5280,5350,5250,5270,5300,0.006,-30,5285,"Rep",-20,100,FALSE,FALSE,FALSE,0.57,"old",60,181,91,"m"
8,"LEG CURL",1,"Rep02",5940,5940,5750,5800,5940,5775,0.028,165,5857.5,"Rep",0,-50,TRUE,FALSE,FALSE,2.86,"old",60,181,91,"m"
8,"LEG CURL",1,"Rep03",4920,4960,5100,5000,4940,5050,0.022,-110,4995,"Rep",-40,100,FALSE,FALSE,FALSE,2.18,"old",60,181,91,"m"
8,"LEG CURL",1,"Rep04",5380,5340,5050,5300,5360,5175,0.035,185,5267.5,"Rep",40,-250,TRUE,FALSE,TRUE,3.57,"old",60,181,91,"m"
8,"LEG CURL",1,"Rep05",5320,5360,5500,5350,5340,5425,0.016,-85,5382.5,"Rep",-40,150,FALSE,FALSE,FALSE,1.57,"old",60,181,91,"m"
8,"LEG CURL",1,"Rep06",4940,4880,4900,4950,4910,4925,0.003,-15,4917.5,"Rep",60,-50,FALSE,FALSE,FALSE,0.3,"old",60,181,91,"m"
8,"LEG CURL",1,"Rep07",4660,4660,4800,4750,4660,4775,0.025,-115,4717.5,"Rep",0,50,FALSE,FALSE,FALSE,2.41,"old",60,181,91,"m"
8,"LEG CURL",1,"Rep08",4880,4880,4150,4100,4880,4125,0.155,755,4502.5,"Rep",0,50,TRUE,FALSE,FALSE,18.3,"old",60,181,91,"m"
8,"LEG CURL",1,"Rep09",5080,5060,5250,5300,5070,5275,0.04,-205,5172.5,"Rep",20,-50,TRUE,FALSE,FALSE,3.89,"old",60,181,91,"m"
8,"LEG CURL",1,"Rep10",4840,4860,5400,5400,4850,5400,0.113,-550,5125,"Rep",-20,0,TRUE,FALSE,FALSE,10.19,"old",60,181,91,"m"
8,"LEG CURL",2,"Rep01",4960,4940,4950,4800,4950,4875,0.015,75,4912.5,"Rep",20,150,FALSE,FALSE,FALSE,1.54,"old",60,181,91,"m"
8,"LEG CURL",2,"Rep02",4800,4820,4600,4750,4810,4675,0.028,135,4742.5,"Rep",-20,-150,FALSE,FALSE,FALSE,2.89,"old",60,181,91,"m"
8,"LEG CURL",2,"Rep03",5720,5740,5800,5750,5730,5775,0.008,-45,5752.5,"Rep",-20,50,FALSE,FALSE,FALSE,0.78,"old",60,181,91,"m"
8,"LEG CURL",2,"Rep04",4800,4780,4900,4850,4790,4875,0.018,-85,4832.5,"Rep",20,50,FALSE,FALSE,FALSE,1.74,"old",60,181,91,"m"
8,"LEG CURL",2,"Rep05",4820,4780,4900,4900,4800,4900,0.021,-100,4850,"Rep",40,0,FALSE,FALSE,FALSE,2.04,"old",60,181,91,"m"
8,"LEG CURL",2,"Rep06",5820,5820,5700,5700,5820,5700,0.021,120,5760,"Rep",0,0,FALSE,FALSE,FALSE,2.11,"old",60,181,91,"m"
8,"LEG CURL",2,"Rep07",4300,4300,4250,4250,4300,4250,0.012,50,4275,"Rep",0,0,FALSE,FALSE,FALSE,1.18,"old",60,181,91,"m"
8,"LEG CURL",2,"Rep08",4500,4500,4650,4650,4500,4650,0.033,-150,4575,"Rep",0,0,FALSE,FALSE,FALSE,3.23,"old",60,181,91,"m"
8,"LEG CURL",2,"Rep09",5660,5680,5450,5450,5670,5450,0.039,220,5560,"Rep",-20,0,TRUE,FALSE,FALSE,4.04,"old",60,181,91,"m"
8,"LEG CURL",2,"Rep10",4920,4900,5150,4750,4910,4950,0.008,-40,4930,"Rep",20,400,FALSE,FALSE,TRUE,0.81,"old",60,181,91,"m"
8,"LEG CURL",1,"TuT",51220,51220,51250,51200,51220,51225,0,-5,51222.5,"TuT",0,50,FALSE,FALSE,FALSE,0.01,"old",60,181,91,"m"
8,"LEG CURL",2,"TuT",50300,50260,50350,49850,50280,50100,0.004,180,50190,"TuT",40,500,FALSE,TRUE,TRUE,0.36,"old",60,181,91,"m"
8,"ABDUCTOR",1,"Con01",1060,1060,1300,1450,1060,1375,0.297,-315,1217.5,"Con",0,-150,TRUE,FALSE,FALSE,22.91,"old",60,181,91,"m"
8,"ABDUCTOR",1,"Con02",840,840,1100,800,840,950,0.131,-110,895,"Con",0,300,FALSE,FALSE,TRUE,11.58,"old",60,181,91,"m"
8,"ABDUCTOR",1,"Con03",1020,1040,900,1100,1030,1000,0.029,30,1015,"Con",-20,-200,FALSE,FALSE,FALSE,3,"old",60,181,91,"m"
8,"ABDUCTOR",1,"Con04",900,920,1100,1300,910,1200,0.319,-290,1055,"Con",-20,-200,FALSE,FALSE,FALSE,24.17,"old",60,181,91,"m"
8,"ABDUCTOR",1,"Con05",1000,1000,1400,1000,1000,1200,0.2,-200,1100,"Con",0,400,FALSE,FALSE,TRUE,16.67,"old",60,181,91,"m"
8,"ABDUCTOR",1,"Con06",1020,1000,2100,1050,1010,1575,0.559,-565,1292.5,"Con",20,1050,TRUE,FALSE,TRUE,35.87,"old",60,181,91,"m"
8,"ABDUCTOR",1,"Con07",920,920,2000,1400,920,1700,0.848,-780,1310,"Con",0,600,TRUE,FALSE,TRUE,45.88,"old",60,181,91,"m"
8,"ABDUCTOR",1,"Con08",1000,980,1200,2450,990,1825,0.843,-835,1407.5,"Con",20,-1250,TRUE,FALSE,TRUE,45.75,"old",60,181,91,"m"
8,"ABDUCTOR",1,"Con09",1020,1020,1150,2050,1020,1600,0.569,-580,1310,"Con",0,-900,TRUE,FALSE,TRUE,36.25,"old",60,181,91,"m"
8,"ABDUCTOR",1,"Con10",1020,1020,1200,2250,1020,1725,0.691,-705,1372.5,"Con",0,-1050,TRUE,FALSE,TRUE,40.87,"old",60,181,91,"m"
8,"ABDUCTOR",2,"Con01",1180,1180,1250,1350,1180,1300,0.102,-120,1240,"Con",0,-100,FALSE,FALSE,FALSE,9.23,"old",60,181,91,"m"
8,"ABDUCTOR",2,"Con02",1040,1020,1600,1050,1030,1325,0.286,-295,1177.5,"Con",20,550,TRUE,FALSE,TRUE,22.26,"old",60,181,91,"m"
8,"ABDUCTOR",2,"Con03",1060,1040,1700,1550,1050,1625,0.548,-575,1337.5,"Con",20,150,TRUE,FALSE,FALSE,35.38,"old",60,181,91,"m"
8,"ABDUCTOR",2,"Con04",940,940,1400,2500,940,1950,1.074,-1010,1445,"Con",0,-1100,TRUE,FALSE,TRUE,51.79,"old",60,181,91,"m"
8,"ABDUCTOR",2,"Con05",940,940,1150,2300,940,1725,0.835,-785,1332.5,"Con",0,-1150,TRUE,FALSE,TRUE,45.51,"old",60,181,91,"m"
8,"ABDUCTOR",2,"Con06",1000,1000,1100,1100,1000,1100,0.1,-100,1050,"Con",0,0,FALSE,FALSE,FALSE,9.09,"old",60,181,91,"m"
8,"ABDUCTOR",2,"Con07",1040,1020,1150,1100,1030,1125,0.092,-95,1077.5,"Con",20,50,FALSE,FALSE,FALSE,8.44,"old",60,181,91,"m"
8,"ABDUCTOR",2,"Con08",1120,1120,1500,1200,1120,1350,0.205,-230,1235,"Con",0,300,FALSE,FALSE,TRUE,17.04,"old",60,181,91,"m"
8,"ABDUCTOR",2,"Con09",1000,940,2050,1450,970,1750,0.804,-780,1360,"Con",60,600,TRUE,TRUE,TRUE,44.57,"old",60,181,91,"m"
8,"ABDUCTOR",2,"Con10",1120,1100,1450,1300,1110,1375,0.239,-265,1242.5,"Con",20,150,FALSE,FALSE,FALSE,19.27,"old",60,181,91,"m"
8,"ABDUCTOR",1,"Ecc01",2940,2940,2650,2900,2940,2775,0.056,165,2857.5,"Ecc",0,-250,FALSE,FALSE,FALSE,5.95,"old",60,181,91,"m"
8,"ABDUCTOR",1,"Ecc02",2980,2960,2950,3000,2970,2975,0.002,-5,2972.5,"Ecc",20,-50,FALSE,FALSE,FALSE,0.17,"old",60,181,91,"m"
8,"ABDUCTOR",1,"Ecc03",3140,3140,3050,2700,3140,2875,0.084,265,3007.5,"Ecc",0,350,FALSE,FALSE,TRUE,9.22,"old",60,181,91,"m"
8,"ABDUCTOR",1,"Ecc04",3440,3420,3150,3400,3430,3275,0.045,155,3352.5,"Ecc",20,-250,FALSE,FALSE,FALSE,4.73,"old",60,181,91,"m"
8,"ABDUCTOR",1,"Ecc05",2900,2920,1750,2850,2910,2300,0.21,610,2605,"Ecc",-20,-1100,TRUE,FALSE,TRUE,26.52,"old",60,181,91,"m"
8,"ABDUCTOR",1,"Ecc06",3120,3120,2000,2800,3120,2400,0.231,720,2760,"Ecc",0,-800,TRUE,FALSE,TRUE,30,"old",60,181,91,"m"
8,"ABDUCTOR",1,"Ecc07",3120,3120,2850,1550,3120,2200,0.295,920,2660,"Ecc",0,1300,TRUE,FALSE,TRUE,41.82,"old",60,181,91,"m"
8,"ABDUCTOR",1,"Ecc08",2880,2900,2750,1900,2890,2325,0.196,565,2607.5,"Ecc",-20,850,TRUE,FALSE,TRUE,24.3,"old",60,181,91,"m"
8,"ABDUCTOR",1,"Ecc09",3060,3060,2900,1800,3060,2350,0.232,710,2705,"Ecc",0,1100,TRUE,FALSE,TRUE,30.21,"old",60,181,91,"m"
8,"ABDUCTOR",1,"Ecc10",2640,2620,2550,2600,2630,2575,0.021,55,2602.5,"Ecc",20,-50,FALSE,FALSE,FALSE,2.14,"old",60,181,91,"m"
8,"ABDUCTOR",2,"Ecc01",2740,2740,2350,2650,2740,2500,0.088,240,2620,"Ecc",0,-300,FALSE,FALSE,FALSE,9.6,"old",60,181,91,"m"
8,"ABDUCTOR",2,"Ecc02",2660,2700,2000,2250,2680,2125,0.207,555,2402.5,"Ecc",-40,-250,TRUE,TRUE,FALSE,26.12,"old",60,181,91,"m"
8,"ABDUCTOR",2,"Ecc03",3440,3440,2950,1850,3440,2400,0.302,1040,2920,"Ecc",0,1100,TRUE,FALSE,TRUE,43.33,"old",60,181,91,"m"
8,"ABDUCTOR",2,"Ecc04",3600,3600,3350,2200,3600,2775,0.229,825,3187.5,"Ecc",0,1150,TRUE,FALSE,TRUE,29.73,"old",60,181,91,"m"
8,"ABDUCTOR",2,"Ecc05",3720,3720,3600,3600,3720,3600,0.032,120,3660,"Ecc",0,0,FALSE,FALSE,FALSE,3.33,"old",60,181,91,"m"
8,"ABDUCTOR",2,"Ecc06",3200,3200,3100,3100,3200,3100,0.031,100,3150,"Ecc",0,0,FALSE,FALSE,FALSE,3.23,"old",60,181,91,"m"
8,"ABDUCTOR",2,"Ecc07",2800,2820,2500,2800,2810,2650,0.057,160,2730,"Ecc",-20,-300,FALSE,FALSE,FALSE,6.04,"old",60,181,91,"m"
8,"ABDUCTOR",2,"Ecc08",2840,2880,1750,2400,2860,2075,0.274,785,2467.5,"Ecc",-40,-650,TRUE,TRUE,TRUE,37.83,"old",60,181,91,"m"
8,"ABDUCTOR",2,"Ecc09",2600,2620,2250,2450,2610,2350,0.1,260,2480,"Ecc",-20,-200,FALSE,FALSE,FALSE,11.06,"old",60,181,91,"m"
8,"ABDUCTOR",2,"Ecc10",2200,2200,2200,2100,2200,2150,0.023,50,2175,"Ecc",0,100,FALSE,FALSE,FALSE,2.33,"old",60,181,91,"m"
8,"ABDUCTOR",1,"Rep01",4000,4000,3950,4350,4000,4150,0.038,-150,4075,"Rep",0,-400,FALSE,FALSE,TRUE,3.61,"old",60,181,91,"m"
8,"ABDUCTOR",1,"Rep02",3820,3800,4050,3800,3810,3925,0.03,-115,3867.5,"Rep",20,250,FALSE,FALSE,FALSE,2.93,"old",60,181,91,"m"
8,"ABDUCTOR",1,"Rep03",4160,4180,3950,3800,4170,3875,0.071,295,4022.5,"Rep",-20,150,TRUE,FALSE,FALSE,7.61,"old",60,181,91,"m"
8,"ABDUCTOR",1,"Rep04",4340,4340,4250,4700,4340,4475,0.031,-135,4407.5,"Rep",0,-450,FALSE,FALSE,TRUE,3.02,"old",60,181,91,"m"
8,"ABDUCTOR",1,"Rep05",3900,3920,3150,3850,3910,3500,0.105,410,3705,"Rep",-20,-700,TRUE,FALSE,TRUE,11.71,"old",60,181,91,"m"
8,"ABDUCTOR",1,"Rep06",4140,4120,4100,3850,4130,3975,0.038,155,4052.5,"Rep",20,250,FALSE,FALSE,FALSE,3.9,"old",60,181,91,"m"
8,"ABDUCTOR",1,"Rep07",4040,4040,4850,2950,4040,3900,0.035,140,3970,"Rep",0,1900,FALSE,FALSE,TRUE,3.59,"old",60,181,91,"m"
8,"ABDUCTOR",1,"Rep08",3880,3880,3950,4350,3880,4150,0.07,-270,4015,"Rep",0,-400,FALSE,FALSE,TRUE,6.51,"old",60,181,91,"m"
8,"ABDUCTOR",1,"Rep09",4080,4080,4050,3850,4080,3950,0.032,130,4015,"Rep",0,200,FALSE,FALSE,FALSE,3.29,"old",60,181,91,"m"
8,"ABDUCTOR",1,"Rep10",3660,3640,3750,4850,3650,4300,0.178,-650,3975,"Rep",20,-1100,TRUE,FALSE,TRUE,15.12,"old",60,181,91,"m"
8,"ABDUCTOR",2,"Rep01",3920,3920,3600,4000,3920,3800,0.031,120,3860,"Rep",0,-400,FALSE,FALSE,TRUE,3.16,"old",60,181,91,"m"
8,"ABDUCTOR",2,"Rep02",3700,3720,3600,3300,3710,3450,0.07,260,3580,"Rep",-20,300,FALSE,FALSE,FALSE,7.54,"old",60,181,91,"m"
8,"ABDUCTOR",2,"Rep03",4500,4480,4650,3400,4490,4025,0.104,465,4257.5,"Rep",20,1250,TRUE,FALSE,TRUE,11.55,"old",60,181,91,"m"
8,"ABDUCTOR",2,"Rep04",4540,4540,4750,4700,4540,4725,0.041,-185,4632.5,"Rep",0,50,FALSE,FALSE,FALSE,3.92,"old",60,181,91,"m"
8,"ABDUCTOR",2,"Rep05",4660,4660,4750,5900,4660,5325,0.143,-665,4992.5,"Rep",0,-1150,TRUE,FALSE,TRUE,12.49,"old",60,181,91,"m"
8,"ABDUCTOR",2,"Rep06",4200,4200,4200,4200,4200,4200,0,0,4200,"Rep",0,0,FALSE,FALSE,FALSE,0,"old",60,181,91,"m"
8,"ABDUCTOR",2,"Rep07",3840,3840,3650,3900,3840,3775,0.017,65,3807.5,"Rep",0,-250,FALSE,FALSE,FALSE,1.72,"old",60,181,91,"m"
8,"ABDUCTOR",2,"Rep08",3960,4000,3250,3600,3980,3425,0.139,555,3702.5,"Rep",-40,-350,TRUE,FALSE,TRUE,16.2,"old",60,181,91,"m"
8,"ABDUCTOR",2,"Rep09",3600,3560,4300,3900,3580,4100,0.145,-520,3840,"Rep",40,400,TRUE,FALSE,TRUE,12.68,"old",60,181,91,"m"
8,"ABDUCTOR",2,"Rep10",3320,3300,3650,3400,3310,3525,0.065,-215,3417.5,"Rep",20,250,FALSE,FALSE,FALSE,6.1,"old",60,181,91,"m"
8,"ABDUCTOR",1,"TuT",40020,40000,40050,40350,40010,40200,0.005,-190,40105,"TuT",20,-300,FALSE,FALSE,FALSE,0.47,"old",60,181,91,"m"
8,"ABDUCTOR",2,"TuT",40240,40220,40400,40300,40230,40350,0.003,-120,40290,"TuT",20,100,FALSE,FALSE,FALSE,0.3,"old",60,181,91,"m"
8,"ADDUCTOR",1,"Con01",1380,1380,1150,1100,1380,1125,0.185,255,1252.5,"Con",0,50,FALSE,FALSE,FALSE,22.67,"old",60,181,91,"m"
8,"ADDUCTOR",1,"Con02",1180,1180,1250,1300,1180,1275,0.081,-95,1227.5,"Con",0,-50,FALSE,FALSE,FALSE,7.45,"old",60,181,91,"m"
8,"ADDUCTOR",1,"Con03",940,960,1200,1200,950,1200,0.263,-250,1075,"Con",-20,0,FALSE,FALSE,FALSE,20.83,"old",60,181,91,"m"
8,"ADDUCTOR",1,"Con04",1180,1180,1550,1450,1180,1500,0.271,-320,1340,"Con",0,100,FALSE,FALSE,FALSE,21.33,"old",60,181,91,"m"
8,"ADDUCTOR",1,"Con05",1040,1060,1650,1400,1050,1525,0.452,-475,1287.5,"Con",-20,250,FALSE,FALSE,FALSE,31.15,"old",60,181,91,"m"
8,"ADDUCTOR",1,"Con06",1180,1160,1350,1250,1170,1300,0.111,-130,1235,"Con",20,100,FALSE,FALSE,FALSE,10,"old",60,181,91,"m"
8,"ADDUCTOR",1,"Con07",1140,1140,1200,1200,1140,1200,0.053,-60,1170,"Con",0,0,FALSE,FALSE,FALSE,5,"old",60,181,91,"m"
8,"ADDUCTOR",1,"Con08",1180,1140,1250,1400,1160,1325,0.142,-165,1242.5,"Con",40,-150,FALSE,TRUE,FALSE,12.45,"old",60,181,91,"m"
8,"ADDUCTOR",1,"Con09",1380,1360,1600,1550,1370,1575,0.15,-205,1472.5,"Con",20,50,FALSE,FALSE,FALSE,13.02,"old",60,181,91,"m"
8,"ADDUCTOR",1,"Con10",1120,1140,1500,1850,1130,1675,0.482,-545,1402.5,"Con",-20,-350,FALSE,FALSE,TRUE,32.54,"old",60,181,91,"m"
8,"ADDUCTOR",2,"Con01",1780,1740,1950,1900,1760,1925,0.094,-165,1842.5,"Con",40,50,FALSE,TRUE,FALSE,8.57,"old",60,181,91,"m"
8,"ADDUCTOR",2,"Con02",1320,1300,1400,1500,1310,1450,0.107,-140,1380,"Con",20,-100,FALSE,FALSE,FALSE,9.66,"old",60,181,91,"m"
8,"ADDUCTOR",2,"Con03",1260,1240,1350,1350,1250,1350,0.08,-100,1300,"Con",20,0,FALSE,FALSE,FALSE,7.41,"old",60,181,91,"m"
8,"ADDUCTOR",2,"Con04",940,900,1100,1100,920,1100,0.196,-180,1010,"Con",40,0,FALSE,TRUE,FALSE,16.36,"old",60,181,91,"m"
8,"ADDUCTOR",2,"Con05",1020,1000,1150,1050,1010,1100,0.089,-90,1055,"Con",20,100,FALSE,FALSE,FALSE,8.18,"old",60,181,91,"m"
8,"ADDUCTOR",2,"Con06",1100,1100,1200,1250,1100,1225,0.114,-125,1162.5,"Con",0,-50,FALSE,FALSE,FALSE,10.2,"old",60,181,91,"m"
8,"ADDUCTOR",2,"Con07",1040,1020,1200,1250,1030,1225,0.189,-195,1127.5,"Con",20,-50,FALSE,FALSE,FALSE,15.92,"old",60,181,91,"m"
8,"ADDUCTOR",2,"Con08",980,980,1250,1200,980,1225,0.25,-245,1102.5,"Con",0,50,FALSE,FALSE,FALSE,20,"old",60,181,91,"m"
8,"ADDUCTOR",2,"Con09",960,960,1500,1300,960,1400,0.458,-440,1180,"Con",0,200,FALSE,FALSE,FALSE,31.43,"old",60,181,91,"m"
8,"ADDUCTOR",2,"Con10",940,960,1950,2000,950,1975,1.079,-1025,1462.5,"Con",-20,-50,TRUE,FALSE,FALSE,51.9,"old",60,181,91,"m"
8,"ADDUCTOR",1,"Ecc01",2560,2560,2750,2750,2560,2750,0.074,-190,2655,"Ecc",0,0,FALSE,FALSE,FALSE,6.91,"old",60,181,91,"m"
8,"ADDUCTOR",1,"Ecc02",2920,2900,2750,2700,2910,2725,0.064,185,2817.5,"Ecc",20,50,FALSE,FALSE,FALSE,6.79,"old",60,181,91,"m"
8,"ADDUCTOR",1,"Ecc03",2520,2520,2100,2200,2520,2150,0.147,370,2335,"Ecc",0,-100,FALSE,FALSE,FALSE,17.21,"old",60,181,91,"m"
8,"ADDUCTOR",1,"Ecc04",2600,2580,2000,2250,2590,2125,0.18,465,2357.5,"Ecc",20,-250,FALSE,FALSE,FALSE,21.88,"old",60,181,91,"m"
8,"ADDUCTOR",1,"Ecc05",2560,2560,2300,2400,2560,2350,0.082,210,2455,"Ecc",0,-100,FALSE,FALSE,FALSE,8.94,"old",60,181,91,"m"
8,"ADDUCTOR",1,"Ecc06",2660,2680,2600,2600,2670,2600,0.026,70,2635,"Ecc",-20,0,FALSE,FALSE,FALSE,2.69,"old",60,181,91,"m"
8,"ADDUCTOR",1,"Ecc07",2420,2460,2350,2250,2440,2300,0.057,140,2370,"Ecc",-40,100,FALSE,TRUE,FALSE,6.09,"old",60,181,91,"m"
8,"ADDUCTOR",1,"Ecc08",2220,2240,2050,2050,2230,2050,0.081,180,2140,"Ecc",-20,0,FALSE,FALSE,FALSE,8.78,"old",60,181,91,"m"
8,"ADDUCTOR",1,"Ecc09",2480,2460,2200,1850,2470,2025,0.18,445,2247.5,"Ecc",20,350,FALSE,FALSE,TRUE,21.98,"old",60,181,91,"m"
8,"ADDUCTOR",1,"Ecc10",2800,2800,3600,3600,2800,3600,0.286,-800,3200,"Ecc",0,0,TRUE,FALSE,FALSE,22.22,"old",60,181,91,"m"
8,"ADDUCTOR",2,"Ecc01",2480,2500,2300,2250,2490,2275,0.086,215,2382.5,"Ecc",-20,50,FALSE,FALSE,FALSE,9.45,"old",60,181,91,"m"
8,"ADDUCTOR",2,"Ecc02",2160,2180,2050,2000,2170,2025,0.067,145,2097.5,"Ecc",-20,50,FALSE,FALSE,FALSE,7.16,"old",60,181,91,"m"
8,"ADDUCTOR",2,"Ecc03",2560,2580,2450,2450,2570,2450,0.047,120,2510,"Ecc",-20,0,FALSE,FALSE,FALSE,4.9,"old",60,181,91,"m"
8,"ADDUCTOR",2,"Ecc04",2640,2680,2500,2600,2660,2550,0.041,110,2605,"Ecc",-40,-100,FALSE,TRUE,FALSE,4.31,"old",60,181,91,"m"
8,"ADDUCTOR",2,"Ecc05",2360,2360,2200,2200,2360,2200,0.068,160,2280,"Ecc",0,0,FALSE,FALSE,FALSE,7.27,"old",60,181,91,"m"
8,"ADDUCTOR",2,"Ecc06",2100,2120,2000,1900,2110,1950,0.076,160,2030,"Ecc",-20,100,FALSE,FALSE,FALSE,8.21,"old",60,181,91,"m"
8,"ADDUCTOR",2,"Ecc07",2180,2200,1950,1950,2190,1950,0.11,240,2070,"Ecc",-20,0,FALSE,FALSE,FALSE,12.31,"old",60,181,91,"m"
8,"ADDUCTOR",2,"Ecc08",2260,2240,1700,1950,2250,1825,0.189,425,2037.5,"Ecc",20,-250,FALSE,FALSE,FALSE,23.29,"old",60,181,91,"m"
8,"ADDUCTOR",2,"Ecc09",2160,2160,1200,1200,2160,1200,0.444,960,1680,"Ecc",0,0,TRUE,FALSE,FALSE,80,"old",60,181,91,"m"
8,"ADDUCTOR",2,"Ecc10",2620,2580,2500,2500,2600,2500,0.038,100,2550,"Ecc",40,0,FALSE,TRUE,FALSE,4,"old",60,181,91,"m"
8,"ADDUCTOR",1,"Rep01",3940,3940,3900,3850,3940,3875,0.016,65,3907.5,"Rep",0,50,FALSE,FALSE,FALSE,1.68,"old",60,181,91,"m"
8,"ADDUCTOR",1,"Rep02",4100,4080,4000,4000,4090,4000,0.022,90,4045,"Rep",20,0,FALSE,FALSE,FALSE,2.25,"old",60,181,91,"m"
8,"ADDUCTOR",1,"Rep03",3460,3480,3300,3400,3470,3350,0.035,120,3410,"Rep",-20,-100,FALSE,FALSE,FALSE,3.58,"old",60,181,91,"m"
8,"ADDUCTOR",1,"Rep04",3780,3760,3550,3700,3770,3625,0.038,145,3697.5,"Rep",20,-150,FALSE,FALSE,FALSE,4,"old",60,181,91,"m"
8,"ADDUCTOR",1,"Rep05",3600,3620,3950,3800,3610,3875,0.073,-265,3742.5,"Rep",-20,150,FALSE,FALSE,FALSE,6.84,"old",60,181,91,"m"
8,"ADDUCTOR",1,"Rep06",3840,3840,3950,3850,3840,3900,0.016,-60,3870,"Rep",0,100,FALSE,FALSE,FALSE,1.54,"old",60,181,91,"m"
8,"ADDUCTOR",1,"Rep07",3560,3600,3550,3450,3580,3500,0.022,80,3540,"Rep",-40,100,FALSE,FALSE,FALSE,2.29,"old",60,181,91,"m"
8,"ADDUCTOR",1,"Rep08",3400,3380,3300,3450,3390,3375,0.004,15,3382.5,"Rep",20,-150,FALSE,FALSE,FALSE,0.44,"old",60,181,91,"m"
8,"ADDUCTOR",1,"Rep09",3860,3820,3800,3400,3840,3600,0.062,240,3720,"Rep",40,400,FALSE,FALSE,TRUE,6.67,"old",60,181,91,"m"
8,"ADDUCTOR",1,"Rep10",3920,3940,5100,5450,3930,5275,0.342,-1345,4602.5,"Rep",-20,-350,TRUE,FALSE,TRUE,25.5,"old",60,181,91,"m"
8,"ADDUCTOR",2,"Rep01",4260,4240,4250,4150,4250,4200,0.012,50,4225,"Rep",20,100,FALSE,FALSE,FALSE,1.19,"old",60,181,91,"m"
8,"ADDUCTOR",2,"Rep02",3480,3480,3450,3500,3480,3475,0.001,5,3477.5,"Rep",0,-50,FALSE,FALSE,FALSE,0.14,"old",60,181,91,"m"
8,"ADDUCTOR",2,"Rep03",3820,3820,3800,3800,3820,3800,0.005,20,3810,"Rep",0,0,FALSE,FALSE,FALSE,0.53,"old",60,181,91,"m"
8,"ADDUCTOR",2,"Rep04",3580,3580,3600,3700,3580,3650,0.02,-70,3615,"Rep",0,-100,FALSE,FALSE,FALSE,1.92,"old",60,181,91,"m"
8,"ADDUCTOR",2,"Rep05",3380,3360,3350,3250,3370,3300,0.021,70,3335,"Rep",20,100,FALSE,FALSE,FALSE,2.12,"old",60,181,91,"m"
8,"ADDUCTOR",2,"Rep06",3200,3220,3200,3150,3210,3175,0.011,35,3192.5,"Rep",-20,50,FALSE,FALSE,FALSE,1.1,"old",60,181,91,"m"
8,"ADDUCTOR",2,"Rep07",3220,3220,3150,3200,3220,3175,0.014,45,3197.5,"Rep",0,-50,FALSE,FALSE,FALSE,1.42,"old",60,181,91,"m"
8,"ADDUCTOR",2,"Rep08",3240,3220,2950,3150,3230,3050,0.056,180,3140,"Rep",20,-200,FALSE,FALSE,FALSE,5.9,"old",60,181,91,"m"
8,"ADDUCTOR",2,"Rep09",3120,3120,2700,2500,3120,2600,0.167,520,2860,"Rep",0,200,TRUE,FALSE,FALSE,20,"old",60,181,91,"m"
8,"ADDUCTOR",2,"Rep10",3560,3540,4450,4500,3550,4475,0.261,-925,4012.5,"Rep",20,-50,TRUE,FALSE,FALSE,20.67,"old",60,181,91,"m"
8,"ADDUCTOR",1,"TuT",37460,37460,38400,38350,37460,38375,0.024,-915,37917.5,"TuT",0,50,FALSE,FALSE,FALSE,2.38,"old",60,181,91,"m"
8,"ADDUCTOR",2,"TuT",34860,34800,34900,34900,34830,34900,0.002,-70,34865,"TuT",60,0,FALSE,TRUE,FALSE,0.2,"old",60,181,91,"m"
8,"LOWER BACK",1,"Con01",1680,1700,1900,1850,1690,1875,0.109,-185,1782.5,"Con",-20,50,FALSE,FALSE,FALSE,9.87,"old",60,181,91,"m"
8,"LOWER BACK",1,"Con02",1520,1540,1600,1600,1530,1600,0.046,-70,1565,"Con",-20,0,FALSE,FALSE,FALSE,4.38,"old",60,181,91,"m"
8,"LOWER BACK",1,"Con03",1540,1540,1650,1650,1540,1650,0.071,-110,1595,"Con",0,0,FALSE,FALSE,FALSE,6.67,"old",60,181,91,"m"
8,"LOWER BACK",1,"Con04",1600,1600,1700,1750,1600,1725,0.078,-125,1662.5,"Con",0,-50,FALSE,FALSE,FALSE,7.25,"old",60,181,91,"m"
8,"LOWER BACK",1,"Con05",1560,1540,1900,1600,1550,1750,0.129,-200,1650,"Con",20,300,TRUE,FALSE,TRUE,11.43,"old",60,181,91,"m"
8,"LOWER BACK",1,"Con06",1580,1560,2750,1700,1570,2225,0.417,-655,1897.5,"Con",20,1050,TRUE,FALSE,TRUE,29.44,"old",60,181,91,"m"
8,"LOWER BACK",1,"Con07",1580,1580,2250,1700,1580,1975,0.25,-395,1777.5,"Con",0,550,TRUE,FALSE,TRUE,20,"old",60,181,91,"m"
8,"LOWER BACK",1,"Con08",1660,1680,1800,1750,1670,1775,0.063,-105,1722.5,"Con",-20,50,FALSE,FALSE,FALSE,5.92,"old",60,181,91,"m"
8,"LOWER BACK",1,"Con09",1540,1580,1750,1900,1560,1825,0.17,-265,1692.5,"Con",-40,-150,TRUE,TRUE,FALSE,14.52,"old",60,181,91,"m"
8,"LOWER BACK",1,"Con10",1480,1480,1700,1950,1480,1825,0.233,-345,1652.5,"Con",0,-250,TRUE,FALSE,TRUE,18.9,"old",60,181,91,"m"
8,"LOWER BACK",2,"Con01",1340,1380,1550,1550,1360,1550,0.14,-190,1455,"Con",-40,0,TRUE,TRUE,FALSE,12.26,"old",60,181,91,"m"
8,"LOWER BACK",2,"Con02",1520,1500,1600,1450,1510,1525,0.01,-15,1517.5,"Con",20,150,FALSE,FALSE,FALSE,0.98,"old",60,181,91,"m"
8,"LOWER BACK",2,"Con03",1480,1520,1550,1450,1500,1500,0,0,1500,"Con",-40,100,FALSE,TRUE,FALSE,0,"old",60,181,91,"m"
8,"LOWER BACK",2,"Con04",1540,1560,1650,1550,1550,1600,0.032,-50,1575,"Con",-20,100,FALSE,FALSE,FALSE,3.12,"old",60,181,91,"m"
8,"LOWER BACK",2,"Con05",1540,1560,1950,1650,1550,1800,0.161,-250,1675,"Con",-20,300,TRUE,FALSE,TRUE,13.89,"old",60,181,91,"m"
8,"LOWER BACK",2,"Con06",1500,1520,1900,1700,1510,1800,0.192,-290,1655,"Con",-20,200,TRUE,FALSE,TRUE,16.11,"old",60,181,91,"m"
8,"LOWER BACK",2,"Con07",1500,1500,1650,1850,1500,1750,0.167,-250,1625,"Con",0,-200,TRUE,FALSE,TRUE,14.29,"old",60,181,91,"m"
8,"LOWER BACK",2,"Con08",1440,1460,1650,1600,1450,1625,0.121,-175,1537.5,"Con",-20,50,FALSE,FALSE,FALSE,10.77,"old",60,181,91,"m"
8,"LOWER BACK",2,"Con09",1460,1460,1700,1600,1460,1650,0.13,-190,1555,"Con",0,100,TRUE,FALSE,FALSE,11.52,"old",60,181,91,"m"
8,"LOWER BACK",2,"Con10",1420,1420,1650,1750,1420,1700,0.197,-280,1560,"Con",0,-100,TRUE,FALSE,FALSE,16.47,"old",60,181,91,"m"
8,"LOWER BACK",1,"Ecc01",3980,3940,3950,3900,3960,3925,0.009,35,3942.5,"Ecc",40,50,FALSE,FALSE,FALSE,0.89,"old",60,181,91,"m"
8,"LOWER BACK",1,"Ecc02",4040,4040,3950,3950,4040,3950,0.022,90,3995,"Ecc",0,0,FALSE,FALSE,FALSE,2.28,"old",60,181,91,"m"
8,"LOWER BACK",1,"Ecc03",4060,4080,3950,3950,4070,3950,0.029,120,4010,"Ecc",-20,0,FALSE,FALSE,FALSE,3.04,"old",60,181,91,"m"
8,"LOWER BACK",1,"Ecc04",4340,4340,4050,4200,4340,4125,0.05,215,4232.5,"Ecc",0,-150,TRUE,FALSE,FALSE,5.21,"old",60,181,91,"m"
8,"LOWER BACK",1,"Ecc05",4060,4060,2850,3950,4060,3400,0.163,660,3730,"Ecc",0,-1100,TRUE,FALSE,TRUE,19.41,"old",60,181,91,"m"
8,"LOWER BACK",1,"Ecc06",3340,3360,2650,3250,3350,2950,0.119,400,3150,"Ecc",-20,-600,TRUE,FALSE,TRUE,13.56,"old",60,181,91,"m"
8,"LOWER BACK",1,"Ecc07",3500,3480,3350,3450,3490,3400,0.026,90,3445,"Ecc",20,-100,FALSE,FALSE,FALSE,2.65,"old",60,181,91,"m"
8,"LOWER BACK",1,"Ecc08",3460,3420,3300,3150,3440,3225,0.062,215,3332.5,"Ecc",40,150,TRUE,FALSE,FALSE,6.67,"old",60,181,91,"m"
8,"LOWER BACK",1,"Ecc09",3620,3620,3400,3150,3620,3275,0.095,345,3447.5,"Ecc",0,250,TRUE,FALSE,TRUE,10.53,"old",60,181,91,"m"
8,"LOWER BACK",1,"Ecc10",3540,3540,3400,3450,3540,3425,0.032,115,3482.5,"Ecc",0,-50,FALSE,FALSE,FALSE,3.36,"old",60,181,91,"m"
8,"LOWER BACK",2,"Ecc01",2720,2720,2600,2750,2720,2675,0.017,45,2697.5,"Ecc",0,-150,FALSE,FALSE,FALSE,1.68,"old",60,181,91,"m"
8,"LOWER BACK",2,"Ecc02",3320,3300,3250,3350,3310,3300,0.003,10,3305,"Ecc",20,-100,FALSE,FALSE,FALSE,0.3,"old",60,181,91,"m"
8,"LOWER BACK",2,"Ecc03",3260,3240,3150,3250,3250,3200,0.015,50,3225,"Ecc",20,-100,FALSE,FALSE,FALSE,1.56,"old",60,181,91,"m"
8,"LOWER BACK",2,"Ecc04",3380,3360,3000,3300,3370,3150,0.065,220,3260,"Ecc",20,-300,TRUE,FALSE,TRUE,6.98,"old",60,181,91,"m"
8,"LOWER BACK",2,"Ecc05",3120,3100,2700,2950,3110,2825,0.092,285,2967.5,"Ecc",20,-250,TRUE,FALSE,TRUE,10.09,"old",60,181,91,"m"
8,"LOWER BACK",2,"Ecc06",3000,3000,2850,2700,3000,2775,0.075,225,2887.5,"Ecc",0,150,TRUE,FALSE,FALSE,8.11,"old",60,181,91,"m"
8,"LOWER BACK",2,"Ecc07",2980,2960,2800,2750,2970,2775,0.066,195,2872.5,"Ecc",20,50,TRUE,FALSE,FALSE,7.03,"old",60,181,91,"m"
8,"LOWER BACK",2,"Ecc08",3020,3000,2750,2900,3010,2825,0.061,185,2917.5,"Ecc",20,-150,TRUE,FALSE,FALSE,6.55,"old",60,181,91,"m"
8,"LOWER BACK",2,"Ecc09",3020,3020,2800,2750,3020,2775,0.081,245,2897.5,"Ecc",0,50,TRUE,FALSE,FALSE,8.83,"old",60,181,91,"m"
8,"LOWER BACK",2,"Ecc10",3040,3020,5500,2950,3030,4225,0.394,-1195,3627.5,"Ecc",20,2550,TRUE,FALSE,TRUE,28.28,"old",60,181,91,"m"
8,"LOWER BACK",1,"Rep01",5660,5640,5850,5750,5650,5800,0.027,-150,5725,"Rep",20,100,TRUE,FALSE,FALSE,2.59,"old",60,181,91,"m"
8,"LOWER BACK",1,"Rep02",5560,5580,5550,5550,5570,5550,0.004,20,5560,"Rep",-20,0,FALSE,FALSE,FALSE,0.36,"old",60,181,91,"m"
8,"LOWER BACK",1,"Rep03",5600,5620,5600,5600,5610,5600,0.002,10,5605,"Rep",-20,0,FALSE,FALSE,FALSE,0.18,"old",60,181,91,"m"
8,"LOWER BACK",1,"Rep04",5940,5940,5750,5950,5940,5850,0.015,90,5895,"Rep",0,-200,FALSE,FALSE,TRUE,1.54,"old",60,181,91,"m"
8,"LOWER BACK",1,"Rep05",5620,5600,4750,5550,5610,5150,0.082,460,5380,"Rep",20,-800,TRUE,FALSE,TRUE,8.93,"old",60,181,91,"m"
8,"LOWER BACK",1,"Rep06",4920,4920,5400,4950,4920,5175,0.052,-255,5047.5,"Rep",0,450,TRUE,FALSE,TRUE,4.93,"old",60,181,91,"m"
8,"LOWER BACK",1,"Rep07",5080,5060,5600,5150,5070,5375,0.06,-305,5222.5,"Rep",20,450,TRUE,FALSE,TRUE,5.67,"old",60,181,91,"m"
8,"LOWER BACK",1,"Rep08",5120,5100,5100,4900,5110,5000,0.022,110,5055,"Rep",20,200,TRUE,FALSE,TRUE,2.2,"old",60,181,91,"m"
8,"LOWER BACK",1,"Rep09",5160,5200,5150,5050,5180,5100,0.015,80,5140,"Rep",-40,100,FALSE,FALSE,FALSE,1.57,"old",60,181,91,"m"
8,"LOWER BACK",1,"Rep10",5020,5020,5100,5400,5020,5250,0.046,-230,5135,"Rep",0,-300,TRUE,FALSE,TRUE,4.38,"old",60,181,91,"m"
8,"LOWER BACK",2,"Rep01",4060,4100,4150,4300,4080,4225,0.036,-145,4152.5,"Rep",-40,-150,TRUE,FALSE,FALSE,3.43,"old",60,181,91,"m"
8,"LOWER BACK",2,"Rep02",4840,4800,4850,4800,4820,4825,0.001,-5,4822.5,"Rep",40,50,FALSE,FALSE,FALSE,0.1,"old",60,181,91,"m"
8,"LOWER BACK",2,"Rep03",4740,4760,4700,4700,4750,4700,0.011,50,4725,"Rep",-20,0,FALSE,FALSE,FALSE,1.06,"old",60,181,91,"m"
8,"LOWER BACK",2,"Rep04",4920,4920,4650,4850,4920,4750,0.035,170,4835,"Rep",0,-200,TRUE,FALSE,TRUE,3.58,"old",60,181,91,"m"
8,"LOWER BACK",2,"Rep05",4660,4660,4650,4600,4660,4625,0.008,35,4642.5,"Rep",0,50,FALSE,FALSE,FALSE,0.76,"old",60,181,91,"m"
8,"LOWER BACK",2,"Rep06",4500,4520,4750,4400,4510,4575,0.014,-65,4542.5,"Rep",-20,350,FALSE,FALSE,TRUE,1.42,"old",60,181,91,"m"
8,"LOWER BACK",2,"Rep07",4480,4460,4450,4600,4470,4525,0.012,-55,4497.5,"Rep",20,-150,FALSE,FALSE,FALSE,1.22,"old",60,181,91,"m"
8,"LOWER BACK",2,"Rep08",4460,4460,4400,4500,4460,4450,0.002,10,4455,"Rep",0,-100,FALSE,FALSE,FALSE,0.22,"old",60,181,91,"m"
8,"LOWER BACK",2,"Rep09",4480,4480,4500,4350,4480,4425,0.012,55,4452.5,"Rep",0,150,FALSE,FALSE,FALSE,1.24,"old",60,181,91,"m"
8,"LOWER BACK",2,"Rep10",4460,4440,7150,4700,4450,5925,0.331,-1475,5187.5,"Rep",20,2450,TRUE,FALSE,TRUE,24.89,"old",60,181,91,"m"
8,"LOWER BACK",1,"TuT",53680,53680,53850,53850,53680,53850,0.003,-170,53765,"TuT",0,0,FALSE,FALSE,FALSE,0.32,"old",60,181,91,"m"
8,"LOWER BACK",2,"TuT",45600,45600,48250,45800,45600,47025,0.031,-1425,46312.5,"TuT",0,2450,TRUE,FALSE,TRUE,3.03,"old",60,181,91,"m"
8,"TOTAL ABDOMINAL",1,"Con01",1360,1380,1550,1650,1370,1600,0.168,-230,1485,"Con",-20,-100,TRUE,FALSE,FALSE,14.37,"old",60,181,91,"m"
8,"TOTAL ABDOMINAL",1,"Con02",1260,1300,1200,1350,1280,1275,0.004,5,1277.5,"Con",-40,-150,FALSE,TRUE,FALSE,0.39,"old",60,181,91,"m"
8,"TOTAL ABDOMINAL",1,"Con03",1240,1260,1250,1300,1250,1275,0.02,-25,1262.5,"Con",-20,-50,FALSE,FALSE,FALSE,1.96,"old",60,181,91,"m"
8,"TOTAL ABDOMINAL",1,"Con04",1260,1280,1300,1400,1270,1350,0.063,-80,1310,"Con",-20,-100,FALSE,FALSE,FALSE,5.93,"old",60,181,91,"m"
8,"TOTAL ABDOMINAL",1,"Con05",1240,1240,1300,1500,1240,1400,0.129,-160,1320,"Con",0,-200,TRUE,FALSE,TRUE,11.43,"old",60,181,91,"m"
8,"TOTAL ABDOMINAL",1,"Con06",1280,1300,1300,1350,1290,1325,0.027,-35,1307.5,"Con",-20,-50,FALSE,FALSE,FALSE,2.64,"old",60,181,91,"m"
8,"TOTAL ABDOMINAL",1,"Con07",1260,1280,1400,1400,1270,1400,0.102,-130,1335,"Con",-20,0,FALSE,FALSE,FALSE,9.29,"old",60,181,91,"m"
8,"TOTAL ABDOMINAL",1,"Con08",1340,1380,1600,1450,1360,1525,0.121,-165,1442.5,"Con",-40,150,TRUE,TRUE,FALSE,10.82,"old",60,181,91,"m"
8,"TOTAL ABDOMINAL",1,"Con09",1260,1240,1850,1400,1250,1625,0.3,-375,1437.5,"Con",20,450,TRUE,FALSE,TRUE,23.08,"old",60,181,91,"m"
8,"TOTAL ABDOMINAL",1,"Con10",1200,1240,1450,1500,1220,1475,0.209,-255,1347.5,"Con",-40,-50,TRUE,TRUE,FALSE,17.29,"old",60,181,91,"m"
8,"TOTAL ABDOMINAL",2,"Con01",1300,1280,1350,1400,1290,1375,0.066,-85,1332.5,"Con",20,-50,FALSE,FALSE,FALSE,6.18,"old",60,181,91,"m"
8,"TOTAL ABDOMINAL",2,"Con02",1300,1320,1250,1300,1310,1275,0.027,35,1292.5,"Con",-20,-50,FALSE,FALSE,FALSE,2.75,"old",60,181,91,"m"
8,"TOTAL ABDOMINAL",2,"Con03",1260,1240,1300,1350,1250,1325,0.06,-75,1287.5,"Con",20,-50,FALSE,FALSE,FALSE,5.66,"old",60,181,91,"m"
8,"TOTAL ABDOMINAL",2,"Con04",1160,1180,1300,1350,1170,1325,0.132,-155,1247.5,"Con",-20,-50,TRUE,FALSE,FALSE,11.7,"old",60,181,91,"m"
8,"TOTAL ABDOMINAL",2,"Con05",1220,1260,1350,1250,1240,1300,0.048,-60,1270,"Con",-40,100,FALSE,TRUE,FALSE,4.62,"old",60,181,91,"m"
8,"TOTAL ABDOMINAL",2,"Con06",1200,1200,1350,1300,1200,1325,0.104,-125,1262.5,"Con",0,50,FALSE,FALSE,FALSE,9.43,"old",60,181,91,"m"
8,"TOTAL ABDOMINAL",2,"Con07",1240,1260,1350,1350,1250,1350,0.08,-100,1300,"Con",-20,0,FALSE,FALSE,FALSE,7.41,"old",60,181,91,"m"
8,"TOTAL ABDOMINAL",2,"Con08",1180,1200,1300,1300,1190,1300,0.092,-110,1245,"Con",-20,0,FALSE,FALSE,FALSE,8.46,"old",60,181,91,"m"
8,"TOTAL ABDOMINAL",2,"Con09",1240,1240,1300,1400,1240,1350,0.089,-110,1295,"Con",0,-100,FALSE,FALSE,FALSE,8.15,"old",60,181,91,"m"
8,"TOTAL ABDOMINAL",2,"Con10",1120,1140,1250,1400,1130,1325,0.173,-195,1227.5,"Con",-20,-150,TRUE,FALSE,FALSE,14.72,"old",60,181,91,"m"
8,"TOTAL ABDOMINAL",1,"Ecc01",2180,2140,2200,2100,2160,2150,0.005,10,2155,"Ecc",40,100,FALSE,TRUE,FALSE,0.47,"old",60,181,91,"m"
8,"TOTAL ABDOMINAL",1,"Ecc02",2740,2720,2750,2650,2730,2700,0.011,30,2715,"Ecc",20,100,FALSE,FALSE,FALSE,1.11,"old",60,181,91,"m"
8,"TOTAL ABDOMINAL",1,"Ecc03",2680,2640,2650,2600,2660,2625,0.013,35,2642.5,"Ecc",40,50,FALSE,TRUE,FALSE,1.33,"old",60,181,91,"m"
8,"TOTAL ABDOMINAL",1,"Ecc04",2880,2880,2800,2600,2880,2700,0.062,180,2790,"Ecc",0,200,TRUE,FALSE,TRUE,6.67,"old",60,181,91,"m"
8,"TOTAL ABDOMINAL",1,"Ecc05",2700,2680,2700,2600,2690,2650,0.015,40,2670,"Ecc",20,100,FALSE,FALSE,FALSE,1.51,"old",60,181,91,"m"
8,"TOTAL ABDOMINAL",1,"Ecc06",2480,2480,2350,2350,2480,2350,0.052,130,2415,"Ecc",0,0,FALSE,FALSE,FALSE,5.53,"old",60,181,91,"m"
8,"TOTAL ABDOMINAL",1,"Ecc07",2240,2200,2050,2150,2220,2100,0.054,120,2160,"Ecc",40,-100,FALSE,TRUE,FALSE,5.71,"old",60,181,91,"m"
8,"TOTAL ABDOMINAL",1,"Ecc08",2360,2380,1750,2200,2370,1975,0.167,395,2172.5,"Ecc",-20,-450,TRUE,FALSE,TRUE,20,"old",60,181,91,"m"
8,"TOTAL ABDOMINAL",1,"Ecc09",2560,2520,2250,2300,2540,2275,0.104,265,2407.5,"Ecc",40,-50,TRUE,TRUE,FALSE,11.65,"old",60,181,91,"m"
8,"TOTAL ABDOMINAL",1,"Ecc10",2920,2920,2900,2900,2920,2900,0.007,20,2910,"Ecc",0,0,FALSE,FALSE,FALSE,0.69,"old",60,181,91,"m"
8,"TOTAL ABDOMINAL",2,"Ecc01",2440,2440,2450,2400,2440,2425,0.006,15,2432.5,"Ecc",0,50,FALSE,FALSE,FALSE,0.62,"old",60,181,91,"m"
8,"TOTAL ABDOMINAL",2,"Ecc02",2640,2640,2650,2550,2640,2600,0.015,40,2620,"Ecc",0,100,FALSE,FALSE,FALSE,1.54,"old",60,181,91,"m"
8,"TOTAL ABDOMINAL",2,"Ecc03",2700,2700,2550,2500,2700,2525,0.065,175,2612.5,"Ecc",0,50,TRUE,FALSE,FALSE,6.93,"old",60,181,91,"m"
8,"TOTAL ABDOMINAL",2,"Ecc04",2480,2440,2350,2450,2460,2400,0.024,60,2430,"Ecc",40,-100,FALSE,TRUE,FALSE,2.5,"old",60,181,91,"m"
8,"TOTAL ABDOMINAL",2,"Ecc05",3060,3060,2950,3000,3060,2975,0.028,85,3017.5,"Ecc",0,-50,FALSE,FALSE,FALSE,2.86,"old",60,181,91,"m"
8,"TOTAL ABDOMINAL",2,"Ecc06",2500,2500,2350,2350,2500,2350,0.06,150,2425,"Ecc",0,0,TRUE,FALSE,FALSE,6.38,"old",60,181,91,"m"
8,"TOTAL ABDOMINAL",2,"Ecc07",2780,2740,2650,2700,2760,2675,0.031,85,2717.5,"Ecc",40,-50,FALSE,TRUE,FALSE,3.18,"old",60,181,91,"m"
8,"TOTAL ABDOMINAL",2,"Ecc08",2420,2420,2350,2250,2420,2300,0.05,120,2360,"Ecc",0,100,FALSE,FALSE,FALSE,5.22,"old",60,181,91,"m"
8,"TOTAL ABDOMINAL",2,"Ecc09",2820,2800,2750,2600,2810,2675,0.048,135,2742.5,"Ecc",20,150,FALSE,FALSE,FALSE,5.05,"old",60,181,91,"m"
8,"TOTAL ABDOMINAL",2,"Ecc10",3500,3500,3500,3500,3500,3500,0,0,3500,"Ecc",0,0,FALSE,FALSE,FALSE,0,"old",60,181,91,"m"
8,"TOTAL ABDOMINAL",1,"Rep01",3540,3520,3750,3750,3530,3750,0.062,-220,3640,"Rep",20,0,TRUE,FALSE,FALSE,5.87,"old",60,181,91,"m"
8,"TOTAL ABDOMINAL",1,"Rep02",4000,4020,3950,4000,4010,3975,0.009,35,3992.5,"Rep",-20,-50,FALSE,FALSE,FALSE,0.88,"old",60,181,91,"m"
8,"TOTAL ABDOMINAL",1,"Rep03",3920,3900,3900,3900,3910,3900,0.003,10,3905,"Rep",20,0,FALSE,FALSE,FALSE,0.26,"old",60,181,91,"m"
8,"TOTAL ABDOMINAL",1,"Rep04",4140,4160,4100,4000,4150,4050,0.024,100,4100,"Rep",-20,100,FALSE,FALSE,FALSE,2.47,"old",60,181,91,"m"
8,"TOTAL ABDOMINAL",1,"Rep05",3940,3920,4000,4100,3930,4050,0.031,-120,3990,"Rep",20,-100,FALSE,FALSE,FALSE,2.96,"old",60,181,91,"m"
8,"TOTAL ABDOMINAL",1,"Rep06",3760,3780,3650,3700,3770,3675,0.025,95,3722.5,"Rep",-20,-50,FALSE,FALSE,FALSE,2.59,"old",60,181,91,"m"
8,"TOTAL ABDOMINAL",1,"Rep07",3500,3480,3450,3550,3490,3500,0.003,-10,3495,"Rep",20,-100,FALSE,FALSE,FALSE,0.29,"old",60,181,91,"m"
8,"TOTAL ABDOMINAL",1,"Rep08",3700,3760,3350,3650,3730,3500,0.062,230,3615,"Rep",-60,-300,TRUE,FALSE,TRUE,6.57,"old",60,181,91,"m"
8,"TOTAL ABDOMINAL",1,"Rep09",3820,3760,4100,3700,3790,3900,0.029,-110,3845,"Rep",60,400,FALSE,FALSE,TRUE,2.82,"old",60,181,91,"m"
8,"TOTAL ABDOMINAL",1,"Rep10",4120,4160,4350,4400,4140,4375,0.057,-235,4257.5,"Rep",-40,-50,TRUE,FALSE,FALSE,5.37,"old",60,181,91,"m"
8,"TOTAL ABDOMINAL",2,"Rep01",3740,3720,3800,3800,3730,3800,0.019,-70,3765,"Rep",20,0,FALSE,FALSE,FALSE,1.84,"old",60,181,91,"m"
8,"TOTAL ABDOMINAL",2,"Rep02",3940,3960,3900,3850,3950,3875,0.019,75,3912.5,"Rep",-20,50,FALSE,FALSE,FALSE,1.94,"old",60,181,91,"m"
8,"TOTAL ABDOMINAL",2,"Rep03",3960,3940,3850,3850,3950,3850,0.025,100,3900,"Rep",20,0,FALSE,FALSE,FALSE,2.6,"old",60,181,91,"m"
8,"TOTAL ABDOMINAL",2,"Rep04",3640,3620,3650,3800,3630,3725,0.026,-95,3677.5,"Rep",20,-150,FALSE,FALSE,FALSE,2.55,"old",60,181,91,"m"
8,"TOTAL ABDOMINAL",2,"Rep05",4280,4320,4300,4250,4300,4275,0.006,25,4287.5,"Rep",-40,50,FALSE,FALSE,FALSE,0.58,"old",60,181,91,"m"
8,"TOTAL ABDOMINAL",2,"Rep06",3700,3700,3700,3650,3700,3675,0.007,25,3687.5,"Rep",0,50,FALSE,FALSE,FALSE,0.68,"old",60,181,91,"m"
8,"TOTAL ABDOMINAL",2,"Rep07",4020,4000,4000,4050,4010,4025,0.004,-15,4017.5,"Rep",20,-50,FALSE,FALSE,FALSE,0.37,"old",60,181,91,"m"
8,"TOTAL ABDOMINAL",2,"Rep08",3600,3620,3650,3550,3610,3600,0.003,10,3605,"Rep",-20,100,FALSE,FALSE,FALSE,0.28,"old",60,181,91,"m"
8,"TOTAL ABDOMINAL",2,"Rep09",4060,4040,4050,4000,4050,4025,0.006,25,4037.5,"Rep",20,50,FALSE,FALSE,FALSE,0.62,"old",60,181,91,"m"
8,"TOTAL ABDOMINAL",2,"Rep10",4620,4640,4750,4900,4630,4825,0.042,-195,4727.5,"Rep",-20,-150,TRUE,FALSE,FALSE,4.04,"old",60,181,91,"m"
8,"TOTAL ABDOMINAL",1,"TuT",38440,38460,38600,38750,38450,38675,0.006,-225,38562.5,"TuT",-20,-150,TRUE,FALSE,FALSE,0.58,"old",60,181,91,"m"
8,"TOTAL ABDOMINAL",2,"TuT",39560,39560,39650,39700,39560,39675,0.003,-115,39617.5,"TuT",0,-50,FALSE,FALSE,FALSE,0.29,"old",60,181,91,"m"
8,"VERTICAL TRACTION",1,"Con01",2120,2140,5650,5550,2130,5600,1.629,-3470,3865,"Con",-20,100,TRUE,FALSE,FALSE,61.96,"old",60,181,91,"m"
8,"VERTICAL TRACTION",1,"Con02",1680,1660,2000,2100,1670,2050,0.228,-380,1860,"Con",20,-100,TRUE,FALSE,FALSE,18.54,"old",60,181,91,"m"
8,"VERTICAL TRACTION",1,"Con03",1480,1480,1800,1800,1480,1800,0.216,-320,1640,"Con",0,0,TRUE,FALSE,FALSE,17.78,"old",60,181,91,"m"
8,"VERTICAL TRACTION",1,"Con04",1340,1280,1700,1500,1310,1600,0.221,-290,1455,"Con",60,200,TRUE,FALSE,TRUE,18.12,"old",60,181,91,"m"
8,"VERTICAL TRACTION",1,"Con05",1520,1500,1650,1500,1510,1575,0.043,-65,1542.5,"Con",20,150,FALSE,FALSE,FALSE,4.13,"old",60,181,91,"m"
8,"VERTICAL TRACTION",1,"Con06",1440,1480,1600,1650,1460,1625,0.113,-165,1542.5,"Con",-40,-50,FALSE,FALSE,FALSE,10.15,"old",60,181,91,"m"
8,"VERTICAL TRACTION",1,"Con07",1460,1460,1700,1750,1460,1725,0.182,-265,1592.5,"Con",0,-50,FALSE,FALSE,FALSE,15.36,"old",60,181,91,"m"
8,"VERTICAL TRACTION",1,"Con08",1580,1580,1850,1800,1580,1825,0.155,-245,1702.5,"Con",0,50,FALSE,FALSE,FALSE,13.42,"old",60,181,91,"m"
8,"VERTICAL TRACTION",1,"Con09",1480,1500,1950,2450,1490,2200,0.477,-710,1845,"Con",-20,-500,TRUE,FALSE,TRUE,32.27,"old",60,181,91,"m"
8,"VERTICAL TRACTION",1,"Con10",1500,1460,2450,2650,1480,2550,0.723,-1070,2015,"Con",40,-200,TRUE,FALSE,TRUE,41.96,"old",60,181,91,"m"
8,"VERTICAL TRACTION",2,"Con01",1420,1380,2150,2000,1400,2075,0.482,-675,1737.5,"Con",40,150,TRUE,FALSE,FALSE,32.53,"old",60,181,91,"m"
8,"VERTICAL TRACTION",2,"Con02",1560,1560,1750,1750,1560,1750,0.122,-190,1655,"Con",0,0,FALSE,FALSE,FALSE,10.86,"old",60,181,91,"m"
8,"VERTICAL TRACTION",2,"Con03",1640,1620,1600,1650,1630,1625,0.003,5,1627.5,"Con",20,-50,FALSE,FALSE,FALSE,0.31,"old",60,181,91,"m"
8,"VERTICAL TRACTION",2,"Con04",1320,1320,1500,1450,1320,1475,0.117,-155,1397.5,"Con",0,50,FALSE,FALSE,FALSE,10.51,"old",60,181,91,"m"
8,"VERTICAL TRACTION",2,"Con05",1260,1280,1550,1600,1270,1575,0.24,-305,1422.5,"Con",-20,-50,TRUE,FALSE,FALSE,19.37,"old",60,181,91,"m"
8,"VERTICAL TRACTION",2,"Con06",1440,1420,1500,1550,1430,1525,0.066,-95,1477.5,"Con",20,-50,FALSE,FALSE,FALSE,6.23,"old",60,181,91,"m"
8,"VERTICAL TRACTION",2,"Con07",1400,1420,1450,1700,1410,1575,0.117,-165,1492.5,"Con",-20,-250,FALSE,FALSE,TRUE,10.48,"old",60,181,91,"m"
8,"VERTICAL TRACTION",2,"Con08",1320,1280,1650,1550,1300,1600,0.231,-300,1450,"Con",40,100,TRUE,FALSE,FALSE,18.75,"old",60,181,91,"m"
8,"VERTICAL TRACTION",2,"Con09",1280,1280,1750,1500,1280,1625,0.27,-345,1452.5,"Con",0,250,TRUE,FALSE,TRUE,21.23,"old",60,181,91,"m"
8,"VERTICAL TRACTION",2,"Con10",1320,1320,1950,1650,1320,1800,0.364,-480,1560,"Con",0,300,TRUE,FALSE,TRUE,26.67,"old",60,181,91,"m"
8,"VERTICAL TRACTION",1,"Ecc01",3200,3240,2900,2800,3220,2850,0.115,370,3035,"Ecc",-40,100,TRUE,FALSE,FALSE,12.98,"old",60,181,91,"m"
8,"VERTICAL TRACTION",1,"Ecc02",3480,3460,3200,3200,3470,3200,0.078,270,3335,"Ecc",20,0,TRUE,FALSE,FALSE,8.44,"old",60,181,91,"m"
8,"VERTICAL TRACTION",1,"Ecc03",3280,3320,2950,3100,3300,3025,0.083,275,3162.5,"Ecc",-40,-150,TRUE,FALSE,FALSE,9.09,"old",60,181,91,"m"
8,"VERTICAL TRACTION",1,"Ecc04",3340,3360,3150,3300,3350,3225,0.037,125,3287.5,"Ecc",-20,-150,FALSE,FALSE,FALSE,3.88,"old",60,181,91,"m"
8,"VERTICAL TRACTION",1,"Ecc05",3260,3240,3100,3150,3250,3125,0.038,125,3187.5,"Ecc",20,-50,FALSE,FALSE,FALSE,4,"old",60,181,91,"m"
8,"VERTICAL TRACTION",1,"Ecc06",3380,3380,3150,3050,3380,3100,0.083,280,3240,"Ecc",0,100,TRUE,FALSE,FALSE,9.03,"old",60,181,91,"m"
8,"VERTICAL TRACTION",1,"Ecc07",3220,3220,2950,3050,3220,3000,0.068,220,3110,"Ecc",0,-100,FALSE,FALSE,FALSE,7.33,"old",60,181,91,"m"
8,"VERTICAL TRACTION",1,"Ecc08",3240,3220,2800,2600,3230,2700,0.164,530,2965,"Ecc",20,200,TRUE,FALSE,TRUE,19.63,"old",60,181,91,"m"
8,"VERTICAL TRACTION",1,"Ecc09",3380,3400,3000,2350,3390,2675,0.211,715,3032.5,"Ecc",-20,650,TRUE,FALSE,TRUE,26.73,"old",60,181,91,"m"
8,"VERTICAL TRACTION",1,"Ecc10",3440,3440,2750,2900,3440,2825,0.179,615,3132.5,"Ecc",0,-150,TRUE,FALSE,FALSE,21.77,"old",60,181,91,"m"
8,"VERTICAL TRACTION",2,"Ecc01",2820,2820,2500,2550,2820,2525,0.105,295,2672.5,"Ecc",0,-50,TRUE,FALSE,FALSE,11.68,"old",60,181,91,"m"
8,"VERTICAL TRACTION",2,"Ecc02",2880,2900,2900,2850,2890,2875,0.005,15,2882.5,"Ecc",-20,50,FALSE,FALSE,FALSE,0.52,"old",60,181,91,"m"
8,"VERTICAL TRACTION",2,"Ecc03",2940,2940,2800,2800,2940,2800,0.048,140,2870,"Ecc",0,0,FALSE,FALSE,FALSE,5,"old",60,181,91,"m"
8,"VERTICAL TRACTION",2,"Ecc04",3180,3160,2900,2900,3170,2900,0.085,270,3035,"Ecc",20,0,TRUE,FALSE,FALSE,9.31,"old",60,181,91,"m"
8,"VERTICAL TRACTION",2,"Ecc05",2860,2860,2750,2700,2860,2725,0.047,135,2792.5,"Ecc",0,50,FALSE,FALSE,FALSE,4.95,"old",60,181,91,"m"
8,"VERTICAL TRACTION",2,"Ecc06",2820,2820,2750,2550,2820,2650,0.06,170,2735,"Ecc",0,200,FALSE,FALSE,TRUE,6.42,"old",60,181,91,"m"
8,"VERTICAL TRACTION",2,"Ecc07",2840,2880,2700,2600,2860,2650,0.073,210,2755,"Ecc",-40,100,FALSE,FALSE,FALSE,7.92,"old",60,181,91,"m"
8,"VERTICAL TRACTION",2,"Ecc08",2940,2940,2400,2700,2940,2550,0.133,390,2745,"Ecc",0,-300,TRUE,FALSE,TRUE,15.29,"old",60,181,91,"m"
8,"VERTICAL TRACTION",2,"Ecc09",2920,2920,2300,2650,2920,2475,0.152,445,2697.5,"Ecc",0,-350,TRUE,FALSE,TRUE,17.98,"old",60,181,91,"m"
8,"VERTICAL TRACTION",2,"Ecc10",3860,3860,3750,4750,3860,4250,0.101,-390,4055,"Ecc",0,-1000,TRUE,FALSE,TRUE,9.18,"old",60,181,91,"m"
8,"VERTICAL TRACTION",1,"Rep01",5320,5380,8550,8350,5350,8450,0.579,-3100,6900,"Rep",-60,200,TRUE,FALSE,TRUE,36.69,"old",60,181,91,"m"
8,"VERTICAL TRACTION",1,"Rep02",5160,5120,5200,5300,5140,5250,0.021,-110,5195,"Rep",40,-100,FALSE,FALSE,FALSE,2.1,"old",60,181,91,"m"
8,"VERTICAL TRACTION",1,"Rep03",4760,4800,4750,4900,4780,4825,0.009,-45,4802.5,"Rep",-40,-150,FALSE,FALSE,FALSE,0.93,"old",60,181,91,"m"
8,"VERTICAL TRACTION",1,"Rep04",4680,4640,4850,4800,4660,4825,0.035,-165,4742.5,"Rep",40,50,TRUE,FALSE,FALSE,3.42,"old",60,181,91,"m"
8,"VERTICAL TRACTION",1,"Rep05",4780,4740,4750,4650,4760,4700,0.013,60,4730,"Rep",40,100,FALSE,FALSE,FALSE,1.28,"old",60,181,91,"m"
8,"VERTICAL TRACTION",1,"Rep06",4820,4860,4750,4700,4840,4725,0.024,115,4782.5,"Rep",-40,50,FALSE,FALSE,FALSE,2.43,"old",60,181,91,"m"
8,"VERTICAL TRACTION",1,"Rep07",4680,4680,4650,4800,4680,4725,0.01,-45,4702.5,"Rep",0,-150,FALSE,FALSE,FALSE,0.95,"old",60,181,91,"m"
8,"VERTICAL TRACTION",1,"Rep08",4820,4800,4650,4400,4810,4525,0.059,285,4667.5,"Rep",20,250,TRUE,FALSE,TRUE,6.3,"old",60,181,91,"m"
8,"VERTICAL TRACTION",1,"Rep09",4860,4900,4950,4800,4880,4875,0.001,5,4877.5,"Rep",-40,150,FALSE,FALSE,FALSE,0.1,"old",60,181,91,"m"
8,"VERTICAL TRACTION",1,"Rep10",4940,4900,5200,5550,4920,5375,0.092,-455,5147.5,"Rep",40,-350,TRUE,FALSE,TRUE,8.47,"old",60,181,91,"m"
8,"VERTICAL TRACTION",2,"Rep01",4240,4200,4650,4550,4220,4600,0.09,-380,4410,"Rep",40,100,TRUE,FALSE,FALSE,8.26,"old",60,181,91,"m"
8,"VERTICAL TRACTION",2,"Rep02",4440,4460,4650,4600,4450,4625,0.039,-175,4537.5,"Rep",-20,50,TRUE,FALSE,FALSE,3.78,"old",60,181,91,"m"
8,"VERTICAL TRACTION",2,"Rep03",4580,4560,4400,4450,4570,4425,0.032,145,4497.5,"Rep",20,-50,TRUE,FALSE,FALSE,3.28,"old",60,181,91,"m"
8,"VERTICAL TRACTION",2,"Rep04",4500,4480,4400,4350,4490,4375,0.026,115,4432.5,"Rep",20,50,FALSE,FALSE,FALSE,2.63,"old",60,181,91,"m"
8,"VERTICAL TRACTION",2,"Rep05",4120,4140,4300,4300,4130,4300,0.041,-170,4215,"Rep",-20,0,TRUE,FALSE,FALSE,3.95,"old",60,181,91,"m"
8,"VERTICAL TRACTION",2,"Rep06",4260,4240,4250,4100,4250,4175,0.018,75,4212.5,"Rep",20,150,FALSE,FALSE,FALSE,1.8,"old",60,181,91,"m"
8,"VERTICAL TRACTION",2,"Rep07",4240,4300,4150,4300,4270,4225,0.011,45,4247.5,"Rep",-60,-150,FALSE,FALSE,FALSE,1.07,"old",60,181,91,"m"
8,"VERTICAL TRACTION",2,"Rep08",4260,4220,4050,4250,4240,4150,0.021,90,4195,"Rep",40,-200,FALSE,FALSE,TRUE,2.17,"old",60,181,91,"m"
8,"VERTICAL TRACTION",2,"Rep09",4200,4200,4050,4150,4200,4100,0.024,100,4150,"Rep",0,-100,FALSE,FALSE,FALSE,2.44,"old",60,181,91,"m"
8,"VERTICAL TRACTION",2,"Rep10",5180,5180,5700,6400,5180,6050,0.168,-870,5615,"Rep",0,-700,TRUE,FALSE,TRUE,14.38,"old",60,181,91,"m"
8,"VERTICAL TRACTION",1,"TuT",48820,48820,52300,52250,48820,52275,0.071,-3455,50547.5,"TuT",0,50,TRUE,FALSE,FALSE,6.61,"old",60,181,91,"m"
8,"VERTICAL TRACTION",2,"TuT",44020,43980,44600,45450,44000,45025,0.023,-1025,44512.5,"TuT",40,-850,FALSE,FALSE,FALSE,2.28,"old",60,181,91,"m"
8,"CHEST PRESS",1,"Con01",2160,2140,2100,2100,2150,2100,0.023,50,2125,"Con",20,0,FALSE,FALSE,FALSE,2.38,"old",60,181,91,"m"
8,"CHEST PRESS",1,"Con02",2000,2020,2000,2200,2010,2100,0.045,-90,2055,"Con",-20,-200,FALSE,FALSE,FALSE,4.29,"old",60,181,91,"m"
8,"CHEST PRESS",1,"Con03",1700,1700,1850,1800,1700,1825,0.074,-125,1762.5,"Con",0,50,FALSE,FALSE,FALSE,6.85,"old",60,181,91,"m"
8,"CHEST PRESS",1,"Con04",1760,1780,1950,1850,1770,1900,0.073,-130,1835,"Con",-20,100,FALSE,FALSE,FALSE,6.84,"old",60,181,91,"m"
8,"CHEST PRESS",1,"Con05",1640,1640,1900,1800,1640,1850,0.128,-210,1745,"Con",0,100,FALSE,FALSE,FALSE,11.35,"old",60,181,91,"m"
8,"CHEST PRESS",1,"Con06",1620,1660,1950,1900,1640,1925,0.174,-285,1782.5,"Con",-40,50,FALSE,TRUE,FALSE,14.81,"old",60,181,91,"m"
8,"CHEST PRESS",1,"Con07",1800,1780,2000,2000,1790,2000,0.117,-210,1895,"Con",20,0,FALSE,FALSE,FALSE,10.5,"old",60,181,91,"m"
8,"CHEST PRESS",1,"Con08",1820,1800,1950,1950,1810,1950,0.077,-140,1880,"Con",20,0,FALSE,FALSE,FALSE,7.18,"old",60,181,91,"m"
8,"CHEST PRESS",1,"Con09",1700,1680,1700,1750,1690,1725,0.021,-35,1707.5,"Con",20,-50,FALSE,FALSE,FALSE,2.03,"old",60,181,91,"m"
8,"CHEST PRESS",1,"Con10",1620,1600,1600,1750,1610,1675,0.04,-65,1642.5,"Con",20,-150,FALSE,FALSE,FALSE,3.88,"old",60,181,91,"m"
8,"CHEST PRESS",2,"Con01",1760,1720,1700,1550,1740,1625,0.066,115,1682.5,"Con",40,150,FALSE,TRUE,FALSE,7.08,"old",60,181,91,"m"
8,"CHEST PRESS",2,"Con02",1740,1740,1750,1750,1740,1750,0.006,-10,1745,"Con",0,0,FALSE,FALSE,FALSE,0.57,"old",60,181,91,"m"
8,"CHEST PRESS",2,"Con03",1640,1620,1700,1600,1630,1650,0.012,-20,1640,"Con",20,100,FALSE,FALSE,FALSE,1.21,"old",60,181,91,"m"
8,"CHEST PRESS",2,"Con04",1580,1560,1700,1600,1570,1650,0.051,-80,1610,"Con",20,100,FALSE,FALSE,FALSE,4.85,"old",60,181,91,"m"
8,"CHEST PRESS",2,"Con05",1620,1620,1950,1650,1620,1800,0.111,-180,1710,"Con",0,300,FALSE,FALSE,FALSE,10,"old",60,181,91,"m"
8,"CHEST PRESS",2,"Con06",1680,1680,1850,1750,1680,1800,0.071,-120,1740,"Con",0,100,FALSE,FALSE,FALSE,6.67,"old",60,181,91,"m"
8,"CHEST PRESS",2,"Con07",1540,1560,1700,1750,1550,1725,0.113,-175,1637.5,"Con",-20,-50,FALSE,FALSE,FALSE,10.14,"old",60,181,91,"m"
8,"CHEST PRESS",2,"Con08",1660,1680,1850,2000,1670,1925,0.153,-255,1797.5,"Con",-20,-150,FALSE,FALSE,FALSE,13.25,"old",60,181,91,"m"
8,"CHEST PRESS",2,"Con09",1560,1600,1750,2000,1580,1875,0.187,-295,1727.5,"Con",-40,-250,FALSE,TRUE,FALSE,15.73,"old",60,181,91,"m"
8,"CHEST PRESS",2,"Con10",1700,1740,1800,2250,1720,2025,0.177,-305,1872.5,"Con",-40,-450,FALSE,TRUE,TRUE,15.06,"old",60,181,91,"m"
8,"CHEST PRESS",1,"Ecc01",3040,3040,3050,2950,3040,3000,0.013,40,3020,"Ecc",0,100,FALSE,FALSE,FALSE,1.33,"old",60,181,91,"m"
8,"CHEST PRESS",1,"Ecc02",3200,3200,3150,3100,3200,3125,0.023,75,3162.5,"Ecc",0,50,FALSE,FALSE,FALSE,2.4,"old",60,181,91,"m"
8,"CHEST PRESS",1,"Ecc03",3120,3120,2950,3050,3120,3000,0.038,120,3060,"Ecc",0,-100,FALSE,FALSE,FALSE,4,"old",60,181,91,"m"
8,"CHEST PRESS",1,"Ecc04",2860,2840,2600,2700,2850,2650,0.07,200,2750,"Ecc",20,-100,FALSE,FALSE,FALSE,7.55,"old",60,181,91,"m"
8,"CHEST PRESS",1,"Ecc05",2900,2880,2650,2700,2890,2675,0.074,215,2782.5,"Ecc",20,-50,FALSE,FALSE,FALSE,8.04,"old",60,181,91,"m"
8,"CHEST PRESS",1,"Ecc06",2920,2900,2600,2650,2910,2625,0.098,285,2767.5,"Ecc",20,-50,FALSE,FALSE,FALSE,10.86,"old",60,181,91,"m"
8,"CHEST PRESS",1,"Ecc07",2740,2780,2650,2600,2760,2625,0.049,135,2692.5,"Ecc",-40,50,FALSE,TRUE,FALSE,5.14,"old",60,181,91,"m"
8,"CHEST PRESS",1,"Ecc08",2540,2540,2450,2450,2540,2450,0.035,90,2495,"Ecc",0,0,FALSE,FALSE,FALSE,3.67,"old",60,181,91,"m"
8,"CHEST PRESS",1,"Ecc09",2720,2760,2800,2750,2740,2775,0.013,-35,2757.5,"Ecc",-40,50,FALSE,TRUE,FALSE,1.26,"old",60,181,91,"m"
8,"CHEST PRESS",1,"Ecc10",6360,2860,4250,4100,4610,4175,0.094,435,4392.5,"Ecc",3500,150,TRUE,TRUE,FALSE,10.42,"old",60,181,91,"m"
8,"CHEST PRESS",2,"Ecc01",2460,2440,2450,2500,2450,2475,0.01,-25,2462.5,"Ecc",20,-50,FALSE,FALSE,FALSE,1.01,"old",60,181,91,"m"
8,"CHEST PRESS",2,"Ecc02",2620,2660,2600,2650,2640,2625,0.006,15,2632.5,"Ecc",-40,-50,FALSE,TRUE,FALSE,0.57,"old",60,181,91,"m"
8,"CHEST PRESS",2,"Ecc03",2700,2720,2650,2750,2710,2700,0.004,10,2705,"Ecc",-20,-100,FALSE,FALSE,FALSE,0.37,"old",60,181,91,"m"
8,"CHEST PRESS",2,"Ecc04",2820,2820,2500,2750,2820,2625,0.069,195,2722.5,"Ecc",0,-250,FALSE,FALSE,TRUE,7.43,"old",60,181,91,"m"
8,"CHEST PRESS",2,"Ecc05",2440,2420,2150,2300,2430,2225,0.084,205,2327.5,"Ecc",20,-150,FALSE,FALSE,FALSE,9.21,"old",60,181,91,"m"
8,"CHEST PRESS",2,"Ecc06",2100,2100,2050,2100,2100,2075,0.012,25,2087.5,"Ecc",0,-50,FALSE,FALSE,FALSE,1.2,"old",60,181,91,"m"
8,"CHEST PRESS",2,"Ecc07",2400,2400,2200,2050,2400,2125,0.115,275,2262.5,"Ecc",0,150,FALSE,FALSE,FALSE,12.94,"old",60,181,91,"m"
8,"CHEST PRESS",2,"Ecc08",2440,2400,2250,2050,2420,2150,0.112,270,2285,"Ecc",40,200,FALSE,TRUE,FALSE,12.56,"old",60,181,91,"m"
8,"CHEST PRESS",2,"Ecc09",2720,2680,2600,2250,2700,2425,0.102,275,2562.5,"Ecc",40,350,FALSE,TRUE,TRUE,11.34,"old",60,181,91,"m"
8,"CHEST PRESS",2,"Ecc10",2980,2980,4800,7500,2980,6150,1.064,-3170,4565,"Ecc",0,-2700,TRUE,FALSE,TRUE,51.54,"old",60,181,91,"m"
8,"CHEST PRESS",1,"Rep01",5200,5180,5150,5050,5190,5100,0.017,90,5145,"Rep",20,100,FALSE,FALSE,FALSE,1.76,"old",60,181,91,"m"
8,"CHEST PRESS",1,"Rep02",5200,5220,5150,5300,5210,5225,0.003,-15,5217.5,"Rep",-20,-150,FALSE,FALSE,FALSE,0.29,"old",60,181,91,"m"
8,"CHEST PRESS",1,"Rep03",4820,4820,4800,4850,4820,4825,0.001,-5,4822.5,"Rep",0,-50,FALSE,FALSE,FALSE,0.1,"old",60,181,91,"m"
8,"CHEST PRESS",1,"Rep04",4620,4620,4550,4550,4620,4550,0.015,70,4585,"Rep",0,0,FALSE,FALSE,FALSE,1.54,"old",60,181,91,"m"
8,"CHEST PRESS",1,"Rep05",4540,4520,4550,4500,4530,4525,0.001,5,4527.5,"Rep",20,50,FALSE,FALSE,FALSE,0.11,"old",60,181,91,"m"
8,"CHEST PRESS",1,"Rep06",4540,4560,4550,4550,4550,4550,0,0,4550,"Rep",-20,0,FALSE,FALSE,FALSE,0,"old",60,181,91,"m"
8,"CHEST PRESS",1,"Rep07",4540,4560,4650,4600,4550,4625,0.016,-75,4587.5,"Rep",-20,50,FALSE,FALSE,FALSE,1.62,"old",60,181,91,"m"
8,"CHEST PRESS",1,"Rep08",4360,4340,4400,4400,4350,4400,0.011,-50,4375,"Rep",20,0,FALSE,FALSE,FALSE,1.14,"old",60,181,91,"m"
8,"CHEST PRESS",1,"Rep09",4420,4440,4500,4500,4430,4500,0.016,-70,4465,"Rep",-20,0,FALSE,FALSE,FALSE,1.56,"old",60,181,91,"m"
8,"CHEST PRESS",1,"Rep10",7980,4460,5850,5850,6220,5850,0.059,370,6035,"Rep",3520,0,TRUE,TRUE,FALSE,6.32,"old",60,181,91,"m"
8,"CHEST PRESS",2,"Rep01",4220,4160,4150,4050,4190,4100,0.021,90,4145,"Rep",60,100,FALSE,FALSE,FALSE,2.2,"old",60,181,91,"m"
8,"CHEST PRESS",2,"Rep02",4360,4400,4350,4400,4380,4375,0.001,5,4377.5,"Rep",-40,-50,FALSE,FALSE,FALSE,0.11,"old",60,181,91,"m"
8,"CHEST PRESS",2,"Rep03",4340,4340,4350,4350,4340,4350,0.002,-10,4345,"Rep",0,0,FALSE,FALSE,FALSE,0.23,"old",60,181,91,"m"
8,"CHEST PRESS",2,"Rep04",4400,4380,4200,4350,4390,4275,0.026,115,4332.5,"Rep",20,-150,FALSE,FALSE,FALSE,2.69,"old",60,181,91,"m"
8,"CHEST PRESS",2,"Rep05",4060,4040,4100,3950,4050,4025,0.006,25,4037.5,"Rep",20,150,FALSE,FALSE,FALSE,0.62,"old",60,181,91,"m"
8,"CHEST PRESS",2,"Rep06",3780,3780,3900,3850,3780,3875,0.025,-95,3827.5,"Rep",0,50,FALSE,FALSE,FALSE,2.45,"old",60,181,91,"m"
8,"CHEST PRESS",2,"Rep07",3940,3960,3900,3800,3950,3850,0.025,100,3900,"Rep",-20,100,FALSE,FALSE,FALSE,2.6,"old",60,181,91,"m"
8,"CHEST PRESS",2,"Rep08",4100,4080,4100,4050,4090,4075,0.004,15,4082.5,"Rep",20,50,FALSE,FALSE,FALSE,0.37,"old",60,181,91,"m"
8,"CHEST PRESS",2,"Rep09",4280,4280,4350,4250,4280,4300,0.005,-20,4290,"Rep",0,100,FALSE,FALSE,FALSE,0.47,"old",60,181,91,"m"
8,"CHEST PRESS",2,"Rep10",4680,4720,6600,9750,4700,8175,0.739,-3475,6437.5,"Rep",-40,-3150,TRUE,FALSE,TRUE,42.51,"old",60,181,91,"m"
8,"CHEST PRESS",1,"TuT",50220,46720,48150,48150,48470,48150,0.007,320,48310,"TuT",3500,0,FALSE,TRUE,FALSE,0.66,"old",60,181,91,"m"
8,"CHEST PRESS",2,"TuT",42160,42140,44000,46800,42150,45400,0.077,-3250,43775,"TuT",20,-2800,TRUE,FALSE,TRUE,7.16,"old",60,181,91,"m"
9,"LEG PRESS",1,"Con01",1160,1160,2200,1300,1160,1750,0.509,-590,1455,"Con",0,900,TRUE,FALSE,TRUE,33.71,"young",31,178,92,"m"
9,"LEG PRESS",1,"Con02",1200,1220,2150,2000,1210,2075,0.715,-865,1642.5,"Con",-20,150,TRUE,FALSE,FALSE,41.69,"young",31,178,92,"m"
9,"LEG PRESS",1,"Con03",1060,1080,2000,1900,1070,1950,0.822,-880,1510,"Con",-20,100,TRUE,FALSE,FALSE,45.13,"young",31,178,92,"m"
9,"LEG PRESS",1,"Con04",1160,1180,1200,1250,1170,1225,0.047,-55,1197.5,"Con",-20,-50,FALSE,FALSE,FALSE,4.49,"young",31,178,92,"m"
9,"LEG PRESS",1,"Con05",1080,1080,1000,1000,1080,1000,0.074,80,1040,"Con",0,0,FALSE,FALSE,FALSE,8,"young",31,178,92,"m"
9,"LEG PRESS",1,"Con06",1120,1120,1300,1900,1120,1600,0.429,-480,1360,"Con",0,-600,TRUE,FALSE,TRUE,30,"young",31,178,92,"m"
9,"LEG PRESS",1,"Con07",1220,1220,1300,1350,1220,1325,0.086,-105,1272.5,"Con",0,-50,FALSE,FALSE,FALSE,7.92,"young",31,178,92,"m"
9,"LEG PRESS",1,"Con08",1340,1340,1450,1450,1340,1450,0.082,-110,1395,"Con",0,0,FALSE,FALSE,FALSE,7.59,"young",31,178,92,"m"
9,"LEG PRESS",1,"Con09",1140,1180,1200,1300,1160,1250,0.078,-90,1205,"Con",-40,-100,FALSE,FALSE,FALSE,7.2,"young",31,178,92,"m"
9,"LEG PRESS",1,"Con10",1120,1140,1900,1900,1130,1900,0.681,-770,1515,"Con",-20,0,TRUE,FALSE,FALSE,40.53,"young",31,178,92,"m"
9,"LEG PRESS",2,"Con01",920,940,1150,1100,930,1125,0.21,-195,1027.5,"Con",-20,50,FALSE,FALSE,FALSE,17.33,"young",31,178,92,"m"
9,"LEG PRESS",2,"Con02",1040,1040,1300,1650,1040,1475,0.418,-435,1257.5,"Con",0,-350,TRUE,FALSE,TRUE,29.49,"young",31,178,92,"m"
9,"LEG PRESS",2,"Con03",1140,1140,1850,1950,1140,1900,0.667,-760,1520,"Con",0,-100,TRUE,FALSE,FALSE,40,"young",31,178,92,"m"
9,"LEG PRESS",2,"Con04",1120,1160,1200,1250,1140,1225,0.075,-85,1182.5,"Con",-40,-50,FALSE,FALSE,FALSE,6.94,"young",31,178,92,"m"
9,"LEG PRESS",2,"Con05",1080,1100,1100,1000,1090,1050,0.037,40,1070,"Con",-20,100,FALSE,FALSE,FALSE,3.81,"young",31,178,92,"m"
9,"LEG PRESS",2,"Con06",1020,1020,1200,1150,1020,1175,0.152,-155,1097.5,"Con",0,50,FALSE,FALSE,FALSE,13.19,"young",31,178,92,"m"
9,"LEG PRESS",2,"Con07",960,960,1150,1150,960,1150,0.198,-190,1055,"Con",0,0,FALSE,FALSE,FALSE,16.52,"young",31,178,92,"m"
9,"LEG PRESS",2,"Con08",1040,1060,1950,2050,1050,2000,0.905,-950,1525,"Con",-20,-100,TRUE,FALSE,FALSE,47.5,"young",31,178,92,"m"
9,"LEG PRESS",2,"Con09",1020,1040,1150,1200,1030,1175,0.141,-145,1102.5,"Con",-20,-50,FALSE,FALSE,FALSE,12.34,"young",31,178,92,"m"
9,"LEG PRESS",2,"Con10",1060,1060,2050,2050,1060,2050,0.934,-990,1555,"Con",0,0,TRUE,FALSE,FALSE,48.29,"young",31,178,92,"m"
9,"LEG PRESS",1,"Ecc01",2920,2920,1850,2750,2920,2300,0.212,620,2610,"Ecc",0,-900,TRUE,FALSE,TRUE,26.96,"young",31,178,92,"m"
9,"LEG PRESS",1,"Ecc02",2540,2540,1550,1650,2540,1600,0.37,940,2070,"Ecc",0,-100,TRUE,FALSE,FALSE,58.75,"young",31,178,92,"m"
9,"LEG PRESS",1,"Ecc03",2400,2360,1650,1700,2380,1675,0.296,705,2027.5,"Ecc",40,-50,TRUE,FALSE,FALSE,42.09,"young",31,178,92,"m"
9,"LEG PRESS",1,"Ecc04",2340,2340,2350,2350,2340,2350,0.004,-10,2345,"Ecc",0,0,FALSE,FALSE,FALSE,0.43,"young",31,178,92,"m"
9,"LEG PRESS",1,"Ecc05",2580,2580,2600,2550,2580,2575,0.002,5,2577.5,"Ecc",0,50,FALSE,FALSE,FALSE,0.19,"young",31,178,92,"m"
9,"LEG PRESS",1,"Ecc06",2980,2980,2800,2200,2980,2500,0.161,480,2740,"Ecc",0,600,TRUE,FALSE,TRUE,19.2,"young",31,178,92,"m"
9,"LEG PRESS",1,"Ecc07",2740,2740,2650,2650,2740,2650,0.033,90,2695,"Ecc",0,0,FALSE,FALSE,FALSE,3.4,"young",31,178,92,"m"
9,"LEG PRESS",1,"Ecc08",2740,2720,2650,2600,2730,2625,0.038,105,2677.5,"Ecc",20,50,FALSE,FALSE,FALSE,4,"young",31,178,92,"m"
9,"LEG PRESS",1,"Ecc09",2920,2880,2800,2700,2900,2750,0.052,150,2825,"Ecc",40,100,FALSE,FALSE,FALSE,5.45,"young",31,178,92,"m"
9,"LEG PRESS",1,"Ecc10",2420,2420,1750,1750,2420,1750,0.277,670,2085,"Ecc",0,0,TRUE,FALSE,FALSE,38.29,"young",31,178,92,"m"
9,"LEG PRESS",2,"Ecc01",2900,2900,2700,2800,2900,2750,0.052,150,2825,"Ecc",0,-100,FALSE,FALSE,FALSE,5.45,"young",31,178,92,"m"
9,"LEG PRESS",2,"Ecc02",2380,2380,2150,1650,2380,1900,0.202,480,2140,"Ecc",0,500,TRUE,FALSE,TRUE,25.26,"young",31,178,92,"m"
9,"LEG PRESS",2,"Ecc03",2440,2400,1800,1750,2420,1775,0.267,645,2097.5,"Ecc",40,50,TRUE,FALSE,FALSE,36.34,"young",31,178,92,"m"
9,"LEG PRESS",2,"Ecc04",2700,2700,2650,2650,2700,2650,0.019,50,2675,"Ecc",0,0,FALSE,FALSE,FALSE,1.89,"young",31,178,92,"m"
9,"LEG PRESS",2,"Ecc05",2720,2700,2600,2700,2710,2650,0.022,60,2680,"Ecc",20,-100,FALSE,FALSE,FALSE,2.26,"young",31,178,92,"m"
9,"LEG PRESS",2,"Ecc06",2540,2540,2350,2400,2540,2375,0.065,165,2457.5,"Ecc",0,-50,FALSE,FALSE,FALSE,6.95,"young",31,178,92,"m"
9,"LEG PRESS",2,"Ecc07",2640,2620,2450,2400,2630,2425,0.078,205,2527.5,"Ecc",20,50,FALSE,FALSE,FALSE,8.45,"young",31,178,92,"m"
9,"LEG PRESS",2,"Ecc08",2480,2460,1600,1500,2470,1550,0.372,920,2010,"Ecc",20,100,TRUE,FALSE,FALSE,59.35,"young",31,178,92,"m"
9,"LEG PRESS",2,"Ecc09",2560,2560,2400,2400,2560,2400,0.062,160,2480,"Ecc",0,0,FALSE,FALSE,FALSE,6.67,"young",31,178,92,"m"
9,"LEG PRESS",2,"Ecc10",2540,2540,1700,1600,2540,1650,0.35,890,2095,"Ecc",0,100,TRUE,FALSE,FALSE,53.94,"young",31,178,92,"m"
9,"LEG PRESS",1,"Rep01",4080,4080,4050,4050,4080,4050,0.007,30,4065,"Rep",0,0,FALSE,FALSE,FALSE,0.74,"young",31,178,92,"m"
9,"LEG PRESS",1,"Rep02",3740,3760,3700,3650,3750,3675,0.02,75,3712.5,"Rep",-20,50,FALSE,FALSE,FALSE,2.04,"young",31,178,92,"m"
9,"LEG PRESS",1,"Rep03",3460,3440,3650,3600,3450,3625,0.051,-175,3537.5,"Rep",20,50,TRUE,FALSE,FALSE,4.83,"young",31,178,92,"m"
9,"LEG PRESS",1,"Rep04",3500,3520,3550,3600,3510,3575,0.019,-65,3542.5,"Rep",-20,-50,FALSE,FALSE,FALSE,1.82,"young",31,178,92,"m"
9,"LEG PRESS",1,"Rep05",3660,3660,3600,3550,3660,3575,0.023,85,3617.5,"Rep",0,50,FALSE,FALSE,FALSE,2.38,"young",31,178,92,"m"
9,"LEG PRESS",1,"Rep06",4100,4100,4100,4100,4100,4100,0,0,4100,"Rep",0,0,FALSE,FALSE,FALSE,0,"young",31,178,92,"m"
9,"LEG PRESS",1,"Rep07",3960,3960,3950,4000,3960,3975,0.004,-15,3967.5,"Rep",0,-50,FALSE,FALSE,FALSE,0.38,"young",31,178,92,"m"
9,"LEG PRESS",1,"Rep08",4080,4060,4100,4050,4070,4075,0.001,-5,4072.5,"Rep",20,50,FALSE,FALSE,FALSE,0.12,"young",31,178,92,"m"
9,"LEG PRESS",1,"Rep09",4060,4060,4000,4000,4060,4000,0.015,60,4030,"Rep",0,0,FALSE,FALSE,FALSE,1.5,"young",31,178,92,"m"
9,"LEG PRESS",1,"Rep10",3540,3560,3650,3650,3550,3650,0.028,-100,3600,"Rep",-20,0,FALSE,FALSE,FALSE,2.74,"young",31,178,92,"m"
9,"LEG PRESS",2,"Rep01",3820,3840,3850,3900,3830,3875,0.012,-45,3852.5,"Rep",-20,-50,FALSE,FALSE,FALSE,1.16,"young",31,178,92,"m"
9,"LEG PRESS",2,"Rep02",3420,3420,3450,3300,3420,3375,0.013,45,3397.5,"Rep",0,150,FALSE,FALSE,TRUE,1.33,"young",31,178,92,"m"
9,"LEG PRESS",2,"Rep03",3580,3540,3650,3700,3560,3675,0.032,-115,3617.5,"Rep",40,-50,TRUE,FALSE,FALSE,3.13,"young",31,178,92,"m"
9,"LEG PRESS",2,"Rep04",3820,3860,3850,3900,3840,3875,0.009,-35,3857.5,"Rep",-40,-50,FALSE,FALSE,FALSE,0.9,"young",31,178,92,"m"
9,"LEG PRESS",2,"Rep05",3800,3800,3700,3700,3800,3700,0.026,100,3750,"Rep",0,0,FALSE,FALSE,FALSE,2.7,"young",31,178,92,"m"
9,"LEG PRESS",2,"Rep06",3560,3560,3550,3550,3560,3550,0.003,10,3555,"Rep",0,0,FALSE,FALSE,FALSE,0.28,"young",31,178,92,"m"
9,"LEG PRESS",2,"Rep07",3600,3580,3600,3550,3590,3575,0.004,15,3582.5,"Rep",20,50,FALSE,FALSE,FALSE,0.42,"young",31,178,92,"m"
9,"LEG PRESS",2,"Rep08",3520,3520,3550,3550,3520,3550,0.009,-30,3535,"Rep",0,0,FALSE,FALSE,FALSE,0.85,"young",31,178,92,"m"
9,"LEG PRESS",2,"Rep09",3580,3600,3550,3600,3590,3575,0.004,15,3582.5,"Rep",-20,-50,FALSE,FALSE,FALSE,0.42,"young",31,178,92,"m"
9,"LEG PRESS",2,"Rep10",3600,3600,3750,3650,3600,3700,0.028,-100,3650,"Rep",0,100,FALSE,FALSE,TRUE,2.7,"young",31,178,92,"m"
9,"LEG PRESS",1,"TuT",38180,38200,38350,38250,38190,38300,0.003,-110,38245,"TuT",-20,100,FALSE,FALSE,FALSE,0.29,"young",31,178,92,"m"
9,"LEG PRESS",2,"TuT",36300,36320,36500,36400,36310,36450,0.004,-140,36380,"TuT",-20,100,FALSE,FALSE,FALSE,0.38,"young",31,178,92,"m"
9,"LEG EXTENSION",1,"Con01",1020,1000,1200,1200,1010,1200,0.188,-190,1105,"Con",20,0,TRUE,FALSE,FALSE,15.83,"young",31,178,92,"m"
9,"LEG EXTENSION",1,"Con02",1300,1280,1350,1300,1290,1325,0.027,-35,1307.5,"Con",20,50,FALSE,FALSE,FALSE,2.64,"young",31,178,92,"m"
9,"LEG EXTENSION",1,"Con03",1320,1360,1400,1400,1340,1400,0.045,-60,1370,"Con",-40,0,FALSE,TRUE,FALSE,4.29,"young",31,178,92,"m"
9,"LEG EXTENSION",1,"Con04",1600,1600,1700,1750,1600,1725,0.078,-125,1662.5,"Con",0,-50,FALSE,FALSE,FALSE,7.25,"young",31,178,92,"m"
9,"LEG EXTENSION",1,"Con05",1440,1460,1450,1450,1450,1450,0,0,1450,"Con",-20,0,FALSE,FALSE,FALSE,0,"young",31,178,92,"m"
9,"LEG EXTENSION",1,"Con06",1260,1260,1350,1250,1260,1300,0.032,-40,1280,"Con",0,100,FALSE,FALSE,FALSE,3.08,"young",31,178,92,"m"
9,"LEG EXTENSION",1,"Con07",1320,1340,1300,1300,1330,1300,0.023,30,1315,"Con",-20,0,FALSE,FALSE,FALSE,2.31,"young",31,178,92,"m"
9,"LEG EXTENSION",1,"Con08",1200,1220,1350,1450,1210,1400,0.157,-190,1305,"Con",-20,-100,TRUE,FALSE,FALSE,13.57,"young",31,178,92,"m"
9,"LEG EXTENSION",1,"Con09",1320,1340,1550,1500,1330,1525,0.147,-195,1427.5,"Con",-20,50,TRUE,FALSE,FALSE,12.79,"young",31,178,92,"m"
9,"LEG EXTENSION",1,"Con10",1360,1400,1950,2000,1380,1975,0.431,-595,1677.5,"Con",-40,-50,TRUE,TRUE,FALSE,30.13,"young",31,178,92,"m"
9,"LEG EXTENSION",2,"Con01",860,880,1100,1150,870,1125,0.293,-255,997.5,"Con",-20,-50,TRUE,FALSE,FALSE,22.67,"young",31,178,92,"m"
9,"LEG EXTENSION",2,"Con02",1160,1160,1250,1300,1160,1275,0.099,-115,1217.5,"Con",0,-50,FALSE,FALSE,FALSE,9.02,"young",31,178,92,"m"
9,"LEG EXTENSION",2,"Con03",1200,1200,1350,1250,1200,1300,0.083,-100,1250,"Con",0,100,FALSE,FALSE,FALSE,7.69,"young",31,178,92,"m"
9,"LEG EXTENSION",2,"Con04",1480,1480,1650,1500,1480,1575,0.064,-95,1527.5,"Con",0,150,FALSE,FALSE,FALSE,6.03,"young",31,178,92,"m"
9,"LEG EXTENSION",2,"Con05",1300,1320,1250,1150,1310,1200,0.084,110,1255,"Con",-20,100,FALSE,FALSE,FALSE,9.17,"young",31,178,92,"m"
9,"LEG EXTENSION",2,"Con06",1160,1160,1250,1250,1160,1250,0.078,-90,1205,"Con",0,0,FALSE,FALSE,FALSE,7.2,"young",31,178,92,"m"
9,"LEG EXTENSION",2,"Con07",1260,1300,1300,1450,1280,1375,0.074,-95,1327.5,"Con",-40,-150,FALSE,TRUE,FALSE,6.91,"young",31,178,92,"m"
9,"LEG EXTENSION",2,"Con08",1180,1180,1350,1500,1180,1425,0.208,-245,1302.5,"Con",0,-150,TRUE,FALSE,FALSE,17.19,"young",31,178,92,"m"
9,"LEG EXTENSION",2,"Con09",1220,1200,1300,1450,1210,1375,0.136,-165,1292.5,"Con",20,-150,FALSE,FALSE,FALSE,12,"young",31,178,92,"m"
9,"LEG EXTENSION",2,"Con10",1380,1380,1550,1700,1380,1625,0.178,-245,1502.5,"Con",0,-150,TRUE,FALSE,FALSE,15.08,"young",31,178,92,"m"
9,"LEG EXTENSION",1,"Ecc01",3040,3040,2900,2950,3040,2925,0.038,115,2982.5,"Ecc",0,-50,FALSE,FALSE,FALSE,3.93,"young",31,178,92,"m"
9,"LEG EXTENSION",1,"Ecc02",2720,2720,2700,2700,2720,2700,0.007,20,2710,"Ecc",0,0,FALSE,FALSE,FALSE,0.74,"young",31,178,92,"m"
9,"LEG EXTENSION",1,"Ecc03",2460,2440,2350,2350,2450,2350,0.041,100,2400,"Ecc",20,0,FALSE,FALSE,FALSE,4.26,"young",31,178,92,"m"
9,"LEG EXTENSION",1,"Ecc04",2540,2520,2450,2450,2530,2450,0.032,80,2490,"Ecc",20,0,FALSE,FALSE,FALSE,3.27,"young",31,178,92,"m"
9,"LEG EXTENSION",1,"Ecc05",2580,2580,2550,2550,2580,2550,0.012,30,2565,"Ecc",0,0,FALSE,FALSE,FALSE,1.18,"young",31,178,92,"m"
9,"LEG EXTENSION",1,"Ecc06",2540,2540,2500,2600,2540,2550,0.004,-10,2545,"Ecc",0,-100,FALSE,FALSE,FALSE,0.39,"young",31,178,92,"m"
9,"LEG EXTENSION",1,"Ecc07",2660,2640,2650,2550,2650,2600,0.019,50,2625,"Ecc",20,100,FALSE,FALSE,FALSE,1.92,"young",31,178,92,"m"
9,"LEG EXTENSION",1,"Ecc08",2780,2760,2550,2550,2770,2550,0.079,220,2660,"Ecc",20,0,TRUE,FALSE,FALSE,8.63,"young",31,178,92,"m"
9,"LEG EXTENSION",1,"Ecc09",2980,2940,2650,2750,2960,2700,0.088,260,2830,"Ecc",40,-100,TRUE,TRUE,FALSE,9.63,"young",31,178,92,"m"
9,"LEG EXTENSION",1,"Ecc10",2360,2340,2050,1900,2350,1975,0.16,375,2162.5,"Ecc",20,150,TRUE,FALSE,FALSE,18.99,"young",31,178,92,"m"
9,"LEG EXTENSION",2,"Ecc01",3440,3420,3250,3200,3430,3225,0.06,205,3327.5,"Ecc",20,50,TRUE,FALSE,FALSE,6.36,"young",31,178,92,"m"
9,"LEG EXTENSION",2,"Ecc02",2700,2700,2600,2600,2700,2600,0.037,100,2650,"Ecc",0,0,FALSE,FALSE,FALSE,3.85,"young",31,178,92,"m"
9,"LEG EXTENSION",2,"Ecc03",2320,2320,2150,2300,2320,2225,0.041,95,2272.5,"Ecc",0,-150,FALSE,FALSE,FALSE,4.27,"young",31,178,92,"m"
9,"LEG EXTENSION",2,"Ecc04",2220,2200,2150,2300,2210,2225,0.007,-15,2217.5,"Ecc",20,-150,FALSE,FALSE,FALSE,0.67,"young",31,178,92,"m"
9,"LEG EXTENSION",2,"Ecc05",2520,2520,2500,2550,2520,2525,0.002,-5,2522.5,"Ecc",0,-50,FALSE,FALSE,FALSE,0.2,"young",31,178,92,"m"
9,"LEG EXTENSION",2,"Ecc06",2640,2620,2600,2500,2630,2550,0.03,80,2590,"Ecc",20,100,FALSE,FALSE,FALSE,3.14,"young",31,178,92,"m"
9,"LEG EXTENSION",2,"Ecc07",2440,2420,2300,2200,2430,2250,0.074,180,2340,"Ecc",20,100,FALSE,FALSE,FALSE,8,"young",31,178,92,"m"
9,"LEG EXTENSION",2,"Ecc08",2340,2340,2250,2050,2340,2150,0.081,190,2245,"Ecc",0,200,TRUE,FALSE,TRUE,8.84,"young",31,178,92,"m"
9,"LEG EXTENSION",2,"Ecc09",2300,2320,2200,2050,2310,2125,0.08,185,2217.5,"Ecc",-20,150,FALSE,FALSE,FALSE,8.71,"young",31,178,92,"m"
9,"LEG EXTENSION",2,"Ecc10",1900,1900,1850,1750,1900,1800,0.053,100,1850,"Ecc",0,100,FALSE,FALSE,FALSE,5.56,"young",31,178,92,"m"
9,"LEG EXTENSION",1,"Rep01",4060,4040,4100,4150,4050,4125,0.019,-75,4087.5,"Rep",20,-50,FALSE,FALSE,FALSE,1.82,"young",31,178,92,"m"
9,"LEG EXTENSION",1,"Rep02",4020,4000,4050,4000,4010,4025,0.004,-15,4017.5,"Rep",20,50,FALSE,FALSE,FALSE,0.37,"young",31,178,92,"m"
9,"LEG EXTENSION",1,"Rep03",3780,3800,3750,3750,3790,3750,0.011,40,3770,"Rep",-20,0,FALSE,FALSE,FALSE,1.07,"young",31,178,92,"m"
9,"LEG EXTENSION",1,"Rep04",4140,4120,4150,4200,4130,4175,0.011,-45,4152.5,"Rep",20,-50,FALSE,FALSE,FALSE,1.08,"young",31,178,92,"m"
9,"LEG EXTENSION",1,"Rep05",4020,4040,4000,4000,4030,4000,0.007,30,4015,"Rep",-20,0,FALSE,FALSE,FALSE,0.75,"young",31,178,92,"m"
9,"LEG EXTENSION",1,"Rep06",3800,3800,3850,3850,3800,3850,0.013,-50,3825,"Rep",0,0,FALSE,FALSE,FALSE,1.3,"young",31,178,92,"m"
9,"LEG EXTENSION",1,"Rep07",3980,3980,3950,3850,3980,3900,0.02,80,3940,"Rep",0,100,FALSE,FALSE,FALSE,2.05,"young",31,178,92,"m"
9,"LEG EXTENSION",1,"Rep08",3980,3980,3900,4000,3980,3950,0.008,30,3965,"Rep",0,-100,FALSE,FALSE,FALSE,0.76,"young",31,178,92,"m"
9,"LEG EXTENSION",1,"Rep09",4300,4280,4200,4250,4290,4225,0.015,65,4257.5,"Rep",20,-50,FALSE,FALSE,FALSE,1.54,"young",31,178,92,"m"
9,"LEG EXTENSION",1,"Rep10",3720,3740,4000,3900,3730,3950,0.059,-220,3840,"Rep",-20,100,TRUE,FALSE,FALSE,5.57,"young",31,178,92,"m"
9,"LEG EXTENSION",2,"Rep01",4300,4300,4350,4350,4300,4350,0.012,-50,4325,"Rep",0,0,FALSE,FALSE,FALSE,1.15,"young",31,178,92,"m"
9,"LEG EXTENSION",2,"Rep02",3860,3860,3850,3900,3860,3875,0.004,-15,3867.5,"Rep",0,-50,FALSE,FALSE,FALSE,0.39,"young",31,178,92,"m"
9,"LEG EXTENSION",2,"Rep03",3520,3520,3500,3550,3520,3525,0.001,-5,3522.5,"Rep",0,-50,FALSE,FALSE,FALSE,0.14,"young",31,178,92,"m"
9,"LEG EXTENSION",2,"Rep04",3700,3680,3800,3800,3690,3800,0.03,-110,3745,"Rep",20,0,TRUE,FALSE,FALSE,2.89,"young",31,178,92,"m"
9,"LEG EXTENSION",2,"Rep05",3820,3840,3750,3700,3830,3725,0.027,105,3777.5,"Rep",-20,50,FALSE,FALSE,FALSE,2.82,"young",31,178,92,"m"
9,"LEG EXTENSION",2,"Rep06",3800,3780,3850,3750,3790,3800,0.003,-10,3795,"Rep",20,100,FALSE,FALSE,FALSE,0.26,"young",31,178,92,"m"
9,"LEG EXTENSION",2,"Rep07",3700,3720,3600,3650,3710,3625,0.023,85,3667.5,"Rep",-20,-50,FALSE,FALSE,FALSE,2.34,"young",31,178,92,"m"
9,"LEG EXTENSION",2,"Rep08",3520,3520,3600,3550,3520,3575,0.016,-55,3547.5,"Rep",0,50,FALSE,FALSE,FALSE,1.54,"young",31,178,92,"m"
9,"LEG EXTENSION",2,"Rep09",3520,3520,3500,3500,3520,3500,0.006,20,3510,"Rep",0,0,FALSE,FALSE,FALSE,0.57,"young",31,178,92,"m"
9,"LEG EXTENSION",2,"Rep10",3280,3280,3400,3450,3280,3425,0.044,-145,3352.5,"Rep",0,-50,TRUE,FALSE,FALSE,4.23,"young",31,178,92,"m"
9,"LEG EXTENSION",1,"TuT",39800,39780,39950,39950,39790,39950,0.004,-160,39870,"TuT",20,0,FALSE,FALSE,FALSE,0.4,"young",31,178,92,"m"
9,"LEG EXTENSION",2,"TuT",37020,37020,37200,37200,37020,37200,0.005,-180,37110,"TuT",0,0,TRUE,FALSE,FALSE,0.48,"young",31,178,92,"m"
9,"LEG CURL",1,"Con01",1100,1120,1300,1250,1110,1275,0.149,-165,1192.5,"Con",-20,50,FALSE,FALSE,FALSE,12.94,"young",31,178,92,"m"
9,"LEG CURL",1,"Con02",1220,1220,1300,1300,1220,1300,0.066,-80,1260,"Con",0,0,FALSE,FALSE,FALSE,6.15,"young",31,178,92,"m"
9,"LEG CURL",1,"Con03",1180,1180,1200,1200,1180,1200,0.017,-20,1190,"Con",0,0,FALSE,FALSE,FALSE,1.67,"young",31,178,92,"m"
9,"LEG CURL",1,"Con04",1180,1200,1300,1300,1190,1300,0.092,-110,1245,"Con",-20,0,FALSE,FALSE,FALSE,8.46,"young",31,178,92,"m"
9,"LEG CURL",1,"Con05",1340,1360,1400,1350,1350,1375,0.019,-25,1362.5,"Con",-20,50,FALSE,FALSE,FALSE,1.82,"young",31,178,92,"m"
9,"LEG CURL",1,"Con06",1100,1120,1250,1150,1110,1200,0.081,-90,1155,"Con",-20,100,FALSE,FALSE,FALSE,7.5,"young",31,178,92,"m"
9,"LEG CURL",1,"Con07",1180,1180,1350,1350,1180,1350,0.144,-170,1265,"Con",0,0,FALSE,FALSE,FALSE,12.59,"young",31,178,92,"m"
9,"LEG CURL",1,"Con08",1360,1380,1450,1650,1370,1550,0.131,-180,1460,"Con",-20,-200,FALSE,FALSE,TRUE,11.61,"young",31,178,92,"m"
9,"LEG CURL",1,"Con09",1420,1380,1650,1850,1400,1750,0.25,-350,1575,"Con",40,-200,TRUE,FALSE,TRUE,20,"young",31,178,92,"m"
9,"LEG CURL",1,"Con10",1240,1240,1650,1550,1240,1600,0.29,-360,1420,"Con",0,100,TRUE,FALSE,FALSE,22.5,"young",31,178,92,"m"
9,"LEG CURL",2,"Con01",1060,1080,1200,1150,1070,1175,0.098,-105,1122.5,"Con",-20,50,FALSE,FALSE,FALSE,8.94,"young",31,178,92,"m"
9,"LEG CURL",2,"Con02",1480,1520,1550,1600,1500,1575,0.05,-75,1537.5,"Con",-40,-50,FALSE,FALSE,FALSE,4.76,"young",31,178,92,"m"
9,"LEG CURL",2,"Con03",1240,1260,1250,1300,1250,1275,0.02,-25,1262.5,"Con",-20,-50,FALSE,FALSE,FALSE,1.96,"young",31,178,92,"m"
9,"LEG CURL",2,"Con04",1320,1300,1450,1400,1310,1425,0.088,-115,1367.5,"Con",20,50,FALSE,FALSE,FALSE,8.07,"young",31,178,92,"m"
9,"LEG CURL",2,"Con05",1300,1300,1700,1500,1300,1600,0.231,-300,1450,"Con",0,200,TRUE,FALSE,TRUE,18.75,"young",31,178,92,"m"
9,"LEG CURL",2,"Con06",1340,1340,1550,1500,1340,1525,0.138,-185,1432.5,"Con",0,50,FALSE,FALSE,FALSE,12.13,"young",31,178,92,"m"
9,"LEG CURL",2,"Con07",1080,1100,1200,1200,1090,1200,0.101,-110,1145,"Con",-20,0,FALSE,FALSE,FALSE,9.17,"young",31,178,92,"m"
9,"LEG CURL",2,"Con08",1200,1200,1250,1300,1200,1275,0.062,-75,1237.5,"Con",0,-50,FALSE,FALSE,FALSE,5.88,"young",31,178,92,"m"
9,"LEG CURL",2,"Con09",1200,1220,1250,1250,1210,1250,0.033,-40,1230,"Con",-20,0,FALSE,FALSE,FALSE,3.2,"young",31,178,92,"m"
9,"LEG CURL",2,"Con10",1200,1180,1300,1400,1190,1350,0.134,-160,1270,"Con",20,-100,FALSE,FALSE,FALSE,11.85,"young",31,178,92,"m"
9,"LEG CURL",1,"Ecc01",3540,3520,3400,3400,3530,3400,0.037,130,3465,"Ecc",20,0,FALSE,FALSE,FALSE,3.82,"young",31,178,92,"m"
9,"LEG CURL",1,"Ecc02",3240,3260,3250,3250,3250,3250,0,0,3250,"Ecc",-20,0,FALSE,FALSE,FALSE,0,"young",31,178,92,"m"
9,"LEG CURL",1,"Ecc03",3160,3140,3050,3050,3150,3050,0.032,100,3100,"Ecc",20,0,FALSE,FALSE,FALSE,3.28,"young",31,178,92,"m"
9,"LEG CURL",1,"Ecc04",3220,3200,3150,3200,3210,3175,0.011,35,3192.5,"Ecc",20,-50,FALSE,FALSE,FALSE,1.1,"young",31,178,92,"m"
9,"LEG CURL",1,"Ecc05",3160,3140,3000,3100,3150,3050,0.032,100,3100,"Ecc",20,-100,FALSE,FALSE,FALSE,3.28,"young",31,178,92,"m"
9,"LEG CURL",1,"Ecc06",3000,2980,2850,2900,2990,2875,0.038,115,2932.5,"Ecc",20,-50,FALSE,FALSE,FALSE,4,"young",31,178,92,"m"
9,"LEG CURL",1,"Ecc07",2780,2760,2650,2500,2770,2575,0.07,195,2672.5,"Ecc",20,150,FALSE,FALSE,FALSE,7.57,"young",31,178,92,"m"
9,"LEG CURL",1,"Ecc08",2960,3000,2850,2500,2980,2675,0.102,305,2827.5,"Ecc",-40,350,TRUE,FALSE,TRUE,11.4,"young",31,178,92,"m"
9,"LEG CURL",1,"Ecc09",3100,3120,2700,2850,3110,2775,0.108,335,2942.5,"Ecc",-20,-150,TRUE,FALSE,FALSE,12.07,"young",31,178,92,"m"
9,"LEG CURL",1,"Ecc10",2160,2140,2050,2100,2150,2075,0.035,75,2112.5,"Ecc",20,-50,FALSE,FALSE,FALSE,3.61,"young",31,178,92,"m"
9,"LEG CURL",2,"Ecc01",3620,3600,3550,3500,3610,3525,0.024,85,3567.5,"Ecc",20,50,FALSE,FALSE,FALSE,2.41,"young",31,178,92,"m"
9,"LEG CURL",2,"Ecc02",3180,3160,3100,3100,3170,3100,0.022,70,3135,"Ecc",20,0,FALSE,FALSE,FALSE,2.26,"young",31,178,92,"m"
9,"LEG CURL",2,"Ecc03",3280,3300,3200,3200,3290,3200,0.027,90,3245,"Ecc",-20,0,FALSE,FALSE,FALSE,2.81,"young",31,178,92,"m"
9,"LEG CURL",2,"Ecc04",3360,3340,3000,3150,3350,3075,0.082,275,3212.5,"Ecc",20,-150,TRUE,FALSE,FALSE,8.94,"young",31,178,92,"m"
9,"LEG CURL",2,"Ecc05",2940,2920,2700,2800,2930,2750,0.061,180,2840,"Ecc",20,-100,FALSE,FALSE,FALSE,6.55,"young",31,178,92,"m"
9,"LEG CURL",2,"Ecc06",3040,3040,2900,2900,3040,2900,0.046,140,2970,"Ecc",0,0,FALSE,FALSE,FALSE,4.83,"young",31,178,92,"m"
9,"LEG CURL",2,"Ecc07",3080,3100,3000,3000,3090,3000,0.029,90,3045,"Ecc",-20,0,FALSE,FALSE,FALSE,3,"young",31,178,92,"m"
9,"LEG CURL",2,"Ecc08",3120,3080,3100,3050,3100,3075,0.008,25,3087.5,"Ecc",40,50,FALSE,FALSE,FALSE,0.81,"young",31,178,92,"m"
9,"LEG CURL",2,"Ecc09",3180,3200,3100,3050,3190,3075,0.036,115,3132.5,"Ecc",-20,50,FALSE,FALSE,FALSE,3.74,"young",31,178,92,"m"
9,"LEG CURL",2,"Ecc10",2320,2340,2300,2250,2330,2275,0.024,55,2302.5,"Ecc",-20,50,FALSE,FALSE,FALSE,2.42,"young",31,178,92,"m"
9,"LEG CURL",1,"Rep01",4640,4640,4700,4650,4640,4675,0.008,-35,4657.5,"Rep",0,50,FALSE,FALSE,FALSE,0.75,"young",31,178,92,"m"
9,"LEG CURL",1,"Rep02",4460,4480,4550,4550,4470,4550,0.018,-80,4510,"Rep",-20,0,FALSE,FALSE,FALSE,1.76,"young",31,178,92,"m"
9,"LEG CURL",1,"Rep03",4340,4320,4250,4250,4330,4250,0.018,80,4290,"Rep",20,0,FALSE,FALSE,FALSE,1.88,"young",31,178,92,"m"
9,"LEG CURL",1,"Rep04",4400,4400,4450,4500,4400,4475,0.017,-75,4437.5,"Rep",0,-50,FALSE,FALSE,FALSE,1.68,"young",31,178,92,"m"
9,"LEG CURL",1,"Rep05",4500,4500,4400,4450,4500,4425,0.017,75,4462.5,"Rep",0,-50,FALSE,FALSE,FALSE,1.69,"young",31,178,92,"m"
9,"LEG CURL",1,"Rep06",4100,4100,4100,4050,4100,4075,0.006,25,4087.5,"Rep",0,50,FALSE,FALSE,FALSE,0.61,"young",31,178,92,"m"
9,"LEG CURL",1,"Rep07",3960,3940,4000,3850,3950,3925,0.006,25,3937.5,"Rep",20,150,FALSE,FALSE,FALSE,0.64,"young",31,178,92,"m"
9,"LEG CURL",1,"Rep08",4320,4380,4300,4150,4350,4225,0.029,125,4287.5,"Rep",-60,150,FALSE,FALSE,FALSE,2.96,"young",31,178,92,"m"
9,"LEG CURL",1,"Rep09",4520,4500,4350,4700,4510,4525,0.003,-15,4517.5,"Rep",20,-350,FALSE,FALSE,TRUE,0.33,"young",31,178,92,"m"
9,"LEG CURL",1,"Rep10",3400,3380,3700,3650,3390,3675,0.084,-285,3532.5,"Rep",20,50,TRUE,FALSE,FALSE,7.76,"young",31,178,92,"m"
9,"LEG CURL",2,"Rep01",4680,4680,4750,4650,4680,4700,0.004,-20,4690,"Rep",0,100,FALSE,FALSE,FALSE,0.43,"young",31,178,92,"m"
9,"LEG CURL",2,"Rep02",4660,4680,4650,4700,4670,4675,0.001,-5,4672.5,"Rep",-20,-50,FALSE,FALSE,FALSE,0.11,"young",31,178,92,"m"
9,"LEG CURL",2,"Rep03",4520,4560,4450,4500,4540,4475,0.014,65,4507.5,"Rep",-40,-50,FALSE,FALSE,FALSE,1.45,"young",31,178,92,"m"
9,"LEG CURL",2,"Rep04",4680,4640,4450,4550,4660,4500,0.034,160,4580,"Rep",40,-100,TRUE,FALSE,FALSE,3.56,"young",31,178,92,"m"
9,"LEG CURL",2,"Rep05",4240,4220,4400,4300,4230,4350,0.028,-120,4290,"Rep",20,100,FALSE,FALSE,FALSE,2.76,"young",31,178,92,"m"
9,"LEG CURL",2,"Rep06",4380,4380,4450,4400,4380,4425,0.01,-45,4402.5,"Rep",0,50,FALSE,FALSE,FALSE,1.02,"young",31,178,92,"m"
9,"LEG CURL",2,"Rep07",4160,4200,4200,4200,4180,4200,0.005,-20,4190,"Rep",-40,0,FALSE,FALSE,FALSE,0.48,"young",31,178,92,"m"
9,"LEG CURL",2,"Rep08",4320,4280,4350,4350,4300,4350,0.012,-50,4325,"Rep",40,0,FALSE,FALSE,FALSE,1.15,"young",31,178,92,"m"
9,"LEG CURL",2,"Rep09",4380,4420,4350,4300,4400,4325,0.017,75,4362.5,"Rep",-40,50,FALSE,FALSE,FALSE,1.73,"young",31,178,92,"m"
9,"LEG CURL",2,"Rep10",3520,3520,3600,3650,3520,3625,0.03,-105,3572.5,"Rep",0,-50,FALSE,FALSE,FALSE,2.9,"young",31,178,92,"m"
9,"LEG CURL",1,"TuT",42640,42640,42800,42800,42640,42800,0.004,-160,42720,"TuT",0,0,FALSE,FALSE,FALSE,0.37,"young",31,178,92,"m"
9,"LEG CURL",2,"TuT",43540,43580,43650,43600,43560,43625,0.001,-65,43592.5,"TuT",-40,50,FALSE,TRUE,FALSE,0.15,"young",31,178,92,"m"
9,"ABDUCTOR",1,"Con01",980,960,1300,1350,970,1325,0.366,-355,1147.5,"Con",20,-50,TRUE,FALSE,FALSE,26.79,"young",31,178,92,"m"
9,"ABDUCTOR",1,"Con02",800,800,1050,950,800,1000,0.25,-200,900,"Con",0,100,FALSE,FALSE,FALSE,20,"young",31,178,92,"m"
9,"ABDUCTOR",1,"Con03",920,920,1050,950,920,1000,0.087,-80,960,"Con",0,100,FALSE,FALSE,FALSE,8,"young",31,178,92,"m"
9,"ABDUCTOR",1,"Con04",1100,1100,1100,1100,1100,1100,0,0,1100,"Con",0,0,FALSE,FALSE,FALSE,0,"young",31,178,92,"m"
9,"ABDUCTOR",1,"Con05",960,960,1100,1100,960,1100,0.146,-140,1030,"Con",0,0,FALSE,FALSE,FALSE,12.73,"young",31,178,92,"m"
9,"ABDUCTOR",1,"Con06",1020,1060,1250,1250,1040,1250,0.202,-210,1145,"Con",-40,0,FALSE,TRUE,FALSE,16.8,"young",31,178,92,"m"
9,"ABDUCTOR",1,"Con07",1200,1220,1600,1500,1210,1550,0.281,-340,1380,"Con",-20,100,TRUE,FALSE,FALSE,21.94,"young",31,178,92,"m"
9,"ABDUCTOR",1,"Con08",1000,1020,1800,2000,1010,1900,0.881,-890,1455,"Con",-20,-200,TRUE,FALSE,FALSE,46.84,"young",31,178,92,"m"
9,"ABDUCTOR",1,"Con09",1040,1040,1500,1950,1040,1725,0.659,-685,1382.5,"Con",0,-450,TRUE,FALSE,TRUE,39.71,"young",31,178,92,"m"
9,"ABDUCTOR",1,"Con10",1380,1380,1600,1500,1380,1550,0.123,-170,1465,"Con",0,100,FALSE,FALSE,FALSE,10.97,"young",31,178,92,"m"
9,"ABDUCTOR",2,"Con01",940,960,1250,1100,950,1175,0.237,-225,1062.5,"Con",-20,150,FALSE,FALSE,FALSE,19.15,"young",31,178,92,"m"
9,"ABDUCTOR",2,"Con02",1020,1040,1050,1150,1030,1100,0.068,-70,1065,"Con",-20,-100,FALSE,FALSE,FALSE,6.36,"young",31,178,92,"m"
9,"ABDUCTOR",2,"Con03",920,940,1250,1150,930,1200,0.29,-270,1065,"Con",-20,100,FALSE,FALSE,FALSE,22.5,"young",31,178,92,"m"
9,"ABDUCTOR",2,"Con04",900,920,1100,1700,910,1400,0.538,-490,1155,"Con",-20,-600,TRUE,FALSE,TRUE,35,"young",31,178,92,"m"
9,"ABDUCTOR",2,"Con05",1080,1060,1200,1300,1070,1250,0.168,-180,1160,"Con",20,-100,FALSE,FALSE,FALSE,14.4,"young",31,178,92,"m"
9,"ABDUCTOR",2,"Con06",1120,1140,1150,1300,1130,1225,0.084,-95,1177.5,"Con",-20,-150,FALSE,FALSE,FALSE,7.76,"young",31,178,92,"m"
9,"ABDUCTOR",2,"Con07",1020,1060,1250,1100,1040,1175,0.13,-135,1107.5,"Con",-40,150,FALSE,TRUE,FALSE,11.49,"young",31,178,92,"m"
9,"ABDUCTOR",2,"Con08",1060,1020,1600,1150,1040,1375,0.322,-335,1207.5,"Con",40,450,TRUE,TRUE,TRUE,24.36,"young",31,178,92,"m"
9,"ABDUCTOR",2,"Con09",1060,1060,1500,1200,1060,1350,0.274,-290,1205,"Con",0,300,FALSE,FALSE,TRUE,21.48,"young",31,178,92,"m"
9,"ABDUCTOR",2,"Con10",1040,1020,1550,1600,1030,1575,0.529,-545,1302.5,"Con",20,-50,TRUE,FALSE,FALSE,34.6,"young",31,178,92,"m"
9,"ABDUCTOR",1,"Ecc01",3040,3060,2800,2850,3050,2825,0.074,225,2937.5,"Ecc",-20,-50,FALSE,FALSE,FALSE,7.96,"young",31,178,92,"m"
9,"ABDUCTOR",1,"Ecc02",2480,2480,2300,2400,2480,2350,0.052,130,2415,"Ecc",0,-100,FALSE,FALSE,FALSE,5.53,"young",31,178,92,"m"
9,"ABDUCTOR",1,"Ecc03",2620,2620,2550,2600,2620,2575,0.017,45,2597.5,"Ecc",0,-50,FALSE,FALSE,FALSE,1.75,"young",31,178,92,"m"
9,"ABDUCTOR",1,"Ecc04",2700,2700,2650,2650,2700,2650,0.019,50,2675,"Ecc",0,0,FALSE,FALSE,FALSE,1.89,"young",31,178,92,"m"
9,"ABDUCTOR",1,"Ecc05",2760,2740,2600,2600,2750,2600,0.055,150,2675,"Ecc",20,0,FALSE,FALSE,FALSE,5.77,"young",31,178,92,"m"
9,"ABDUCTOR",1,"Ecc06",2940,2900,2650,2650,2920,2650,0.092,270,2785,"Ecc",40,0,FALSE,TRUE,FALSE,10.19,"young",31,178,92,"m"
9,"ABDUCTOR",1,"Ecc07",2820,2800,1900,2150,2810,2025,0.279,785,2417.5,"Ecc",20,-250,TRUE,FALSE,FALSE,38.77,"young",31,178,92,"m"
9,"ABDUCTOR",1,"Ecc08",3040,3040,2800,2150,3040,2475,0.186,565,2757.5,"Ecc",0,650,TRUE,FALSE,TRUE,22.83,"young",31,178,92,"m"
9,"ABDUCTOR",1,"Ecc09",2740,2740,2300,2150,2740,2225,0.188,515,2482.5,"Ecc",0,150,TRUE,FALSE,FALSE,23.15,"young",31,178,92,"m"
9,"ABDUCTOR",1,"Ecc10",3020,3020,2850,2950,3020,2900,0.04,120,2960,"Ecc",0,-100,FALSE,FALSE,FALSE,4.14,"young",31,178,92,"m"
9,"ABDUCTOR",2,"Ecc01",2640,2620,2650,2600,2630,2625,0.002,5,2627.5,"Ecc",20,50,FALSE,FALSE,FALSE,0.19,"young",31,178,92,"m"
9,"ABDUCTOR",2,"Ecc02",2780,2760,2650,2550,2770,2600,0.061,170,2685,"Ecc",20,100,FALSE,FALSE,FALSE,6.54,"young",31,178,92,"m"
9,"ABDUCTOR",2,"Ecc03",2640,2620,2200,1900,2630,2050,0.221,580,2340,"Ecc",20,300,TRUE,FALSE,FALSE,28.29,"young",31,178,92,"m"
9,"ABDUCTOR",2,"Ecc04",2640,2640,2550,2250,2640,2400,0.091,240,2520,"Ecc",0,300,FALSE,FALSE,FALSE,10,"young",31,178,92,"m"
9,"ABDUCTOR",2,"Ecc05",2440,2460,2350,2350,2450,2350,0.041,100,2400,"Ecc",-20,0,FALSE,FALSE,FALSE,4.26,"young",31,178,92,"m"
9,"ABDUCTOR",2,"Ecc06",2560,2520,2550,2450,2540,2500,0.016,40,2520,"Ecc",40,100,FALSE,TRUE,FALSE,1.6,"young",31,178,92,"m"
9,"ABDUCTOR",2,"Ecc07",2680,2640,2250,2500,2660,2375,0.107,285,2517.5,"Ecc",40,-250,FALSE,TRUE,FALSE,12,"young",31,178,92,"m"
9,"ABDUCTOR",2,"Ecc08",2480,2540,1900,2450,2510,2175,0.133,335,2342.5,"Ecc",-60,-550,TRUE,TRUE,TRUE,15.4,"young",31,178,92,"m"
9,"ABDUCTOR",2,"Ecc09",2580,2580,2250,2400,2580,2325,0.099,255,2452.5,"Ecc",0,-150,FALSE,FALSE,FALSE,10.97,"young",31,178,92,"m"
9,"ABDUCTOR",2,"Ecc10",2100,2100,1750,1600,2100,1675,0.202,425,1887.5,"Ecc",0,150,TRUE,FALSE,FALSE,25.37,"young",31,178,92,"m"
9,"ABDUCTOR",1,"Rep01",4020,4020,4100,4200,4020,4150,0.032,-130,4085,"Rep",0,-100,FALSE,FALSE,FALSE,3.13,"young",31,178,92,"m"
9,"ABDUCTOR",1,"Rep02",3280,3280,3350,3350,3280,3350,0.021,-70,3315,"Rep",0,0,FALSE,FALSE,FALSE,2.09,"young",31,178,92,"m"
9,"ABDUCTOR",1,"Rep03",3540,3540,3600,3550,3540,3575,0.01,-35,3557.5,"Rep",0,50,FALSE,FALSE,FALSE,0.98,"young",31,178,92,"m"
9,"ABDUCTOR",1,"Rep04",3800,3800,3750,3750,3800,3750,0.013,50,3775,"Rep",0,0,FALSE,FALSE,FALSE,1.33,"young",31,178,92,"m"
9,"ABDUCTOR",1,"Rep05",3720,3700,3700,3700,3710,3700,0.003,10,3705,"Rep",20,0,FALSE,FALSE,FALSE,0.27,"young",31,178,92,"m"
9,"ABDUCTOR",1,"Rep06",3960,3960,3900,3900,3960,3900,0.015,60,3930,"Rep",0,0,FALSE,FALSE,FALSE,1.54,"young",31,178,92,"m"
9,"ABDUCTOR",1,"Rep07",4020,4020,3500,3650,4020,3575,0.111,445,3797.5,"Rep",0,-150,TRUE,FALSE,FALSE,12.45,"young",31,178,92,"m"
9,"ABDUCTOR",1,"Rep08",4040,4060,4600,4150,4050,4375,0.08,-325,4212.5,"Rep",-20,450,TRUE,FALSE,TRUE,7.43,"young",31,178,92,"m"
9,"ABDUCTOR",1,"Rep09",3780,3780,3800,4100,3780,3950,0.045,-170,3865,"Rep",0,-300,FALSE,FALSE,FALSE,4.3,"young",31,178,92,"m"
9,"ABDUCTOR",1,"Rep10",4400,4400,4450,4450,4400,4450,0.011,-50,4425,"Rep",0,0,FALSE,FALSE,FALSE,1.12,"young",31,178,92,"m"
9,"ABDUCTOR",2,"Rep01",3580,3580,3900,3700,3580,3800,0.061,-220,3690,"Rep",0,200,FALSE,FALSE,FALSE,5.79,"young",31,178,92,"m"
9,"ABDUCTOR",2,"Rep02",3800,3800,3700,3700,3800,3700,0.026,100,3750,"Rep",0,0,FALSE,FALSE,FALSE,2.7,"young",31,178,92,"m"
9,"ABDUCTOR",2,"Rep03",3560,3560,3450,3050,3560,3250,0.087,310,3405,"Rep",0,400,TRUE,FALSE,TRUE,9.54,"young",31,178,92,"m"
9,"ABDUCTOR",2,"Rep04",3540,3560,3650,3950,3550,3800,0.07,-250,3675,"Rep",-20,-300,FALSE,FALSE,FALSE,6.58,"young",31,178,92,"m"
9,"ABDUCTOR",2,"Rep05",3520,3520,3550,3650,3520,3600,0.023,-80,3560,"Rep",0,-100,FALSE,FALSE,FALSE,2.22,"young",31,178,92,"m"
9,"ABDUCTOR",2,"Rep06",3680,3660,3700,3750,3670,3725,0.015,-55,3697.5,"Rep",20,-50,FALSE,FALSE,FALSE,1.48,"young",31,178,92,"m"
9,"ABDUCTOR",2,"Rep07",3700,3700,3500,3600,3700,3550,0.041,150,3625,"Rep",0,-100,FALSE,FALSE,FALSE,4.23,"young",31,178,92,"m"
9,"ABDUCTOR",2,"Rep08",3540,3560,3500,3600,3550,3550,0,0,3550,"Rep",-20,-100,FALSE,FALSE,FALSE,0,"young",31,178,92,"m"
9,"ABDUCTOR",2,"Rep09",3640,3640,3750,3600,3640,3675,0.01,-35,3657.5,"Rep",0,150,FALSE,FALSE,FALSE,0.95,"young",31,178,92,"m"
9,"ABDUCTOR",2,"Rep10",3140,3120,3300,3200,3130,3250,0.038,-120,3190,"Rep",20,100,FALSE,FALSE,FALSE,3.69,"young",31,178,92,"m"
9,"ABDUCTOR",1,"TuT",38560,38560,38750,38800,38560,38775,0.006,-215,38667.5,"TuT",0,-50,FALSE,FALSE,FALSE,0.55,"young",31,178,92,"m"
9,"ABDUCTOR",2,"TuT",35700,35700,36000,35800,35700,35900,0.006,-200,35800,"TuT",0,200,FALSE,FALSE,FALSE,0.56,"young",31,178,92,"m"
9,"ADDUCTOR",1,"Con01",1640,1620,1750,3150,1630,2450,0.503,-820,2040,"Con",20,-1400,TRUE,FALSE,TRUE,33.47,"young",31,178,92,"m"
9,"ADDUCTOR",1,"Con02",920,880,1200,1300,900,1250,0.389,-350,1075,"Con",40,-100,FALSE,TRUE,FALSE,28,"young",31,178,92,"m"
9,"ADDUCTOR",1,"Con03",920,900,1050,1000,910,1025,0.126,-115,967.5,"Con",20,50,FALSE,FALSE,FALSE,11.22,"young",31,178,92,"m"
9,"ADDUCTOR",1,"Con04",1020,1040,1600,1450,1030,1525,0.481,-495,1277.5,"Con",-20,150,FALSE,FALSE,FALSE,32.46,"young",31,178,92,"m"
9,"ADDUCTOR",1,"Con05",1080,1040,1650,1350,1060,1500,0.415,-440,1280,"Con",40,300,FALSE,TRUE,FALSE,29.33,"young",31,178,92,"m"
9,"ADDUCTOR",1,"Con06",1060,1060,1350,1550,1060,1450,0.368,-390,1255,"Con",0,-200,FALSE,FALSE,FALSE,26.9,"young",31,178,92,"m"
9,"ADDUCTOR",1,"Con07",1120,1120,900,1150,1120,1025,0.085,95,1072.5,"Con",0,-250,FALSE,FALSE,FALSE,9.27,"young",31,178,92,"m"
9,"ADDUCTOR",1,"Con08",1000,1000,1700,1650,1000,1675,0.675,-675,1337.5,"Con",0,50,TRUE,FALSE,FALSE,40.3,"young",31,178,92,"m"
9,"ADDUCTOR",1,"Con09",1160,1180,2100,1950,1170,2025,0.731,-855,1597.5,"Con",-20,150,TRUE,FALSE,FALSE,42.22,"young",31,178,92,"m"
9,"ADDUCTOR",1,"Con10",1080,1080,1900,1900,1080,1900,0.759,-820,1490,"Con",0,0,TRUE,FALSE,FALSE,43.16,"young",31,178,92,"m"
9,"ADDUCTOR",2,"Con01",1440,1400,1750,1250,1420,1500,0.056,-80,1460,"Con",40,500,FALSE,TRUE,TRUE,5.33,"young",31,178,92,"m"
9,"ADDUCTOR",2,"Con02",1040,1020,1400,1150,1030,1275,0.238,-245,1152.5,"Con",20,250,FALSE,FALSE,FALSE,19.22,"young",31,178,92,"m"
9,"ADDUCTOR",2,"Con03",1060,1080,1200,1100,1070,1150,0.075,-80,1110,"Con",-20,100,FALSE,FALSE,FALSE,6.96,"young",31,178,92,"m"
9,"ADDUCTOR",2,"Con04",1080,1060,1200,950,1070,1075,0.005,-5,1072.5,"Con",20,250,FALSE,FALSE,FALSE,0.47,"young",31,178,92,"m"
9,"ADDUCTOR",2,"Con05",940,940,1100,1150,940,1125,0.197,-185,1032.5,"Con",0,-50,FALSE,FALSE,FALSE,16.44,"young",31,178,92,"m"
9,"ADDUCTOR",2,"Con06",960,940,1450,1250,950,1350,0.421,-400,1150,"Con",20,200,FALSE,FALSE,FALSE,29.63,"young",31,178,92,"m"
9,"ADDUCTOR",2,"Con07",1060,1040,1300,2400,1050,1850,0.762,-800,1450,"Con",20,-1100,TRUE,FALSE,TRUE,43.24,"young",31,178,92,"m"
9,"ADDUCTOR",2,"Con08",1000,1000,1500,0,1000,750,0.25,250,875,"Con",0,1500,FALSE,FALSE,TRUE,33.33,"young",31,178,92,"m"
9,"ADDUCTOR",2,"Con09",860,860,1450,34000,860,17725,19.61,-16865,9292.5,"Con",0,-32550,TRUE,FALSE,TRUE,95.15,"young",31,178,92,"m"
9,"ADDUCTOR",2,"Con10",980,940,1800,0,960,900,0.062,60,930,"Con",40,1800,FALSE,TRUE,TRUE,6.67,"young",31,178,92,"m"
9,"ADDUCTOR",1,"Ecc01",3340,3360,2450,950,3350,1700,0.493,1650,2525,"Ecc",-20,1500,TRUE,FALSE,TRUE,97.06,"young",31,178,92,"m"
9,"ADDUCTOR",1,"Ecc02",2420,2440,2300,2350,2430,2325,0.043,105,2377.5,"Ecc",-20,-50,FALSE,FALSE,FALSE,4.52,"young",31,178,92,"m"
9,"ADDUCTOR",1,"Ecc03",2480,2480,2300,2350,2480,2325,0.062,155,2402.5,"Ecc",0,-50,FALSE,FALSE,FALSE,6.67,"young",31,178,92,"m"
9,"ADDUCTOR",1,"Ecc04",2700,2740,2050,2300,2720,2175,0.2,545,2447.5,"Ecc",-40,-250,FALSE,TRUE,FALSE,25.06,"young",31,178,92,"m"
9,"ADDUCTOR",1,"Ecc05",2720,2720,2150,2450,2720,2300,0.154,420,2510,"Ecc",0,-300,FALSE,FALSE,FALSE,18.26,"young",31,178,92,"m"
9,"ADDUCTOR",1,"Ecc06",2740,2780,2700,2300,2760,2500,0.094,260,2630,"Ecc",-40,400,FALSE,TRUE,TRUE,10.4,"young",31,178,92,"m"
9,"ADDUCTOR",1,"Ecc07",2760,2720,2950,2800,2740,2875,0.049,-135,2807.5,"Ecc",40,150,FALSE,TRUE,FALSE,4.7,"young",31,178,92,"m"
9,"ADDUCTOR",1,"Ecc08",2520,2520,1250,1400,2520,1325,0.474,1195,1922.5,"Ecc",0,-150,TRUE,FALSE,FALSE,90.19,"young",31,178,92,"m"
9,"ADDUCTOR",1,"Ecc09",2240,2220,1550,1550,2230,1550,0.305,680,1890,"Ecc",20,0,TRUE,FALSE,FALSE,43.87,"young",31,178,92,"m"
9,"ADDUCTOR",1,"Ecc10",2460,2460,1900,1900,2460,1900,0.228,560,2180,"Ecc",0,0,TRUE,FALSE,FALSE,29.47,"young",31,178,92,"m"
9,"ADDUCTOR",2,"Ecc01",2360,2380,2100,2200,2370,2150,0.093,220,2260,"Ecc",-20,-100,FALSE,FALSE,FALSE,10.23,"young",31,178,92,"m"
9,"ADDUCTOR",2,"Ecc02",2380,2380,2100,2300,2380,2200,0.076,180,2290,"Ecc",0,-200,FALSE,FALSE,FALSE,8.18,"young",31,178,92,"m"
9,"ADDUCTOR",2,"Ecc03",2260,2260,2250,2550,2260,2400,0.062,-140,2330,"Ecc",0,-300,FALSE,FALSE,FALSE,5.83,"young",31,178,92,"m"
9,"ADDUCTOR",2,"Ecc04",2620,2620,2400,2250,2620,2325,0.113,295,2472.5,"Ecc",0,150,FALSE,FALSE,FALSE,12.69,"young",31,178,92,"m"
9,"ADDUCTOR",2,"Ecc05",2280,2280,2100,1900,2280,2000,0.123,280,2140,"Ecc",0,200,FALSE,FALSE,FALSE,14,"young",31,178,92,"m"
9,"ADDUCTOR",2,"Ecc06",2180,2200,1600,1950,2190,1775,0.189,415,1982.5,"Ecc",-20,-350,FALSE,FALSE,TRUE,23.38,"young",31,178,92,"m"
9,"ADDUCTOR",2,"Ecc07",2120,2140,2050,250,2130,1150,0.46,980,1640,"Ecc",-20,1800,TRUE,FALSE,TRUE,85.22,"young",31,178,92,"m"
9,"ADDUCTOR",2,"Ecc08",2340,2340,1650,0,2340,825,0.647,1515,1582.5,"Ecc",0,1650,TRUE,FALSE,TRUE,183.64,"young",31,178,92,"m"
9,"ADDUCTOR",2,"Ecc09",2220,2260,1450,1450,2240,1450,0.353,790,1845,"Ecc",-40,0,TRUE,TRUE,FALSE,54.48,"young",31,178,92,"m"
9,"ADDUCTOR",2,"Ecc10",1880,1880,1400,0,1880,700,0.628,1180,1290,"Ecc",0,1400,TRUE,FALSE,TRUE,168.57,"young",31,178,92,"m"
9,"ADDUCTOR",1,"Rep01",4980,4980,4200,4100,4980,4150,0.167,830,4565,"Rep",0,100,TRUE,FALSE,FALSE,20,"young",31,178,92,"m"
9,"ADDUCTOR",1,"Rep02",3340,3320,3500,3650,3330,3575,0.074,-245,3452.5,"Rep",20,-150,FALSE,FALSE,FALSE,6.85,"young",31,178,92,"m"
9,"ADDUCTOR",1,"Rep03",3400,3380,3350,3350,3390,3350,0.012,40,3370,"Rep",20,0,FALSE,FALSE,FALSE,1.19,"young",31,178,92,"m"
9,"ADDUCTOR",1,"Rep04",3720,3780,3650,3750,3750,3700,0.013,50,3725,"Rep",-60,-100,FALSE,FALSE,FALSE,1.35,"young",31,178,92,"m"
9,"ADDUCTOR",1,"Rep05",3800,3760,3800,3800,3780,3800,0.005,-20,3790,"Rep",40,0,FALSE,FALSE,FALSE,0.53,"young",31,178,92,"m"
9,"ADDUCTOR",1,"Rep06",3800,3840,4050,3850,3820,3950,0.034,-130,3885,"Rep",-40,200,FALSE,FALSE,FALSE,3.29,"young",31,178,92,"m"
9,"ADDUCTOR",1,"Rep07",3880,3840,3850,3950,3860,3900,0.01,-40,3880,"Rep",40,-100,FALSE,FALSE,FALSE,1.03,"young",31,178,92,"m"
9,"ADDUCTOR",1,"Rep08",3520,3520,2950,3050,3520,3000,0.148,520,3260,"Rep",0,-100,TRUE,FALSE,FALSE,17.33,"young",31,178,92,"m"
9,"ADDUCTOR",1,"Rep09",3400,3400,3650,3500,3400,3575,0.051,-175,3487.5,"Rep",0,150,FALSE,FALSE,FALSE,4.9,"young",31,178,92,"m"
9,"ADDUCTOR",1,"Rep10",3540,3540,3800,3800,3540,3800,0.073,-260,3670,"Rep",0,0,FALSE,FALSE,FALSE,6.84,"young",31,178,92,"m"
9,"ADDUCTOR",2,"Rep01",3800,3780,3850,3450,3790,3650,0.037,140,3720,"Rep",20,400,FALSE,FALSE,TRUE,3.84,"young",31,178,92,"m"
9,"ADDUCTOR",2,"Rep02",3420,3400,3500,3450,3410,3475,0.019,-65,3442.5,"Rep",20,50,FALSE,FALSE,FALSE,1.87,"young",31,178,92,"m"
9,"ADDUCTOR",2,"Rep03",3320,3340,3450,3650,3330,3550,0.066,-220,3440,"Rep",-20,-200,FALSE,FALSE,FALSE,6.2,"young",31,178,92,"m"
9,"ADDUCTOR",2,"Rep04",3700,3680,3600,3200,3690,3400,0.079,290,3545,"Rep",20,400,FALSE,FALSE,TRUE,8.53,"young",31,178,92,"m"
9,"ADDUCTOR",2,"Rep05",3220,3220,3200,3050,3220,3125,0.03,95,3172.5,"Rep",0,150,FALSE,FALSE,FALSE,3.04,"young",31,178,92,"m"
9,"ADDUCTOR",2,"Rep06",3140,3140,3050,3200,3140,3125,0.005,15,3132.5,"Rep",0,-150,FALSE,FALSE,FALSE,0.48,"young",31,178,92,"m"
9,"ADDUCTOR",2,"Rep07",3180,3180,3350,2650,3180,3000,0.057,180,3090,"Rep",0,700,FALSE,FALSE,TRUE,6,"young",31,178,92,"m"
9,"ADDUCTOR",2,"Rep08",3340,3340,3150,0,3340,1575,0.528,1765,2457.5,"Rep",0,3150,TRUE,FALSE,TRUE,112.06,"young",31,178,92,"m"
9,"ADDUCTOR",2,"Rep09",3080,3120,2900,35450,3100,19175,5.185,-16075,11137.5,"Rep",-40,-32550,TRUE,FALSE,TRUE,83.83,"young",31,178,92,"m"
9,"ADDUCTOR",2,"Rep10",2860,2820,3200,0,2840,1600,0.437,1240,2220,"Rep",40,3200,TRUE,FALSE,TRUE,77.5,"young",31,178,92,"m"
9,"ADDUCTOR",1,"TuT",37380,37360,36800,36800,37370,36800,0.015,570,37085,"TuT",20,0,FALSE,FALSE,FALSE,1.55,"young",31,178,92,"m"
9,"ADDUCTOR",2,"TuT",33060,33020,33250,58100,33040,45675,0.382,-12635,39357.5,"TuT",40,-24850,TRUE,TRUE,TRUE,27.66,"young",31,178,92,"m"
9,"LOWER BACK",1,"Con01",1260,1260,1500,1450,1260,1475,0.171,-215,1367.5,"Con",0,50,TRUE,FALSE,FALSE,14.58,"young",31,178,92,"m"
9,"LOWER BACK",1,"Con02",1460,1460,1500,1600,1460,1550,0.062,-90,1505,"Con",0,-100,FALSE,FALSE,FALSE,5.81,"young",31,178,92,"m"
9,"LOWER BACK",1,"Con03",1480,1480,1550,1500,1480,1525,0.03,-45,1502.5,"Con",0,50,FALSE,FALSE,FALSE,2.95,"young",31,178,92,"m"
9,"LOWER BACK",1,"Con04",1560,1540,1650,1500,1550,1575,0.016,-25,1562.5,"Con",20,150,FALSE,FALSE,FALSE,1.59,"young",31,178,92,"m"
9,"LOWER BACK",1,"Con05",1460,1500,1600,1500,1480,1550,0.047,-70,1515,"Con",-40,100,FALSE,TRUE,FALSE,4.52,"young",31,178,92,"m"
9,"LOWER BACK",1,"Con06",1320,1340,1400,1400,1330,1400,0.053,-70,1365,"Con",-20,0,FALSE,FALSE,FALSE,5,"young",31,178,92,"m"
9,"LOWER BACK",1,"Con07",1360,1360,1500,1450,1360,1475,0.085,-115,1417.5,"Con",0,50,FALSE,FALSE,FALSE,7.8,"young",31,178,92,"m"
9,"LOWER BACK",1,"Con08",1420,1420,1550,1650,1420,1600,0.127,-180,1510,"Con",0,-100,FALSE,FALSE,FALSE,11.25,"young",31,178,92,"m"
9,"LOWER BACK",1,"Con09",1440,1420,1550,1700,1430,1625,0.136,-195,1527.5,"Con",20,-150,TRUE,FALSE,FALSE,12,"young",31,178,92,"m"
9,"LOWER BACK",1,"Con10",1480,1480,1550,1800,1480,1675,0.132,-195,1577.5,"Con",0,-250,TRUE,FALSE,TRUE,11.64,"young",31,178,92,"m"
9,"LOWER BACK",2,"Con01",1200,1220,1450,1350,1210,1400,0.157,-190,1305,"Con",-20,100,TRUE,FALSE,FALSE,13.57,"young",31,178,92,"m"
9,"LOWER BACK",2,"Con02",1460,1460,1450,1500,1460,1475,0.01,-15,1467.5,"Con",0,-50,FALSE,FALSE,FALSE,1.02,"young",31,178,92,"m"
9,"LOWER BACK",2,"Con03",1440,1440,1500,1500,1440,1500,0.042,-60,1470,"Con",0,0,FALSE,FALSE,FALSE,4,"young",31,178,92,"m"
9,"LOWER BACK",2,"Con04",1340,1380,1400,1400,1360,1400,0.029,-40,1380,"Con",-40,0,FALSE,TRUE,FALSE,2.86,"young",31,178,92,"m"
9,"LOWER BACK",2,"Con05",1500,1520,1600,1550,1510,1575,0.043,-65,1542.5,"Con",-20,50,FALSE,FALSE,FALSE,4.13,"young",31,178,92,"m"
9,"LOWER BACK",2,"Con06",1300,1320,1350,1300,1310,1325,0.011,-15,1317.5,"Con",-20,50,FALSE,FALSE,FALSE,1.13,"young",31,178,92,"m"
9,"LOWER BACK",2,"Con07",1340,1380,1400,1400,1360,1400,0.029,-40,1380,"Con",-40,0,FALSE,TRUE,FALSE,2.86,"young",31,178,92,"m"
9,"LOWER BACK",2,"Con08",1300,1340,1450,1500,1320,1475,0.117,-155,1397.5,"Con",-40,-50,FALSE,TRUE,FALSE,10.51,"young",31,178,92,"m"
9,"LOWER BACK",2,"Con09",1200,1200,1400,1400,1200,1400,0.167,-200,1300,"Con",0,0,TRUE,FALSE,FALSE,14.29,"young",31,178,92,"m"
9,"LOWER BACK",2,"Con10",1260,1260,1450,1500,1260,1475,0.171,-215,1367.5,"Con",0,-50,TRUE,FALSE,FALSE,14.58,"young",31,178,92,"m"
9,"LOWER BACK",1,"Ecc01",3880,3880,3800,3750,3880,3775,0.027,105,3827.5,"Ecc",0,50,FALSE,FALSE,FALSE,2.78,"young",31,178,92,"m"
9,"LOWER BACK",1,"Ecc02",3240,3240,3200,3150,3240,3175,0.02,65,3207.5,"Ecc",0,50,FALSE,FALSE,FALSE,2.05,"young",31,178,92,"m"
9,"LOWER BACK",1,"Ecc03",2920,2940,2850,3000,2930,2925,0.002,5,2927.5,"Ecc",-20,-150,FALSE,FALSE,FALSE,0.17,"young",31,178,92,"m"
9,"LOWER BACK",1,"Ecc04",2960,2940,2800,2950,2950,2875,0.025,75,2912.5,"Ecc",20,-150,FALSE,FALSE,FALSE,2.61,"young",31,178,92,"m"
9,"LOWER BACK",1,"Ecc05",2880,2840,2800,2800,2860,2800,0.021,60,2830,"Ecc",40,0,FALSE,FALSE,FALSE,2.14,"young",31,178,92,"m"
9,"LOWER BACK",1,"Ecc06",2400,2400,2300,2300,2400,2300,0.042,100,2350,"Ecc",0,0,FALSE,FALSE,FALSE,4.35,"young",31,178,92,"m"
9,"LOWER BACK",1,"Ecc07",2780,2780,2600,2600,2780,2600,0.065,180,2690,"Ecc",0,0,TRUE,FALSE,FALSE,6.92,"young",31,178,92,"m"
9,"LOWER BACK",1,"Ecc08",2860,2860,2750,2600,2860,2675,0.065,185,2767.5,"Ecc",0,150,TRUE,FALSE,FALSE,6.92,"young",31,178,92,"m"
9,"LOWER BACK",1,"Ecc09",2740,2760,2650,2450,2750,2550,0.073,200,2650,"Ecc",-20,200,TRUE,FALSE,TRUE,7.84,"young",31,178,92,"m"
9,"LOWER BACK",1,"Ecc10",2240,2240,2250,2150,2240,2200,0.018,40,2220,"Ecc",0,100,FALSE,FALSE,FALSE,1.82,"young",31,178,92,"m"
9,"LOWER BACK",2,"Ecc01",3280,3260,3250,3200,3270,3225,0.014,45,3247.5,"Ecc",20,50,FALSE,FALSE,FALSE,1.4,"young",31,178,92,"m"
9,"LOWER BACK",2,"Ecc02",2980,2980,2950,2950,2980,2950,0.01,30,2965,"Ecc",0,0,FALSE,FALSE,FALSE,1.02,"young",31,178,92,"m"
9,"LOWER BACK",2,"Ecc03",2680,2660,2650,2600,2670,2625,0.017,45,2647.5,"Ecc",20,50,FALSE,FALSE,FALSE,1.71,"young",31,178,92,"m"
9,"LOWER BACK",2,"Ecc04",2520,2480,2400,2450,2500,2425,0.03,75,2462.5,"Ecc",40,-50,FALSE,FALSE,FALSE,3.09,"young",31,178,92,"m"
9,"LOWER BACK",2,"Ecc05",2560,2540,2500,2550,2550,2525,0.01,25,2537.5,"Ecc",20,-50,FALSE,FALSE,FALSE,0.99,"young",31,178,92,"m"
9,"LOWER BACK",2,"Ecc06",2660,2640,2600,2650,2650,2625,0.009,25,2637.5,"Ecc",20,-50,FALSE,FALSE,FALSE,0.95,"young",31,178,92,"m"
9,"LOWER BACK",2,"Ecc07",2500,2460,2400,2350,2480,2375,0.042,105,2427.5,"Ecc",40,50,FALSE,FALSE,FALSE,4.42,"young",31,178,92,"m"
9,"LOWER BACK",2,"Ecc08",2380,2360,2200,2200,2370,2200,0.072,170,2285,"Ecc",20,0,FALSE,FALSE,FALSE,7.73,"young",31,178,92,"m"
9,"LOWER BACK",2,"Ecc09",2340,2340,2150,2100,2340,2125,0.092,215,2232.5,"Ecc",0,50,TRUE,FALSE,FALSE,10.12,"young",31,178,92,"m"
9,"LOWER BACK",2,"Ecc10",1920,1920,1950,1850,1920,1900,0.01,20,1910,"Ecc",0,100,FALSE,FALSE,FALSE,1.05,"young",31,178,92,"m"
9,"LOWER BACK",1,"Rep01",5140,5140,5300,5200,5140,5250,0.021,-110,5195,"Rep",0,100,TRUE,FALSE,FALSE,2.1,"young",31,178,92,"m"
9,"LOWER BACK",1,"Rep02",4700,4700,4700,4750,4700,4725,0.005,-25,4712.5,"Rep",0,-50,FALSE,FALSE,FALSE,0.53,"young",31,178,92,"m"
9,"LOWER BACK",1,"Rep03",4400,4420,4400,4500,4410,4450,0.009,-40,4430,"Rep",-20,-100,FALSE,FALSE,FALSE,0.9,"young",31,178,92,"m"
9,"LOWER BACK",1,"Rep04",4520,4480,4450,4450,4500,4450,0.011,50,4475,"Rep",40,0,FALSE,FALSE,FALSE,1.12,"young",31,178,92,"m"
9,"LOWER BACK",1,"Rep05",4340,4340,4400,4300,4340,4350,0.002,-10,4345,"Rep",0,100,FALSE,FALSE,FALSE,0.23,"young",31,178,92,"m"
9,"LOWER BACK",1,"Rep06",3720,3740,3700,3700,3730,3700,0.008,30,3715,"Rep",-20,0,FALSE,FALSE,FALSE,0.81,"young",31,178,92,"m"
9,"LOWER BACK",1,"Rep07",4140,4140,4100,4050,4140,4075,0.016,65,4107.5,"Rep",0,50,FALSE,FALSE,FALSE,1.6,"young",31,178,92,"m"
9,"LOWER BACK",1,"Rep08",4280,4280,4300,4250,4280,4275,0.001,5,4277.5,"Rep",0,50,FALSE,FALSE,FALSE,0.12,"young",31,178,92,"m"
9,"LOWER BACK",1,"Rep09",4180,4180,4200,4150,4180,4175,0.001,5,4177.5,"Rep",0,50,FALSE,FALSE,FALSE,0.12,"young",31,178,92,"m"
9,"LOWER BACK",1,"Rep10",3720,3720,3800,3950,3720,3875,0.042,-155,3797.5,"Rep",0,-150,TRUE,FALSE,FALSE,4,"young",31,178,92,"m"
9,"LOWER BACK",2,"Rep01",4480,4480,4700,4550,4480,4625,0.032,-145,4552.5,"Rep",0,150,TRUE,FALSE,FALSE,3.14,"young",31,178,92,"m"
9,"LOWER BACK",2,"Rep02",4440,4440,4400,4450,4440,4425,0.003,15,4432.5,"Rep",0,-50,FALSE,FALSE,FALSE,0.34,"young",31,178,92,"m"
9,"LOWER BACK",2,"Rep03",4120,4100,4150,4100,4110,4125,0.004,-15,4117.5,"Rep",20,50,FALSE,FALSE,FALSE,0.36,"young",31,178,92,"m"
9,"LOWER BACK",2,"Rep04",3860,3860,3800,3850,3860,3825,0.009,35,3842.5,"Rep",0,-50,FALSE,FALSE,FALSE,0.92,"young",31,178,92,"m"
9,"LOWER BACK",2,"Rep05",4060,4060,4100,4100,4060,4100,0.01,-40,4080,"Rep",0,0,FALSE,FALSE,FALSE,0.98,"young",31,178,92,"m"
9,"LOWER BACK",2,"Rep06",3960,3960,3950,3950,3960,3950,0.003,10,3955,"Rep",0,0,FALSE,FALSE,FALSE,0.25,"young",31,178,92,"m"
9,"LOWER BACK",2,"Rep07",3840,3840,3800,3750,3840,3775,0.017,65,3807.5,"Rep",0,50,FALSE,FALSE,FALSE,1.72,"young",31,178,92,"m"
9,"LOWER BACK",2,"Rep08",3680,3700,3650,3700,3690,3675,0.004,15,3682.5,"Rep",-20,-50,FALSE,FALSE,FALSE,0.41,"young",31,178,92,"m"
9,"LOWER BACK",2,"Rep09",3540,3540,3550,3500,3540,3525,0.004,15,3532.5,"Rep",0,50,FALSE,FALSE,FALSE,0.43,"young",31,178,92,"m"
9,"LOWER BACK",2,"Rep10",3180,3180,3400,3350,3180,3375,0.061,-195,3277.5,"Rep",0,50,TRUE,FALSE,FALSE,5.78,"young",31,178,92,"m"
9,"LOWER BACK",1,"TuT",43140,43140,43350,43300,43140,43325,0.004,-185,43232.5,"TuT",0,50,FALSE,FALSE,FALSE,0.43,"young",31,178,92,"m"
9,"LOWER BACK",2,"TuT",39160,39160,39500,39300,39160,39400,0.006,-240,39280,"TuT",0,200,TRUE,FALSE,FALSE,0.61,"young",31,178,92,"m"
9,"TOTAL ABDOMINAL",1,"Con01",1440,1400,1550,1500,1420,1525,0.074,-105,1472.5,"Con",40,50,FALSE,TRUE,FALSE,6.89,"young",31,178,92,"m"
9,"TOTAL ABDOMINAL",1,"Con02",1240,1280,1350,1350,1260,1350,0.071,-90,1305,"Con",-40,0,FALSE,TRUE,FALSE,6.67,"young",31,178,92,"m"
9,"TOTAL ABDOMINAL",1,"Con03",1280,1260,1400,1400,1270,1400,0.102,-130,1335,"Con",20,0,FALSE,FALSE,FALSE,9.29,"young",31,178,92,"m"
9,"TOTAL ABDOMINAL",1,"Con04",1220,1200,1250,1350,1210,1300,0.074,-90,1255,"Con",20,-100,FALSE,FALSE,FALSE,6.92,"young",31,178,92,"m"
9,"TOTAL ABDOMINAL",1,"Con05",1280,1300,1450,1250,1290,1350,0.047,-60,1320,"Con",-20,200,FALSE,FALSE,TRUE,4.44,"young",31,178,92,"m"
9,"TOTAL ABDOMINAL",1,"Con06",1260,1240,1400,1250,1250,1325,0.06,-75,1287.5,"Con",20,150,FALSE,FALSE,FALSE,5.66,"young",31,178,92,"m"
9,"TOTAL ABDOMINAL",1,"Con07",1300,1320,1350,1300,1310,1325,0.011,-15,1317.5,"Con",-20,50,FALSE,FALSE,FALSE,1.13,"young",31,178,92,"m"
9,"TOTAL ABDOMINAL",1,"Con08",1260,1220,1300,1300,1240,1300,0.048,-60,1270,"Con",40,0,FALSE,TRUE,FALSE,4.62,"young",31,178,92,"m"
9,"TOTAL ABDOMINAL",1,"Con09",1200,1200,1350,1500,1200,1425,0.188,-225,1312.5,"Con",0,-150,TRUE,FALSE,FALSE,15.79,"young",31,178,92,"m"
9,"TOTAL ABDOMINAL",1,"Con10",1360,1340,1550,1650,1350,1600,0.185,-250,1475,"Con",20,-100,TRUE,FALSE,FALSE,15.62,"young",31,178,92,"m"
9,"TOTAL ABDOMINAL",2,"Con01",1220,1200,1350,1300,1210,1325,0.095,-115,1267.5,"Con",20,50,FALSE,FALSE,FALSE,8.68,"young",31,178,92,"m"
9,"TOTAL ABDOMINAL",2,"Con02",1340,1320,1350,1400,1330,1375,0.034,-45,1352.5,"Con",20,-50,FALSE,FALSE,FALSE,3.27,"young",31,178,92,"m"
9,"TOTAL ABDOMINAL",2,"Con03",1300,1320,1450,1450,1310,1450,0.107,-140,1380,"Con",-20,0,FALSE,FALSE,FALSE,9.66,"young",31,178,92,"m"
9,"TOTAL ABDOMINAL",2,"Con04",1300,1340,1400,1450,1320,1425,0.08,-105,1372.5,"Con",-40,-50,FALSE,TRUE,FALSE,7.37,"young",31,178,92,"m"
9,"TOTAL ABDOMINAL",2,"Con05",1200,1220,1250,1300,1210,1275,0.054,-65,1242.5,"Con",-20,-50,FALSE,FALSE,FALSE,5.1,"young",31,178,92,"m"
9,"TOTAL ABDOMINAL",2,"Con06",1340,1340,1350,1350,1340,1350,0.007,-10,1345,"Con",0,0,FALSE,FALSE,FALSE,0.74,"young",31,178,92,"m"
9,"TOTAL ABDOMINAL",2,"Con07",1360,1360,1450,1400,1360,1425,0.048,-65,1392.5,"Con",0,50,FALSE,FALSE,FALSE,4.56,"young",31,178,92,"m"
9,"TOTAL ABDOMINAL",2,"Con08",1280,1280,1400,1400,1280,1400,0.094,-120,1340,"Con",0,0,FALSE,FALSE,FALSE,8.57,"young",31,178,92,"m"
9,"TOTAL ABDOMINAL",2,"Con09",1340,1340,1450,1400,1340,1425,0.063,-85,1382.5,"Con",0,50,FALSE,FALSE,FALSE,5.96,"young",31,178,92,"m"
9,"TOTAL ABDOMINAL",2,"Con10",1320,1340,1500,1450,1330,1475,0.109,-145,1402.5,"Con",-20,50,TRUE,FALSE,FALSE,9.83,"young",31,178,92,"m"
9,"TOTAL ABDOMINAL",1,"Ecc01",2380,2380,2300,2350,2380,2325,0.023,55,2352.5,"Ecc",0,-50,FALSE,FALSE,FALSE,2.37,"young",31,178,92,"m"
9,"TOTAL ABDOMINAL",1,"Ecc02",2400,2400,2300,2250,2400,2275,0.052,125,2337.5,"Ecc",0,50,FALSE,FALSE,FALSE,5.49,"young",31,178,92,"m"
9,"TOTAL ABDOMINAL",1,"Ecc03",2400,2440,2350,2300,2420,2325,0.039,95,2372.5,"Ecc",-40,50,FALSE,TRUE,FALSE,4.09,"young",31,178,92,"m"
9,"TOTAL ABDOMINAL",1,"Ecc04",2440,2440,2350,2400,2440,2375,0.027,65,2407.5,"Ecc",0,-50,FALSE,FALSE,FALSE,2.74,"young",31,178,92,"m"
9,"TOTAL ABDOMINAL",1,"Ecc05",2300,2280,2100,2300,2290,2200,0.039,90,2245,"Ecc",20,-200,FALSE,FALSE,TRUE,4.09,"young",31,178,92,"m"
9,"TOTAL ABDOMINAL",1,"Ecc06",2260,2260,2150,2300,2260,2225,0.015,35,2242.5,"Ecc",0,-150,FALSE,FALSE,FALSE,1.57,"young",31,178,92,"m"
9,"TOTAL ABDOMINAL",1,"Ecc07",2440,2460,2450,2400,2450,2425,0.01,25,2437.5,"Ecc",-20,50,FALSE,FALSE,FALSE,1.03,"young",31,178,92,"m"
9,"TOTAL ABDOMINAL",1,"Ecc08",2580,2600,2450,2400,2590,2425,0.064,165,2507.5,"Ecc",-20,50,TRUE,FALSE,FALSE,6.8,"young",31,178,92,"m"
9,"TOTAL ABDOMINAL",1,"Ecc09",2180,2220,2050,1900,2200,1975,0.102,225,2087.5,"Ecc",-40,150,TRUE,TRUE,FALSE,11.39,"young",31,178,92,"m"
9,"TOTAL ABDOMINAL",1,"Ecc10",2480,2460,2450,2400,2470,2425,0.018,45,2447.5,"Ecc",20,50,FALSE,FALSE,FALSE,1.86,"young",31,178,92,"m"
9,"TOTAL ABDOMINAL",2,"Ecc01",2780,2800,2750,2700,2790,2725,0.023,65,2757.5,"Ecc",-20,50,FALSE,FALSE,FALSE,2.39,"young",31,178,92,"m"
9,"TOTAL ABDOMINAL",2,"Ecc02",2560,2560,2500,2500,2560,2500,0.023,60,2530,"Ecc",0,0,FALSE,FALSE,FALSE,2.4,"young",31,178,92,"m"
9,"TOTAL ABDOMINAL",2,"Ecc03",2760,2720,2600,2600,2740,2600,0.051,140,2670,"Ecc",40,0,FALSE,TRUE,FALSE,5.38,"young",31,178,92,"m"
9,"TOTAL ABDOMINAL",2,"Ecc04",2760,2720,2700,2600,2740,2650,0.033,90,2695,"Ecc",40,100,FALSE,TRUE,FALSE,3.4,"young",31,178,92,"m"
9,"TOTAL ABDOMINAL",2,"Ecc05",2660,2660,2650,2650,2660,2650,0.004,10,2655,"Ecc",0,0,FALSE,FALSE,FALSE,0.38,"young",31,178,92,"m"
9,"TOTAL ABDOMINAL",2,"Ecc06",2700,2720,2600,2650,2710,2625,0.031,85,2667.5,"Ecc",-20,-50,FALSE,FALSE,FALSE,3.24,"young",31,178,92,"m"
9,"TOTAL ABDOMINAL",2,"Ecc07",2620,2600,2550,2550,2610,2550,0.023,60,2580,"Ecc",20,0,FALSE,FALSE,FALSE,2.35,"young",31,178,92,"m"
9,"TOTAL ABDOMINAL",2,"Ecc08",2560,2560,2450,2450,2560,2450,0.043,110,2505,"Ecc",0,0,FALSE,FALSE,FALSE,4.49,"young",31,178,92,"m"
9,"TOTAL ABDOMINAL",2,"Ecc09",2320,2300,2150,2250,2310,2200,0.048,110,2255,"Ecc",20,-100,FALSE,FALSE,FALSE,5,"young",31,178,92,"m"
9,"TOTAL ABDOMINAL",2,"Ecc10",2600,2600,2600,2550,2600,2575,0.01,25,2587.5,"Ecc",0,50,FALSE,FALSE,FALSE,0.97,"young",31,178,92,"m"
9,"TOTAL ABDOMINAL",1,"Rep01",3820,3780,3850,3850,3800,3850,0.013,-50,3825,"Rep",40,0,FALSE,FALSE,FALSE,1.3,"young",31,178,92,"m"
9,"TOTAL ABDOMINAL",1,"Rep02",3640,3680,3650,3600,3660,3625,0.01,35,3642.5,"Rep",-40,50,FALSE,FALSE,FALSE,0.97,"young",31,178,92,"m"
9,"TOTAL ABDOMINAL",1,"Rep03",3680,3700,3750,3700,3690,3725,0.009,-35,3707.5,"Rep",-20,50,FALSE,FALSE,FALSE,0.94,"young",31,178,92,"m"
9,"TOTAL ABDOMINAL",1,"Rep04",3660,3640,3600,3750,3650,3675,0.007,-25,3662.5,"Rep",20,-150,FALSE,FALSE,FALSE,0.68,"young",31,178,92,"m"
9,"TOTAL ABDOMINAL",1,"Rep05",3580,3580,3550,3550,3580,3550,0.008,30,3565,"Rep",0,0,FALSE,FALSE,FALSE,0.85,"young",31,178,92,"m"
9,"TOTAL ABDOMINAL",1,"Rep06",3520,3500,3550,3550,3510,3550,0.011,-40,3530,"Rep",20,0,FALSE,FALSE,FALSE,1.13,"young",31,178,92,"m"
9,"TOTAL ABDOMINAL",1,"Rep07",3740,3780,3800,3700,3760,3750,0.003,10,3755,"Rep",-40,100,FALSE,FALSE,FALSE,0.27,"young",31,178,92,"m"
9,"TOTAL ABDOMINAL",1,"Rep08",3840,3820,3750,3700,3830,3725,0.027,105,3777.5,"Rep",20,50,FALSE,FALSE,FALSE,2.82,"young",31,178,92,"m"
9,"TOTAL ABDOMINAL",1,"Rep09",3380,3420,3400,3400,3400,3400,0,0,3400,"Rep",-40,0,FALSE,FALSE,FALSE,0,"young",31,178,92,"m"
9,"TOTAL ABDOMINAL",1,"Rep10",3840,3800,4000,4050,3820,4025,0.054,-205,3922.5,"Rep",40,-50,TRUE,FALSE,FALSE,5.09,"young",31,178,92,"m"
9,"TOTAL ABDOMINAL",2,"Rep01",4000,4000,4100,4000,4000,4050,0.012,-50,4025,"Rep",0,100,FALSE,FALSE,FALSE,1.23,"young",31,178,92,"m"
9,"TOTAL ABDOMINAL",2,"Rep02",3900,3880,3850,3900,3890,3875,0.004,15,3882.5,"Rep",20,-50,FALSE,FALSE,FALSE,0.39,"young",31,178,92,"m"
9,"TOTAL ABDOMINAL",2,"Rep03",4060,4040,4050,4050,4050,4050,0,0,4050,"Rep",20,0,FALSE,FALSE,FALSE,0,"young",31,178,92,"m"
9,"TOTAL ABDOMINAL",2,"Rep04",4060,4060,4100,4050,4060,4075,0.004,-15,4067.5,"Rep",0,50,FALSE,FALSE,FALSE,0.37,"young",31,178,92,"m"
9,"TOTAL ABDOMINAL",2,"Rep05",3860,3880,3900,3950,3870,3925,0.014,-55,3897.5,"Rep",-20,-50,FALSE,FALSE,FALSE,1.4,"young",31,178,92,"m"
9,"TOTAL ABDOMINAL",2,"Rep06",4040,4060,3950,4000,4050,3975,0.019,75,4012.5,"Rep",-20,-50,FALSE,FALSE,FALSE,1.89,"young",31,178,92,"m"
9,"TOTAL ABDOMINAL",2,"Rep07",3980,3960,4000,3950,3970,3975,0.001,-5,3972.5,"Rep",20,50,FALSE,FALSE,FALSE,0.13,"young",31,178,92,"m"
9,"TOTAL ABDOMINAL",2,"Rep08",3840,3840,3850,3850,3840,3850,0.003,-10,3845,"Rep",0,0,FALSE,FALSE,FALSE,0.26,"young",31,178,92,"m"
9,"TOTAL ABDOMINAL",2,"Rep09",3660,3640,3600,3650,3650,3625,0.007,25,3637.5,"Rep",20,-50,FALSE,FALSE,FALSE,0.69,"young",31,178,92,"m"
9,"TOTAL ABDOMINAL",2,"Rep10",3920,3940,4100,4000,3930,4050,0.031,-120,3990,"Rep",-20,100,FALSE,FALSE,FALSE,2.96,"young",31,178,92,"m"
9,"TOTAL ABDOMINAL",1,"TuT",36700,36700,36900,36850,36700,36875,0.005,-175,36787.5,"TuT",0,50,FALSE,FALSE,FALSE,0.47,"young",31,178,92,"m"
9,"TOTAL ABDOMINAL",2,"TuT",39320,39300,39500,39400,39310,39450,0.004,-140,39380,"TuT",20,100,FALSE,FALSE,FALSE,0.35,"young",31,178,92,"m"
9,"VERTICAL TRACTION",1,"Con01",1100,1060,1700,3600,1080,2650,1.454,-1570,1865,"Con",40,-1900,TRUE,FALSE,TRUE,59.25,"young",31,178,92,"m"
9,"VERTICAL TRACTION",1,"Con02",1080,1060,1950,1250,1070,1600,0.495,-530,1335,"Con",20,700,TRUE,FALSE,TRUE,33.12,"young",31,178,92,"m"
9,"VERTICAL TRACTION",1,"Con03",1320,1320,2050,1500,1320,1775,0.345,-455,1547.5,"Con",0,550,TRUE,FALSE,TRUE,25.63,"young",31,178,92,"m"
9,"VERTICAL TRACTION",1,"Con04",1340,1360,1750,1500,1350,1625,0.204,-275,1487.5,"Con",-20,250,FALSE,FALSE,TRUE,16.92,"young",31,178,92,"m"
9,"VERTICAL TRACTION",1,"Con05",1140,1160,1850,1350,1150,1600,0.391,-450,1375,"Con",-20,500,TRUE,FALSE,TRUE,28.12,"young",31,178,92,"m"
9,"VERTICAL TRACTION",1,"Con06",1240,1280,1450,1250,1260,1350,0.071,-90,1305,"Con",-40,200,FALSE,FALSE,TRUE,6.67,"young",31,178,92,"m"
9,"VERTICAL TRACTION",1,"Con07",1340,1340,1450,1300,1340,1375,0.026,-35,1357.5,"Con",0,150,FALSE,FALSE,FALSE,2.55,"young",31,178,92,"m"
9,"VERTICAL TRACTION",1,"Con08",1340,1360,1250,1500,1350,1375,0.019,-25,1362.5,"Con",-20,-250,FALSE,FALSE,TRUE,1.82,"young",31,178,92,"m"
9,"VERTICAL TRACTION",1,"Con09",1300,1280,1150,1550,1290,1350,0.047,-60,1320,"Con",20,-400,FALSE,FALSE,TRUE,4.44,"young",31,178,92,"m"
9,"VERTICAL TRACTION",1,"Con10",1360,1400,1100,2000,1380,1550,0.123,-170,1465,"Con",-40,-900,FALSE,FALSE,TRUE,10.97,"young",31,178,92,"m"
9,"VERTICAL TRACTION",2,"Con01",1120,1120,4650,1500,1120,3075,1.746,-1955,2097.5,"Con",0,3150,TRUE,FALSE,TRUE,63.58,"young",31,178,92,"m"
9,"VERTICAL TRACTION",2,"Con02",1280,1280,1900,1350,1280,1625,0.27,-345,1452.5,"Con",0,550,TRUE,FALSE,TRUE,21.23,"young",31,178,92,"m"
9,"VERTICAL TRACTION",2,"Con03",1120,1100,1850,1500,1110,1675,0.509,-565,1392.5,"Con",20,350,TRUE,FALSE,TRUE,33.73,"young",31,178,92,"m"
9,"VERTICAL TRACTION",2,"Con04",1100,1120,1350,1400,1110,1375,0.239,-265,1242.5,"Con",-20,-50,FALSE,FALSE,FALSE,19.27,"young",31,178,92,"m"
9,"VERTICAL TRACTION",2,"Con05",1400,1380,1550,1300,1390,1425,0.025,-35,1407.5,"Con",20,250,FALSE,FALSE,TRUE,2.46,"young",31,178,92,"m"
9,"VERTICAL TRACTION",2,"Con06",1300,1320,1400,1500,1310,1450,0.107,-140,1380,"Con",-20,-100,FALSE,FALSE,FALSE,9.66,"young",31,178,92,"m"
9,"VERTICAL TRACTION",2,"Con07",1280,1280,1400,1350,1280,1375,0.074,-95,1327.5,"Con",0,50,FALSE,FALSE,FALSE,6.91,"young",31,178,92,"m"
9,"VERTICAL TRACTION",2,"Con08",1320,1300,1300,1450,1310,1375,0.05,-65,1342.5,"Con",20,-150,FALSE,FALSE,FALSE,4.73,"young",31,178,92,"m"
9,"VERTICAL TRACTION",2,"Con09",1220,1220,1100,1350,1220,1225,0.004,-5,1222.5,"Con",0,-250,FALSE,FALSE,TRUE,0.41,"young",31,178,92,"m"
9,"VERTICAL TRACTION",2,"Con10",1180,1200,1050,1250,1190,1150,0.034,40,1170,"Con",-20,-200,FALSE,FALSE,TRUE,3.48,"young",31,178,92,"m"
9,"VERTICAL TRACTION",1,"Ecc01",3500,3500,2850,2850,3500,2850,0.186,650,3175,"Ecc",0,0,TRUE,FALSE,FALSE,22.81,"young",31,178,92,"m"
9,"VERTICAL TRACTION",1,"Ecc02",3140,3140,2200,3000,3140,2600,0.172,540,2870,"Ecc",0,-800,TRUE,FALSE,TRUE,20.77,"young",31,178,92,"m"
9,"VERTICAL TRACTION",1,"Ecc03",3120,3120,2350,2900,3120,2625,0.159,495,2872.5,"Ecc",0,-550,TRUE,FALSE,TRUE,18.86,"young",31,178,92,"m"
9,"VERTICAL TRACTION",1,"Ecc04",2780,2760,2450,2600,2770,2525,0.088,245,2647.5,"Ecc",20,-150,FALSE,FALSE,FALSE,9.7,"young",31,178,92,"m"
9,"VERTICAL TRACTION",1,"Ecc05",2860,2840,2250,2750,2850,2500,0.123,350,2675,"Ecc",20,-500,TRUE,FALSE,TRUE,14,"young",31,178,92,"m"
9,"VERTICAL TRACTION",1,"Ecc06",3000,2960,2800,3050,2980,2925,0.018,55,2952.5,"Ecc",40,-250,FALSE,FALSE,TRUE,1.88,"young",31,178,92,"m"
9,"VERTICAL TRACTION",1,"Ecc07",2900,2880,2900,2850,2890,2875,0.005,15,2882.5,"Ecc",20,50,FALSE,FALSE,FALSE,0.52,"young",31,178,92,"m"
9,"VERTICAL TRACTION",1,"Ecc08",3100,3100,3200,2900,3100,3050,0.016,50,3075,"Ecc",0,300,FALSE,FALSE,TRUE,1.64,"young",31,178,92,"m"
9,"VERTICAL TRACTION",1,"Ecc09",3120,3120,3350,2750,3120,3050,0.022,70,3085,"Ecc",0,600,FALSE,FALSE,TRUE,2.3,"young",31,178,92,"m"
9,"VERTICAL TRACTION",1,"Ecc10",2600,2600,2550,2050,2600,2300,0.115,300,2450,"Ecc",0,500,TRUE,FALSE,TRUE,13.04,"young",31,178,92,"m"
9,"VERTICAL TRACTION",2,"Ecc01",3420,3420,2300,1300,3420,1800,0.474,1620,2610,"Ecc",0,1000,TRUE,FALSE,TRUE,90,"young",31,178,92,"m"
9,"VERTICAL TRACTION",2,"Ecc02",2880,2880,2350,3200,2880,2775,0.036,105,2827.5,"Ecc",0,-850,FALSE,FALSE,TRUE,3.78,"young",31,178,92,"m"
9,"VERTICAL TRACTION",2,"Ecc03",3020,3040,2350,2650,3030,2500,0.175,530,2765,"Ecc",-20,-300,TRUE,FALSE,TRUE,21.2,"young",31,178,92,"m"
9,"VERTICAL TRACTION",2,"Ecc04",2940,2940,2750,2750,2940,2750,0.065,190,2845,"Ecc",0,0,FALSE,FALSE,FALSE,6.91,"young",31,178,92,"m"
9,"VERTICAL TRACTION",2,"Ecc05",2680,2680,2550,2800,2680,2675,0.002,5,2677.5,"Ecc",0,-250,FALSE,FALSE,TRUE,0.19,"young",31,178,92,"m"
9,"VERTICAL TRACTION",2,"Ecc06",2900,2880,2800,2600,2890,2700,0.066,190,2795,"Ecc",20,200,FALSE,FALSE,TRUE,7.04,"young",31,178,92,"m"
9,"VERTICAL TRACTION",2,"Ecc07",3020,3020,2950,2800,3020,2875,0.048,145,2947.5,"Ecc",0,150,FALSE,FALSE,FALSE,5.04,"young",31,178,92,"m"
9,"VERTICAL TRACTION",2,"Ecc08",2780,2800,2850,2900,2790,2875,0.03,-85,2832.5,"Ecc",-20,-50,FALSE,FALSE,FALSE,2.96,"young",31,178,92,"m"
9,"VERTICAL TRACTION",2,"Ecc09",2880,2880,3000,2750,2880,2875,0.002,5,2877.5,"Ecc",0,250,FALSE,FALSE,TRUE,0.17,"young",31,178,92,"m"
9,"VERTICAL TRACTION",2,"Ecc10",2160,2180,2300,2800,2170,2550,0.175,-380,2360,"Ecc",-20,-500,TRUE,FALSE,TRUE,14.9,"young",31,178,92,"m"
9,"VERTICAL TRACTION",1,"Rep01",4600,4560,4550,6450,4580,5500,0.201,-920,5040,"Rep",40,-1900,TRUE,FALSE,TRUE,16.73,"young",31,178,92,"m"
9,"VERTICAL TRACTION",1,"Rep02",4220,4200,4150,4250,4210,4200,0.002,10,4205,"Rep",20,-100,FALSE,FALSE,FALSE,0.24,"young",31,178,92,"m"
9,"VERTICAL TRACTION",1,"Rep03",4440,4440,4400,4400,4440,4400,0.009,40,4420,"Rep",0,0,FALSE,FALSE,FALSE,0.91,"young",31,178,92,"m"
9,"VERTICAL TRACTION",1,"Rep04",4120,4120,4200,4100,4120,4150,0.007,-30,4135,"Rep",0,100,FALSE,FALSE,FALSE,0.72,"young",31,178,92,"m"
9,"VERTICAL TRACTION",1,"Rep05",4000,4000,4100,4100,4000,4100,0.025,-100,4050,"Rep",0,0,FALSE,FALSE,FALSE,2.44,"young",31,178,92,"m"
9,"VERTICAL TRACTION",1,"Rep06",4240,4240,4250,4300,4240,4275,0.008,-35,4257.5,"Rep",0,-50,FALSE,FALSE,FALSE,0.82,"young",31,178,92,"m"
9,"VERTICAL TRACTION",1,"Rep07",4240,4220,4350,4150,4230,4250,0.005,-20,4240,"Rep",20,200,FALSE,FALSE,TRUE,0.47,"young",31,178,92,"m"
9,"VERTICAL TRACTION",1,"Rep08",4440,4460,4450,4400,4450,4425,0.006,25,4437.5,"Rep",-20,50,FALSE,FALSE,FALSE,0.56,"young",31,178,92,"m"
9,"VERTICAL TRACTION",1,"Rep09",4420,4400,4500,4300,4410,4400,0.002,10,4405,"Rep",20,200,FALSE,FALSE,TRUE,0.23,"young",31,178,92,"m"
9,"VERTICAL TRACTION",1,"Rep10",3960,4000,3650,4050,3980,3850,0.033,130,3915,"Rep",-40,-400,FALSE,FALSE,TRUE,3.38,"young",31,178,92,"m"
9,"VERTICAL TRACTION",2,"Rep01",4540,4540,6950,2800,4540,4875,0.074,-335,4707.5,"Rep",0,4150,TRUE,FALSE,TRUE,6.87,"young",31,178,92,"m"
9,"VERTICAL TRACTION",2,"Rep02",4160,4160,4250,4550,4160,4400,0.058,-240,4280,"Rep",0,-300,TRUE,FALSE,TRUE,5.45,"young",31,178,92,"m"
9,"VERTICAL TRACTION",2,"Rep03",4140,4140,4200,4150,4140,4175,0.008,-35,4157.5,"Rep",0,50,FALSE,FALSE,FALSE,0.84,"young",31,178,92,"m"
9,"VERTICAL TRACTION",2,"Rep04",4040,4060,4100,4150,4050,4125,0.019,-75,4087.5,"Rep",-20,-50,FALSE,FALSE,FALSE,1.82,"young",31,178,92,"m"
9,"VERTICAL TRACTION",2,"Rep05",4080,4060,4100,4100,4070,4100,0.007,-30,4085,"Rep",20,0,FALSE,FALSE,FALSE,0.73,"young",31,178,92,"m"
9,"VERTICAL TRACTION",2,"Rep06",4200,4200,4200,4100,4200,4150,0.012,50,4175,"Rep",0,100,FALSE,FALSE,FALSE,1.2,"young",31,178,92,"m"
9,"VERTICAL TRACTION",2,"Rep07",4300,4300,4350,4150,4300,4250,0.012,50,4275,"Rep",0,200,FALSE,FALSE,TRUE,1.18,"young",31,178,92,"m"
9,"VERTICAL TRACTION",2,"Rep08",4100,4100,4150,4350,4100,4250,0.037,-150,4175,"Rep",0,-200,TRUE,FALSE,TRUE,3.53,"young",31,178,92,"m"
9,"VERTICAL TRACTION",2,"Rep09",4100,4100,4100,4100,4100,4100,0,0,4100,"Rep",0,0,FALSE,FALSE,FALSE,0,"young",31,178,92,"m"
9,"VERTICAL TRACTION",2,"Rep10",3340,3380,3350,4050,3360,3700,0.101,-340,3530,"Rep",-40,-700,TRUE,FALSE,TRUE,9.19,"young",31,178,92,"m"
9,"VERTICAL TRACTION",1,"TuT",42680,42640,42600,44500,42660,43550,0.021,-890,43105,"TuT",40,-1900,FALSE,FALSE,TRUE,2.04,"young",31,178,92,"m"
9,"VERTICAL TRACTION",2,"TuT",41000,41040,43750,40500,41020,42125,0.027,-1105,41572.5,"TuT",-40,3250,FALSE,FALSE,TRUE,2.62,"young",31,178,92,"m"
9,"CHEST PRESS",1,"Con01",1140,1160,4900,5800,1150,5350,3.652,-4200,3250,"Con",-20,-900,TRUE,FALSE,TRUE,78.5,"young",31,178,92,"m"
9,"CHEST PRESS",1,"Con02",1140,1160,1850,1850,1150,1850,0.609,-700,1500,"Con",-20,0,TRUE,FALSE,FALSE,37.84,"young",31,178,92,"m"
9,"CHEST PRESS",1,"Con03",1240,1240,1550,1400,1240,1475,0.19,-235,1357.5,"Con",0,150,FALSE,FALSE,FALSE,15.93,"young",31,178,92,"m"
9,"CHEST PRESS",1,"Con04",1100,1100,1950,1250,1100,1600,0.455,-500,1350,"Con",0,700,TRUE,FALSE,TRUE,31.25,"young",31,178,92,"m"
9,"CHEST PRESS",1,"Con05",1200,1240,2050,1150,1220,1600,0.311,-380,1410,"Con",-40,900,TRUE,TRUE,TRUE,23.75,"young",31,178,92,"m"
9,"CHEST PRESS",1,"Con06",1160,1180,1450,1150,1170,1300,0.111,-130,1235,"Con",-20,300,FALSE,FALSE,FALSE,10,"young",31,178,92,"m"
9,"CHEST PRESS",1,"Con07",1180,1180,1250,1300,1180,1275,0.081,-95,1227.5,"Con",0,-50,FALSE,FALSE,FALSE,7.45,"young",31,178,92,"m"
9,"CHEST PRESS",1,"Con08",1080,1080,1100,1850,1080,1475,0.366,-395,1277.5,"Con",0,-750,TRUE,FALSE,TRUE,26.78,"young",31,178,92,"m"
9,"CHEST PRESS",1,"Con09",1080,1080,1100,2000,1080,1550,0.435,-470,1315,"Con",0,-900,TRUE,FALSE,TRUE,30.32,"young",31,178,92,"m"
9,"CHEST PRESS",1,"Con10",1260,1280,1050,1900,1270,1475,0.161,-205,1372.5,"Con",-20,-850,FALSE,FALSE,TRUE,13.9,"young",31,178,92,"m"
9,"CHEST PRESS",2,"Con01",1140,1140,2100,6350,1140,4225,2.706,-3085,2682.5,"Con",0,-4250,TRUE,FALSE,TRUE,73.02,"young",31,178,92,"m"
9,"CHEST PRESS",2,"Con02",1060,1080,1500,1500,1070,1500,0.402,-430,1285,"Con",-20,0,TRUE,FALSE,FALSE,28.67,"young",31,178,92,"m"
9,"CHEST PRESS",2,"Con03",1220,1240,1900,1800,1230,1850,0.504,-620,1540,"Con",-20,100,TRUE,FALSE,FALSE,33.51,"young",31,178,92,"m"
9,"CHEST PRESS",2,"Con04",1260,1300,2050,1850,1280,1950,0.523,-670,1615,"Con",-40,200,TRUE,TRUE,FALSE,34.36,"young",31,178,92,"m"
9,"CHEST PRESS",2,"Con05",1100,1120,1400,1200,1110,1300,0.171,-190,1205,"Con",-20,200,FALSE,FALSE,FALSE,14.62,"young",31,178,92,"m"
9,"CHEST PRESS",2,"Con06",1180,1200,1350,1200,1190,1275,0.071,-85,1232.5,"Con",-20,150,FALSE,FALSE,FALSE,6.67,"young",31,178,92,"m"
9,"CHEST PRESS",2,"Con07",1240,1240,1350,1200,1240,1275,0.028,-35,1257.5,"Con",0,150,FALSE,FALSE,FALSE,2.75,"young",31,178,92,"m"
9,"CHEST PRESS",2,"Con08",1180,1220,1250,1300,1200,1275,0.062,-75,1237.5,"Con",-40,-50,FALSE,TRUE,FALSE,5.88,"young",31,178,92,"m"
9,"CHEST PRESS",2,"Con09",1340,1340,1250,1450,1340,1350,0.007,-10,1345,"Con",0,-200,FALSE,FALSE,FALSE,0.74,"young",31,178,92,"m"
9,"CHEST PRESS",2,"Con10",1240,1260,1050,1450,1250,1250,0,0,1250,"Con",-20,-400,FALSE,FALSE,TRUE,0,"young",31,178,92,"m"
9,"CHEST PRESS",1,"Ecc01",2860,2820,2150,1950,2840,2050,0.278,790,2445,"Ecc",40,200,TRUE,TRUE,FALSE,38.54,"young",31,178,92,"m"
9,"CHEST PRESS",1,"Ecc02",2700,2700,2000,2100,2700,2050,0.241,650,2375,"Ecc",0,-100,TRUE,FALSE,FALSE,31.71,"young",31,178,92,"m"
9,"CHEST PRESS",1,"Ecc03",2720,2700,2400,2550,2710,2475,0.087,235,2592.5,"Ecc",20,-150,FALSE,FALSE,FALSE,9.49,"young",31,178,92,"m"
9,"CHEST PRESS",1,"Ecc04",2580,2580,1700,2500,2580,2100,0.186,480,2340,"Ecc",0,-800,TRUE,FALSE,TRUE,22.86,"young",31,178,92,"m"
9,"CHEST PRESS",1,"Ecc05",2520,2500,1700,2600,2510,2150,0.143,360,2330,"Ecc",20,-900,TRUE,FALSE,TRUE,16.74,"young",31,178,92,"m"
9,"CHEST PRESS",1,"Ecc06",2740,2720,2550,2700,2730,2625,0.038,105,2677.5,"Ecc",20,-150,FALSE,FALSE,FALSE,4,"young",31,178,92,"m"
9,"CHEST PRESS",1,"Ecc07",2780,2780,2700,2600,2780,2650,0.047,130,2715,"Ecc",0,100,FALSE,FALSE,FALSE,4.91,"young",31,178,92,"m"
9,"CHEST PRESS",1,"Ecc08",2860,2840,2850,2050,2850,2450,0.14,400,2650,"Ecc",20,800,TRUE,FALSE,TRUE,16.33,"young",31,178,92,"m"
9,"CHEST PRESS",1,"Ecc09",3040,3060,3150,2050,3050,2600,0.148,450,2825,"Ecc",-20,1100,TRUE,FALSE,TRUE,17.31,"young",31,178,92,"m"
9,"CHEST PRESS",1,"Ecc10",2740,2740,2900,1250,2740,2075,0.243,665,2407.5,"Ecc",0,1650,TRUE,FALSE,TRUE,32.05,"young",31,178,92,"m"
9,"CHEST PRESS",2,"Ecc01",3300,3300,2350,2250,3300,2300,0.303,1000,2800,"Ecc",0,100,TRUE,FALSE,FALSE,43.48,"young",31,178,92,"m"
9,"CHEST PRESS",2,"Ecc02",2660,2640,2300,2250,2650,2275,0.142,375,2462.5,"Ecc",20,50,TRUE,FALSE,FALSE,16.48,"young",31,178,92,"m"
9,"CHEST PRESS",2,"Ecc03",2580,2540,1900,2050,2560,1975,0.229,585,2267.5,"Ecc",40,-150,TRUE,TRUE,FALSE,29.62,"young",31,178,92,"m"
9,"CHEST PRESS",2,"Ecc04",2760,2720,1950,2150,2740,2050,0.252,690,2395,"Ecc",40,-200,TRUE,TRUE,FALSE,33.66,"young",31,178,92,"m"
9,"CHEST PRESS",2,"Ecc05",2860,2860,2600,2800,2860,2700,0.056,160,2780,"Ecc",0,-200,FALSE,FALSE,FALSE,5.93,"young",31,178,92,"m"
9,"CHEST PRESS",2,"Ecc06",2820,2800,2700,2850,2810,2775,0.012,35,2792.5,"Ecc",20,-150,FALSE,FALSE,FALSE,1.26,"young",31,178,92,"m"
9,"CHEST PRESS",2,"Ecc07",2940,2920,2800,2900,2930,2850,0.027,80,2890,"Ecc",20,-100,FALSE,FALSE,FALSE,2.81,"young",31,178,92,"m"
9,"CHEST PRESS",2,"Ecc08",2980,2960,2950,2850,2970,2900,0.024,70,2935,"Ecc",20,100,FALSE,FALSE,FALSE,2.41,"young",31,178,92,"m"
9,"CHEST PRESS",2,"Ecc09",2760,2760,2900,2650,2760,2775,0.005,-15,2767.5,"Ecc",0,250,FALSE,FALSE,TRUE,0.54,"young",31,178,92,"m"
9,"CHEST PRESS",2,"Ecc10",2520,2560,3000,2700,2540,2850,0.122,-310,2695,"Ecc",-40,300,FALSE,TRUE,TRUE,10.88,"young",31,178,92,"m"
9,"CHEST PRESS",1,"Rep01",4000,3980,7050,7750,3990,7400,0.855,-3410,5695,"Rep",20,-700,TRUE,FALSE,TRUE,46.08,"young",31,178,92,"m"
9,"CHEST PRESS",1,"Rep02",3840,3860,3850,3950,3850,3900,0.013,-50,3875,"Rep",-20,-100,FALSE,FALSE,FALSE,1.28,"young",31,178,92,"m"
9,"CHEST PRESS",1,"Rep03",3960,3940,3950,3950,3950,3950,0,0,3950,"Rep",20,0,FALSE,FALSE,FALSE,0,"young",31,178,92,"m"
9,"CHEST PRESS",1,"Rep04",3680,3680,3650,3750,3680,3700,0.005,-20,3690,"Rep",0,-100,FALSE,FALSE,FALSE,0.54,"young",31,178,92,"m"
9,"CHEST PRESS",1,"Rep05",3720,3740,3750,3750,3730,3750,0.005,-20,3740,"Rep",-20,0,FALSE,FALSE,FALSE,0.53,"young",31,178,92,"m"
9,"CHEST PRESS",1,"Rep06",3900,3900,4000,3850,3900,3925,0.006,-25,3912.5,"Rep",0,150,FALSE,FALSE,FALSE,0.64,"young",31,178,92,"m"
9,"CHEST PRESS",1,"Rep07",3960,3960,3950,3900,3960,3925,0.009,35,3942.5,"Rep",0,50,FALSE,FALSE,FALSE,0.89,"young",31,178,92,"m"
9,"CHEST PRESS",1,"Rep08",3940,3920,3950,3900,3930,3925,0.001,5,3927.5,"Rep",20,50,FALSE,FALSE,FALSE,0.13,"young",31,178,92,"m"
9,"CHEST PRESS",1,"Rep09",4120,4140,4250,4050,4130,4150,0.005,-20,4140,"Rep",-20,200,FALSE,FALSE,TRUE,0.48,"young",31,178,92,"m"
9,"CHEST PRESS",1,"Rep10",4000,4020,3950,3150,4010,3550,0.115,460,3780,"Rep",-20,800,TRUE,FALSE,TRUE,12.96,"young",31,178,92,"m"
9,"CHEST PRESS",2,"Rep01",4440,4440,4450,8600,4440,6525,0.47,-2085,5482.5,"Rep",0,-4150,TRUE,FALSE,TRUE,31.95,"young",31,178,92,"m"
9,"CHEST PRESS",2,"Rep02",3720,3720,3800,3750,3720,3775,0.015,-55,3747.5,"Rep",0,50,FALSE,FALSE,FALSE,1.46,"young",31,178,92,"m"
9,"CHEST PRESS",2,"Rep03",3800,3780,3800,3850,3790,3825,0.009,-35,3807.5,"Rep",20,-50,FALSE,FALSE,FALSE,0.92,"young",31,178,92,"m"
9,"CHEST PRESS",2,"Rep04",4020,4020,4000,4000,4020,4000,0.005,20,4010,"Rep",0,0,FALSE,FALSE,FALSE,0.5,"young",31,178,92,"m"
9,"CHEST PRESS",2,"Rep05",3960,3980,4000,4000,3970,4000,0.008,-30,3985,"Rep",-20,0,FALSE,FALSE,FALSE,0.75,"young",31,178,92,"m"
9,"CHEST PRESS",2,"Rep06",4000,4000,4050,4050,4000,4050,0.012,-50,4025,"Rep",0,0,FALSE,FALSE,FALSE,1.23,"young",31,178,92,"m"
9,"CHEST PRESS",2,"Rep07",4180,4160,4150,4100,4170,4125,0.011,45,4147.5,"Rep",20,50,FALSE,FALSE,FALSE,1.09,"young",31,178,92,"m"
9,"CHEST PRESS",2,"Rep08",4160,4180,4200,4150,4170,4175,0.001,-5,4172.5,"Rep",-20,50,FALSE,FALSE,FALSE,0.12,"young",31,178,92,"m"
9,"CHEST PRESS",2,"Rep09",4100,4100,4150,4100,4100,4125,0.006,-25,4112.5,"Rep",0,50,FALSE,FALSE,FALSE,0.61,"young",31,178,92,"m"
9,"CHEST PRESS",2,"Rep10",3760,3820,4050,4150,3790,4100,0.082,-310,3945,"Rep",-60,-100,TRUE,FALSE,FALSE,7.56,"young",31,178,92,"m"
9,"CHEST PRESS",1,"TuT",39120,39140,42350,42000,39130,42175,0.078,-3045,40652.5,"TuT",-20,350,TRUE,FALSE,FALSE,7.22,"young",31,178,92,"m"
9,"CHEST PRESS",2,"TuT",40140,40200,40650,44750,40170,42700,0.063,-2530,41435,"TuT",-60,-4100,TRUE,FALSE,TRUE,5.93,"young",31,178,92,"m"
10,"LEG PRESS",1,"Con01",1060,1040,1800,1600,1050,1700,0.619,-650,1375,"Con",20,200,TRUE,FALSE,TRUE,38.24,"young",43,185,88,"m"
10,"LEG PRESS",1,"Con02",980,1020,1000,1050,1000,1025,0.025,-25,1012.5,"Con",-40,-50,FALSE,FALSE,FALSE,2.44,"young",43,185,88,"m"
10,"LEG PRESS",1,"Con03",940,940,1000,1050,940,1025,0.09,-85,982.5,"Con",0,-50,FALSE,FALSE,FALSE,8.29,"young",43,185,88,"m"
10,"LEG PRESS",1,"Con04",940,920,1050,1150,930,1100,0.183,-170,1015,"Con",20,-100,FALSE,FALSE,FALSE,15.45,"young",43,185,88,"m"
10,"LEG PRESS",1,"Con05",1080,1060,1350,1450,1070,1400,0.308,-330,1235,"Con",20,-100,FALSE,FALSE,FALSE,23.57,"young",43,185,88,"m"
10,"LEG PRESS",1,"Con06",1000,1000,1600,1650,1000,1625,0.625,-625,1312.5,"Con",0,-50,TRUE,FALSE,FALSE,38.46,"young",43,185,88,"m"
10,"LEG PRESS",1,"Con07",960,960,1650,1550,960,1600,0.667,-640,1280,"Con",0,100,TRUE,FALSE,FALSE,40,"young",43,185,88,"m"
10,"LEG PRESS",1,"Con08",980,960,1250,1200,970,1225,0.263,-255,1097.5,"Con",20,50,FALSE,FALSE,FALSE,20.82,"young",43,185,88,"m"
10,"LEG PRESS",1,"Con09",960,960,1600,1550,960,1575,0.641,-615,1267.5,"Con",0,50,TRUE,FALSE,FALSE,39.05,"young",43,185,88,"m"
10,"LEG PRESS",1,"Con10",900,920,1650,1600,910,1625,0.786,-715,1267.5,"Con",-20,50,TRUE,FALSE,FALSE,44,"young",43,185,88,"m"
10,"LEG PRESS",2,"Con01",960,980,1400,1250,970,1325,0.366,-355,1147.5,"Con",-20,150,TRUE,FALSE,FALSE,26.79,"young",43,185,88,"m"
10,"LEG PRESS",2,"Con02",980,960,1100,1250,970,1175,0.211,-205,1072.5,"Con",20,-150,FALSE,FALSE,FALSE,17.45,"young",43,185,88,"m"
10,"LEG PRESS",2,"Con03",960,960,1100,1150,960,1125,0.172,-165,1042.5,"Con",0,-50,FALSE,FALSE,FALSE,14.67,"young",43,185,88,"m"
10,"LEG PRESS",2,"Con04",1040,1040,1100,1150,1040,1125,0.082,-85,1082.5,"Con",0,-50,FALSE,FALSE,FALSE,7.56,"young",43,185,88,"m"
10,"LEG PRESS",2,"Con05",1100,1060,1200,1250,1080,1225,0.134,-145,1152.5,"Con",40,-50,FALSE,FALSE,FALSE,11.84,"young",43,185,88,"m"
10,"LEG PRESS",2,"Con06",1020,1020,1200,1150,1020,1175,0.152,-155,1097.5,"Con",0,50,FALSE,FALSE,FALSE,13.19,"young",43,185,88,"m"
10,"LEG PRESS",2,"Con07",1060,1060,1300,1200,1060,1250,0.179,-190,1155,"Con",0,100,FALSE,FALSE,FALSE,15.2,"young",43,185,88,"m"
10,"LEG PRESS",2,"Con08",1000,1000,1450,1400,1000,1425,0.425,-425,1212.5,"Con",0,50,TRUE,FALSE,FALSE,29.82,"young",43,185,88,"m"
10,"LEG PRESS",2,"Con09",1000,980,1600,1550,990,1575,0.591,-585,1282.5,"Con",20,50,TRUE,FALSE,FALSE,37.14,"young",43,185,88,"m"
10,"LEG PRESS",2,"Con10",1080,1100,1650,1600,1090,1625,0.491,-535,1357.5,"Con",-20,50,TRUE,FALSE,FALSE,32.92,"young",43,185,88,"m"
10,"LEG PRESS",1,"Ecc01",2660,2680,2500,2500,2670,2500,0.064,170,2585,"Ecc",-20,0,FALSE,FALSE,FALSE,6.8,"young",43,185,88,"m"
10,"LEG PRESS",1,"Ecc02",2160,2140,2150,2100,2150,2125,0.012,25,2137.5,"Ecc",20,50,FALSE,FALSE,FALSE,1.18,"young",43,185,88,"m"
10,"LEG PRESS",1,"Ecc03",2060,2060,1950,1900,2060,1925,0.066,135,1992.5,"Ecc",0,50,FALSE,FALSE,FALSE,7.01,"young",43,185,88,"m"
10,"LEG PRESS",1,"Ecc04",1900,1900,1750,1700,1900,1725,0.092,175,1812.5,"Ecc",0,50,FALSE,FALSE,FALSE,10.14,"young",43,185,88,"m"
10,"LEG PRESS",1,"Ecc05",1960,1980,1700,1550,1970,1625,0.175,345,1797.5,"Ecc",-20,150,TRUE,FALSE,FALSE,21.23,"young",43,185,88,"m"
10,"LEG PRESS",1,"Ecc06",1920,1920,1300,1300,1920,1300,0.323,620,1610,"Ecc",0,0,TRUE,FALSE,FALSE,47.69,"young",43,185,88,"m"
10,"LEG PRESS",1,"Ecc07",2020,2020,1300,1400,2020,1350,0.332,670,1685,"Ecc",0,-100,TRUE,FALSE,FALSE,49.63,"young",43,185,88,"m"
10,"LEG PRESS",1,"Ecc08",1800,1820,1600,1600,1810,1600,0.116,210,1705,"Ecc",-20,0,FALSE,FALSE,FALSE,13.12,"young",43,185,88,"m"
10,"LEG PRESS",1,"Ecc09",1900,1900,1200,1300,1900,1250,0.342,650,1575,"Ecc",0,-100,TRUE,FALSE,FALSE,52,"young",43,185,88,"m"
10,"LEG PRESS",1,"Ecc10",1700,1700,1100,1100,1700,1100,0.353,600,1400,"Ecc",0,0,TRUE,FALSE,FALSE,54.55,"young",43,185,88,"m"
10,"LEG PRESS",2,"Ecc01",2200,2200,2000,2000,2200,2000,0.091,200,2100,"Ecc",0,0,FALSE,FALSE,FALSE,10,"young",43,185,88,"m"
10,"LEG PRESS",2,"Ecc02",1860,1880,1750,1600,1870,1675,0.104,195,1772.5,"Ecc",-20,150,FALSE,FALSE,FALSE,11.64,"young",43,185,88,"m"
10,"LEG PRESS",2,"Ecc03",1760,1760,1650,1600,1760,1625,0.077,135,1692.5,"Ecc",0,50,FALSE,FALSE,FALSE,8.31,"young",43,185,88,"m"
10,"LEG PRESS",2,"Ecc04",1640,1660,1550,1500,1650,1525,0.076,125,1587.5,"Ecc",-20,50,FALSE,FALSE,FALSE,8.2,"young",43,185,88,"m"
10,"LEG PRESS",2,"Ecc05",1780,1800,1650,1650,1790,1650,0.078,140,1720,"Ecc",-20,0,FALSE,FALSE,FALSE,8.48,"young",43,185,88,"m"
10,"LEG PRESS",2,"Ecc06",1840,1840,1650,1700,1840,1675,0.09,165,1757.5,"Ecc",0,-50,FALSE,FALSE,FALSE,9.85,"young",43,185,88,"m"
10,"LEG PRESS",2,"Ecc07",1860,1880,1600,1700,1870,1650,0.118,220,1760,"Ecc",-20,-100,FALSE,FALSE,FALSE,13.33,"young",43,185,88,"m"
10,"LEG PRESS",2,"Ecc08",1620,1600,1150,1200,1610,1175,0.27,435,1392.5,"Ecc",20,-50,TRUE,FALSE,FALSE,37.02,"young",43,185,88,"m"
10,"LEG PRESS",2,"Ecc09",1840,1860,1200,1250,1850,1225,0.338,625,1537.5,"Ecc",-20,-50,TRUE,FALSE,FALSE,51.02,"young",43,185,88,"m"
10,"LEG PRESS",2,"Ecc10",1540,1520,1150,1200,1530,1175,0.232,355,1352.5,"Ecc",20,-50,TRUE,FALSE,FALSE,30.21,"young",43,185,88,"m"
10,"LEG PRESS",1,"Rep01",3720,3720,4300,4100,3720,4200,0.129,-480,3960,"Rep",0,200,TRUE,FALSE,TRUE,11.43,"young",43,185,88,"m"
10,"LEG PRESS",1,"Rep02",3140,3160,3150,3150,3150,3150,0,0,3150,"Rep",-20,0,FALSE,FALSE,FALSE,0,"young",43,185,88,"m"
10,"LEG PRESS",1,"Rep03",3000,3000,2950,2950,3000,2950,0.017,50,2975,"Rep",0,0,FALSE,FALSE,FALSE,1.69,"young",43,185,88,"m"
10,"LEG PRESS",1,"Rep04",2840,2820,2800,2850,2830,2825,0.002,5,2827.5,"Rep",20,-50,FALSE,FALSE,FALSE,0.18,"young",43,185,88,"m"
10,"LEG PRESS",1,"Rep05",3040,3040,3050,3000,3040,3025,0.005,15,3032.5,"Rep",0,50,FALSE,FALSE,FALSE,0.5,"young",43,185,88,"m"
10,"LEG PRESS",1,"Rep06",2920,2920,2900,2950,2920,2925,0.002,-5,2922.5,"Rep",0,-50,FALSE,FALSE,FALSE,0.17,"young",43,185,88,"m"
10,"LEG PRESS",1,"Rep07",2980,2980,2950,2950,2980,2950,0.01,30,2965,"Rep",0,0,FALSE,FALSE,FALSE,1.02,"young",43,185,88,"m"
10,"LEG PRESS",1,"Rep08",2780,2780,2850,2800,2780,2825,0.016,-45,2802.5,"Rep",0,50,FALSE,FALSE,FALSE,1.59,"young",43,185,88,"m"
10,"LEG PRESS",1,"Rep09",2860,2860,2800,2850,2860,2825,0.012,35,2842.5,"Rep",0,-50,FALSE,FALSE,FALSE,1.24,"young",43,185,88,"m"
10,"LEG PRESS",1,"Rep10",2600,2620,2750,2700,2610,2725,0.044,-115,2667.5,"Rep",-20,50,TRUE,FALSE,FALSE,4.22,"young",43,185,88,"m"
10,"LEG PRESS",2,"Rep01",3160,3180,3400,3250,3170,3325,0.049,-155,3247.5,"Rep",-20,150,TRUE,FALSE,TRUE,4.66,"young",43,185,88,"m"
10,"LEG PRESS",2,"Rep02",2840,2840,2850,2850,2840,2850,0.004,-10,2845,"Rep",0,0,FALSE,FALSE,FALSE,0.35,"young",43,185,88,"m"
10,"LEG PRESS",2,"Rep03",2720,2720,2750,2750,2720,2750,0.011,-30,2735,"Rep",0,0,FALSE,FALSE,FALSE,1.09,"young",43,185,88,"m"
10,"LEG PRESS",2,"Rep04",2680,2700,2650,2650,2690,2650,0.015,40,2670,"Rep",-20,0,FALSE,FALSE,FALSE,1.51,"young",43,185,88,"m"
10,"LEG PRESS",2,"Rep05",2880,2860,2850,2900,2870,2875,0.002,-5,2872.5,"Rep",20,-50,FALSE,FALSE,FALSE,0.17,"young",43,185,88,"m"
10,"LEG PRESS",2,"Rep06",2860,2860,2850,2850,2860,2850,0.003,10,2855,"Rep",0,0,FALSE,FALSE,FALSE,0.35,"young",43,185,88,"m"
10,"LEG PRESS",2,"Rep07",2920,2940,2900,2900,2930,2900,0.01,30,2915,"Rep",-20,0,FALSE,FALSE,FALSE,1.03,"young",43,185,88,"m"
10,"LEG PRESS",2,"Rep08",2620,2600,2600,2600,2610,2600,0.004,10,2605,"Rep",20,0,FALSE,FALSE,FALSE,0.38,"young",43,185,88,"m"
10,"LEG PRESS",2,"Rep09",2840,2840,2800,2800,2840,2800,0.014,40,2820,"Rep",0,0,FALSE,FALSE,FALSE,1.43,"young",43,185,88,"m"
10,"LEG PRESS",2,"Rep10",2620,2620,2800,2800,2620,2800,0.069,-180,2710,"Rep",0,0,TRUE,FALSE,FALSE,6.43,"young",43,185,88,"m"
10,"LEG PRESS",1,"TuT",29880,29900,30500,30300,29890,30400,0.017,-510,30145,"TuT",-20,200,FALSE,FALSE,FALSE,1.68,"young",43,185,88,"m"
10,"LEG PRESS",2,"TuT",28140,28160,28450,28350,28150,28400,0.009,-250,28275,"TuT",-20,100,FALSE,FALSE,FALSE,0.88,"young",43,185,88,"m"
10,"LEG EXTENSION",1,"Con01",920,940,1050,1050,930,1050,0.129,-120,990,"Con",-20,0,FALSE,FALSE,FALSE,11.43,"young",43,185,88,"m"
10,"LEG EXTENSION",1,"Con02",840,840,1000,1000,840,1000,0.19,-160,920,"Con",0,0,FALSE,FALSE,FALSE,16,"young",43,185,88,"m"
10,"LEG EXTENSION",1,"Con03",820,840,1000,950,830,975,0.175,-145,902.5,"Con",-20,50,FALSE,FALSE,FALSE,14.87,"young",43,185,88,"m"
10,"LEG EXTENSION",1,"Con04",840,860,950,1000,850,975,0.147,-125,912.5,"Con",-20,-50,FALSE,FALSE,FALSE,12.82,"young",43,185,88,"m"
10,"LEG EXTENSION",1,"Con05",800,800,900,950,800,925,0.156,-125,862.5,"Con",0,-50,FALSE,FALSE,FALSE,13.51,"young",43,185,88,"m"
10,"LEG EXTENSION",1,"Con06",840,860,1000,1050,850,1025,0.206,-175,937.5,"Con",-20,-50,FALSE,FALSE,FALSE,17.07,"young",43,185,88,"m"
10,"LEG EXTENSION",1,"Con07",800,820,900,950,810,925,0.142,-115,867.5,"Con",-20,-50,FALSE,FALSE,FALSE,12.43,"young",43,185,88,"m"
10,"LEG EXTENSION",1,"Con08",860,860,1050,1000,860,1025,0.192,-165,942.5,"Con",0,50,FALSE,FALSE,FALSE,16.1,"young",43,185,88,"m"
10,"LEG EXTENSION",1,"Con09",880,900,1100,1050,890,1075,0.208,-185,982.5,"Con",-20,50,TRUE,FALSE,FALSE,17.21,"young",43,185,88,"m"
10,"LEG EXTENSION",1,"Con10",880,880,1050,1100,880,1075,0.222,-195,977.5,"Con",0,-50,TRUE,FALSE,FALSE,18.14,"young",43,185,88,"m"
10,"LEG EXTENSION",2,"Con01",920,900,1050,1050,910,1050,0.154,-140,980,"Con",20,0,FALSE,FALSE,FALSE,13.33,"young",43,185,88,"m"
10,"LEG EXTENSION",2,"Con02",820,820,900,950,820,925,0.128,-105,872.5,"Con",0,-50,FALSE,FALSE,FALSE,11.35,"young",43,185,88,"m"
10,"LEG EXTENSION",2,"Con03",860,860,950,950,860,950,0.105,-90,905,"Con",0,0,FALSE,FALSE,FALSE,9.47,"young",43,185,88,"m"
10,"LEG EXTENSION",2,"Con04",820,860,950,900,840,925,0.101,-85,882.5,"Con",-40,50,FALSE,TRUE,FALSE,9.19,"young",43,185,88,"m"
10,"LEG EXTENSION",2,"Con05",840,840,1000,950,840,975,0.161,-135,907.5,"Con",0,50,FALSE,FALSE,FALSE,13.85,"young",43,185,88,"m"
10,"LEG EXTENSION",2,"Con06",820,860,1000,950,840,975,0.161,-135,907.5,"Con",-40,50,FALSE,TRUE,FALSE,13.85,"young",43,185,88,"m"
10,"LEG EXTENSION",2,"Con07",920,940,1050,1050,930,1050,0.129,-120,990,"Con",-20,0,FALSE,FALSE,FALSE,11.43,"young",43,185,88,"m"
10,"LEG EXTENSION",2,"Con08",780,780,900,950,780,925,0.186,-145,852.5,"Con",0,-50,FALSE,FALSE,FALSE,15.68,"young",43,185,88,"m"
10,"LEG EXTENSION",2,"Con09",820,840,1000,1000,830,1000,0.205,-170,915,"Con",-20,0,FALSE,FALSE,FALSE,17,"young",43,185,88,"m"
10,"LEG EXTENSION",2,"Con10",920,920,1050,1100,920,1075,0.168,-155,997.5,"Con",0,-50,FALSE,FALSE,FALSE,14.42,"young",43,185,88,"m"
10,"LEG EXTENSION",1,"Ecc01",3260,3240,3150,3100,3250,3125,0.038,125,3187.5,"Ecc",20,50,FALSE,FALSE,FALSE,4,"young",43,185,88,"m"
10,"LEG EXTENSION",1,"Ecc02",3140,3120,2950,3000,3130,2975,0.05,155,3052.5,"Ecc",20,-50,FALSE,FALSE,FALSE,5.21,"young",43,185,88,"m"
10,"LEG EXTENSION",1,"Ecc03",3240,3240,3100,3100,3240,3100,0.043,140,3170,"Ecc",0,0,FALSE,FALSE,FALSE,4.52,"young",43,185,88,"m"
10,"LEG EXTENSION",1,"Ecc04",3060,3040,2950,2900,3050,2925,0.041,125,2987.5,"Ecc",20,50,FALSE,FALSE,FALSE,4.27,"young",43,185,88,"m"
10,"LEG EXTENSION",1,"Ecc05",2600,2600,2500,2450,2600,2475,0.048,125,2537.5,"Ecc",0,50,FALSE,FALSE,FALSE,5.05,"young",43,185,88,"m"
10,"LEG EXTENSION",1,"Ecc06",2540,2520,2400,2350,2530,2375,0.061,155,2452.5,"Ecc",20,50,FALSE,FALSE,FALSE,6.53,"young",43,185,88,"m"
10,"LEG EXTENSION",1,"Ecc07",2800,2780,2650,2650,2790,2650,0.05,140,2720,"Ecc",20,0,FALSE,FALSE,FALSE,5.28,"young",43,185,88,"m"
10,"LEG EXTENSION",1,"Ecc08",2840,2840,2650,2700,2840,2675,0.058,165,2757.5,"Ecc",0,-50,FALSE,FALSE,FALSE,6.17,"young",43,185,88,"m"
10,"LEG EXTENSION",1,"Ecc09",2760,2740,2550,2550,2750,2550,0.073,200,2650,"Ecc",20,0,TRUE,FALSE,FALSE,7.84,"young",43,185,88,"m"
10,"LEG EXTENSION",1,"Ecc10",2300,2280,2350,2200,2290,2275,0.007,15,2282.5,"Ecc",20,150,FALSE,FALSE,FALSE,0.66,"young",43,185,88,"m"
10,"LEG EXTENSION",2,"Ecc01",2640,2640,2550,2500,2640,2525,0.044,115,2582.5,"Ecc",0,50,FALSE,FALSE,FALSE,4.55,"young",43,185,88,"m"
10,"LEG EXTENSION",2,"Ecc02",2560,2560,2500,2450,2560,2475,0.033,85,2517.5,"Ecc",0,50,FALSE,FALSE,FALSE,3.43,"young",43,185,88,"m"
10,"LEG EXTENSION",2,"Ecc03",2380,2360,2250,2300,2370,2275,0.04,95,2322.5,"Ecc",20,-50,FALSE,FALSE,FALSE,4.18,"young",43,185,88,"m"
10,"LEG EXTENSION",2,"Ecc04",2360,2340,2200,2250,2350,2225,0.053,125,2287.5,"Ecc",20,-50,FALSE,FALSE,FALSE,5.62,"young",43,185,88,"m"
10,"LEG EXTENSION",2,"Ecc05",2420,2400,2250,2300,2410,2275,0.056,135,2342.5,"Ecc",20,-50,FALSE,FALSE,FALSE,5.93,"young",43,185,88,"m"
10,"LEG EXTENSION",2,"Ecc06",2220,2200,2050,2100,2210,2075,0.061,135,2142.5,"Ecc",20,-50,FALSE,FALSE,FALSE,6.51,"young",43,185,88,"m"
10,"LEG EXTENSION",2,"Ecc07",2160,2140,2050,2000,2150,2025,0.058,125,2087.5,"Ecc",20,50,FALSE,FALSE,FALSE,6.17,"young",43,185,88,"m"
10,"LEG EXTENSION",2,"Ecc08",1920,1920,1800,1750,1920,1775,0.076,145,1847.5,"Ecc",0,50,FALSE,FALSE,FALSE,8.17,"young",43,185,88,"m"
10,"LEG EXTENSION",2,"Ecc09",2520,2500,2350,2350,2510,2350,0.064,160,2430,"Ecc",20,0,FALSE,FALSE,FALSE,6.81,"young",43,185,88,"m"
10,"LEG EXTENSION",2,"Ecc10",1860,1820,1900,1850,1840,1875,0.019,-35,1857.5,"Ecc",40,50,FALSE,TRUE,FALSE,1.87,"young",43,185,88,"m"
10,"LEG EXTENSION",1,"Rep01",4180,4180,4200,4150,4180,4175,0.001,5,4177.5,"Rep",0,50,FALSE,FALSE,FALSE,0.12,"young",43,185,88,"m"
10,"LEG EXTENSION",1,"Rep02",3980,3960,3950,4000,3970,3975,0.001,-5,3972.5,"Rep",20,-50,FALSE,FALSE,FALSE,0.13,"young",43,185,88,"m"
10,"LEG EXTENSION",1,"Rep03",4060,4080,4100,4050,4070,4075,0.001,-5,4072.5,"Rep",-20,50,FALSE,FALSE,FALSE,0.12,"young",43,185,88,"m"
10,"LEG EXTENSION",1,"Rep04",3900,3900,3900,3900,3900,3900,0,0,3900,"Rep",0,0,FALSE,FALSE,FALSE,0,"young",43,185,88,"m"
10,"LEG EXTENSION",1,"Rep05",3400,3400,3400,3400,3400,3400,0,0,3400,"Rep",0,0,FALSE,FALSE,FALSE,0,"young",43,185,88,"m"
10,"LEG EXTENSION",1,"Rep06",3380,3380,3400,3400,3380,3400,0.006,-20,3390,"Rep",0,0,FALSE,FALSE,FALSE,0.59,"young",43,185,88,"m"
10,"LEG EXTENSION",1,"Rep07",3600,3600,3550,3600,3600,3575,0.007,25,3587.5,"Rep",0,-50,FALSE,FALSE,FALSE,0.7,"young",43,185,88,"m"
10,"LEG EXTENSION",1,"Rep08",3700,3700,3700,3700,3700,3700,0,0,3700,"Rep",0,0,FALSE,FALSE,FALSE,0,"young",43,185,88,"m"
10,"LEG EXTENSION",1,"Rep09",3640,3640,3650,3600,3640,3625,0.004,15,3632.5,"Rep",0,50,FALSE,FALSE,FALSE,0.41,"young",43,185,88,"m"
10,"LEG EXTENSION",1,"Rep10",3180,3160,3400,3300,3170,3350,0.057,-180,3260,"Rep",20,100,TRUE,FALSE,FALSE,5.37,"young",43,185,88,"m"
10,"LEG EXTENSION",2,"Rep01",3560,3540,3600,3550,3550,3575,0.007,-25,3562.5,"Rep",20,50,FALSE,FALSE,FALSE,0.7,"young",43,185,88,"m"
10,"LEG EXTENSION",2,"Rep02",3380,3380,3400,3400,3380,3400,0.006,-20,3390,"Rep",0,0,FALSE,FALSE,FALSE,0.59,"young",43,185,88,"m"
10,"LEG EXTENSION",2,"Rep03",3240,3220,3200,3250,3230,3225,0.002,5,3227.5,"Rep",20,-50,FALSE,FALSE,FALSE,0.16,"young",43,185,88,"m"
10,"LEG EXTENSION",2,"Rep04",3180,3200,3150,3150,3190,3150,0.013,40,3170,"Rep",-20,0,FALSE,FALSE,FALSE,1.27,"young",43,185,88,"m"
10,"LEG EXTENSION",2,"Rep05",3260,3240,3250,3250,3250,3250,0,0,3250,"Rep",20,0,FALSE,FALSE,FALSE,0,"young",43,185,88,"m"
10,"LEG EXTENSION",2,"Rep06",3040,3060,3050,3050,3050,3050,0,0,3050,"Rep",-20,0,FALSE,FALSE,FALSE,0,"young",43,185,88,"m"
10,"LEG EXTENSION",2,"Rep07",3080,3080,3100,3050,3080,3075,0.002,5,3077.5,"Rep",0,50,FALSE,FALSE,FALSE,0.16,"young",43,185,88,"m"
10,"LEG EXTENSION",2,"Rep08",2700,2700,2700,2700,2700,2700,0,0,2700,"Rep",0,0,FALSE,FALSE,FALSE,0,"young",43,185,88,"m"
10,"LEG EXTENSION",2,"Rep09",3340,3340,3350,3350,3340,3350,0.003,-10,3345,"Rep",0,0,FALSE,FALSE,FALSE,0.3,"young",43,185,88,"m"
10,"LEG EXTENSION",2,"Rep10",2780,2740,2950,2950,2760,2950,0.069,-190,2855,"Rep",40,0,TRUE,FALSE,FALSE,6.44,"young",43,185,88,"m"
10,"LEG EXTENSION",1,"TuT",37020,37000,37250,37100,37010,37175,0.004,-165,37092.5,"TuT",20,150,FALSE,FALSE,FALSE,0.44,"young",43,185,88,"m"
10,"LEG EXTENSION",2,"TuT",31560,31500,31750,31700,31530,31725,0.006,-195,31627.5,"TuT",60,50,TRUE,FALSE,FALSE,0.61,"young",43,185,88,"m"
10,"LEG CURL",1,"Con01",1120,1120,1150,1150,1120,1150,0.027,-30,1135,"Con",0,0,FALSE,FALSE,FALSE,2.61,"young",43,185,88,"m"
10,"LEG CURL",1,"Con02",980,980,1150,1150,980,1150,0.173,-170,1065,"Con",0,0,FALSE,FALSE,FALSE,14.78,"young",43,185,88,"m"
10,"LEG CURL",1,"Con03",980,980,1150,1150,980,1150,0.173,-170,1065,"Con",0,0,FALSE,FALSE,FALSE,14.78,"young",43,185,88,"m"
10,"LEG CURL",1,"Con04",1060,1080,1150,1250,1070,1200,0.121,-130,1135,"Con",-20,-100,FALSE,FALSE,FALSE,10.83,"young",43,185,88,"m"
10,"LEG CURL",1,"Con05",1040,1040,1150,1150,1040,1150,0.106,-110,1095,"Con",0,0,FALSE,FALSE,FALSE,9.57,"young",43,185,88,"m"
10,"LEG CURL",1,"Con06",980,980,1150,1150,980,1150,0.173,-170,1065,"Con",0,0,FALSE,FALSE,FALSE,14.78,"young",43,185,88,"m"
10,"LEG CURL",1,"Con07",1120,1120,1200,1200,1120,1200,0.071,-80,1160,"Con",0,0,FALSE,FALSE,FALSE,6.67,"young",43,185,88,"m"
10,"LEG CURL",1,"Con08",960,960,1100,1150,960,1125,0.172,-165,1042.5,"Con",0,-50,FALSE,FALSE,FALSE,14.67,"young",43,185,88,"m"
10,"LEG CURL",1,"Con09",1120,1140,1250,1250,1130,1250,0.106,-120,1190,"Con",-20,0,FALSE,FALSE,FALSE,9.6,"young",43,185,88,"m"
10,"LEG CURL",1,"Con10",1160,1140,1350,1400,1150,1375,0.196,-225,1262.5,"Con",20,-50,FALSE,FALSE,FALSE,16.36,"young",43,185,88,"m"
10,"LEG CURL",2,"Con01",1100,1100,1150,1100,1100,1125,0.023,-25,1112.5,"Con",0,50,FALSE,FALSE,FALSE,2.22,"young",43,185,88,"m"
10,"LEG CURL",2,"Con02",880,900,1000,1050,890,1025,0.152,-135,957.5,"Con",-20,-50,FALSE,FALSE,FALSE,13.17,"young",43,185,88,"m"
10,"LEG CURL",2,"Con03",840,840,1050,1300,840,1175,0.399,-335,1007.5,"Con",0,-250,TRUE,FALSE,TRUE,28.51,"young",43,185,88,"m"
10,"LEG CURL",2,"Con04",920,920,1100,1100,920,1100,0.196,-180,1010,"Con",0,0,FALSE,FALSE,FALSE,16.36,"young",43,185,88,"m"
10,"LEG CURL",2,"Con05",960,940,1100,1150,950,1125,0.184,-175,1037.5,"Con",20,-50,FALSE,FALSE,FALSE,15.56,"young",43,185,88,"m"
10,"LEG CURL",2,"Con06",920,900,1000,1050,910,1025,0.126,-115,967.5,"Con",20,-50,FALSE,FALSE,FALSE,11.22,"young",43,185,88,"m"
10,"LEG CURL",2,"Con07",920,940,1050,1050,930,1050,0.129,-120,990,"Con",-20,0,FALSE,FALSE,FALSE,11.43,"young",43,185,88,"m"
10,"LEG CURL",2,"Con08",1020,1040,1150,1150,1030,1150,0.117,-120,1090,"Con",-20,0,FALSE,FALSE,FALSE,10.43,"young",43,185,88,"m"
10,"LEG CURL",2,"Con09",1020,1040,1250,1200,1030,1225,0.189,-195,1127.5,"Con",-20,50,FALSE,FALSE,FALSE,15.92,"young",43,185,88,"m"
10,"LEG CURL",2,"Con10",1020,1020,1300,1200,1020,1250,0.225,-230,1135,"Con",0,100,TRUE,FALSE,FALSE,18.4,"young",43,185,88,"m"
10,"LEG CURL",1,"Ecc01",3860,3860,3700,3700,3860,3700,0.041,160,3780,"Ecc",0,0,FALSE,FALSE,FALSE,4.32,"young",43,185,88,"m"
10,"LEG CURL",1,"Ecc02",3800,3800,3650,3650,3800,3650,0.039,150,3725,"Ecc",0,0,FALSE,FALSE,FALSE,4.11,"young",43,185,88,"m"
10,"LEG CURL",1,"Ecc03",3420,3400,3300,3250,3410,3275,0.04,135,3342.5,"Ecc",20,50,FALSE,FALSE,FALSE,4.12,"young",43,185,88,"m"
10,"LEG CURL",1,"Ecc04",3080,3080,3000,2950,3080,2975,0.034,105,3027.5,"Ecc",0,50,FALSE,FALSE,FALSE,3.53,"young",43,185,88,"m"
10,"LEG CURL",1,"Ecc05",3020,3020,2850,2850,3020,2850,0.056,170,2935,"Ecc",0,0,FALSE,FALSE,FALSE,5.96,"young",43,185,88,"m"
10,"LEG CURL",1,"Ecc06",3400,3400,3300,3300,3400,3300,0.029,100,3350,"Ecc",0,0,FALSE,FALSE,FALSE,3.03,"young",43,185,88,"m"
10,"LEG CURL",1,"Ecc07",3320,3320,3150,3150,3320,3150,0.051,170,3235,"Ecc",0,0,FALSE,FALSE,FALSE,5.4,"young",43,185,88,"m"
10,"LEG CURL",1,"Ecc08",3000,2980,2900,2850,2990,2875,0.038,115,2932.5,"Ecc",20,50,FALSE,FALSE,FALSE,4,"young",43,185,88,"m"
10,"LEG CURL",1,"Ecc09",2840,2860,2650,2600,2850,2625,0.079,225,2737.5,"Ecc",-20,50,FALSE,FALSE,FALSE,8.57,"young",43,185,88,"m"
10,"LEG CURL",1,"Ecc10",2100,2080,2250,2100,2090,2175,0.041,-85,2132.5,"Ecc",20,150,FALSE,FALSE,FALSE,3.91,"young",43,185,88,"m"
10,"LEG CURL",2,"Ecc01",3740,3720,3600,3600,3730,3600,0.035,130,3665,"Ecc",20,0,FALSE,FALSE,FALSE,3.61,"young",43,185,88,"m"
10,"LEG CURL",2,"Ecc02",3300,3300,3100,2850,3300,2975,0.098,325,3137.5,"Ecc",0,250,TRUE,FALSE,TRUE,10.92,"young",43,185,88,"m"
10,"LEG CURL",2,"Ecc03",2860,2860,2700,2700,2860,2700,0.056,160,2780,"Ecc",0,0,FALSE,FALSE,FALSE,5.93,"young",43,185,88,"m"
10,"LEG CURL",2,"Ecc04",2860,2860,2700,2650,2860,2675,0.065,185,2767.5,"Ecc",0,50,FALSE,FALSE,FALSE,6.92,"young",43,185,88,"m"
10,"LEG CURL",2,"Ecc05",2940,2980,2850,2800,2960,2825,0.046,135,2892.5,"Ecc",-40,50,FALSE,FALSE,FALSE,4.78,"young",43,185,88,"m"
10,"LEG CURL",2,"Ecc06",2720,2720,2600,2600,2720,2600,0.044,120,2660,"Ecc",0,0,FALSE,FALSE,FALSE,4.62,"young",43,185,88,"m"
10,"LEG CURL",2,"Ecc07",2660,2620,2550,2550,2640,2550,0.034,90,2595,"Ecc",40,0,FALSE,FALSE,FALSE,3.53,"young",43,185,88,"m"
10,"LEG CURL",2,"Ecc08",2980,2960,2750,2800,2970,2775,0.066,195,2872.5,"Ecc",20,-50,FALSE,FALSE,FALSE,7.03,"young",43,185,88,"m"
10,"LEG CURL",2,"Ecc09",3280,3280,3000,3100,3280,3050,0.07,230,3165,"Ecc",0,-100,TRUE,FALSE,FALSE,7.54,"young",43,185,88,"m"
10,"LEG CURL",2,"Ecc10",2160,2160,2150,2200,2160,2175,0.007,-15,2167.5,"Ecc",0,-50,FALSE,FALSE,FALSE,0.69,"young",43,185,88,"m"
10,"LEG CURL",1,"Rep01",4980,4980,4850,4850,4980,4850,0.026,130,4915,"Rep",0,0,FALSE,FALSE,FALSE,2.68,"young",43,185,88,"m"
10,"LEG CURL",1,"Rep02",4780,4780,4800,4800,4780,4800,0.004,-20,4790,"Rep",0,0,FALSE,FALSE,FALSE,0.42,"young",43,185,88,"m"
10,"LEG CURL",1,"Rep03",4400,4380,4450,4400,4390,4425,0.008,-35,4407.5,"Rep",20,50,FALSE,FALSE,FALSE,0.79,"young",43,185,88,"m"
10,"LEG CURL",1,"Rep04",4140,4160,4150,4200,4150,4175,0.006,-25,4162.5,"Rep",-20,-50,FALSE,FALSE,FALSE,0.6,"young",43,185,88,"m"
10,"LEG CURL",1,"Rep05",4060,4060,4000,4000,4060,4000,0.015,60,4030,"Rep",0,0,FALSE,FALSE,FALSE,1.5,"young",43,185,88,"m"
10,"LEG CURL",1,"Rep06",4380,4380,4450,4450,4380,4450,0.016,-70,4415,"Rep",0,0,FALSE,FALSE,FALSE,1.57,"young",43,185,88,"m"
10,"LEG CURL",1,"Rep07",4440,4440,4350,4350,4440,4350,0.02,90,4395,"Rep",0,0,FALSE,FALSE,FALSE,2.07,"young",43,185,88,"m"
10,"LEG CURL",1,"Rep08",3960,3940,4000,4000,3950,4000,0.013,-50,3975,"Rep",20,0,FALSE,FALSE,FALSE,1.25,"young",43,185,88,"m"
10,"LEG CURL",1,"Rep09",3960,4000,3900,3850,3980,3875,0.026,105,3927.5,"Rep",-40,50,FALSE,FALSE,FALSE,2.71,"young",43,185,88,"m"
10,"LEG CURL",1,"Rep10",3260,3220,3600,3500,3240,3550,0.096,-310,3395,"Rep",40,100,TRUE,FALSE,FALSE,8.73,"young",43,185,88,"m"
10,"LEG CURL",2,"Rep01",4840,4820,4750,4700,4830,4725,0.022,105,4777.5,"Rep",20,50,FALSE,FALSE,FALSE,2.22,"young",43,185,88,"m"
10,"LEG CURL",2,"Rep02",4180,4200,4100,3900,4190,4000,0.045,190,4095,"Rep",-20,200,TRUE,FALSE,TRUE,4.75,"young",43,185,88,"m"
10,"LEG CURL",2,"Rep03",3700,3700,3750,4000,3700,3875,0.047,-175,3787.5,"Rep",0,-250,TRUE,FALSE,TRUE,4.52,"young",43,185,88,"m"
10,"LEG CURL",2,"Rep04",3780,3780,3800,3750,3780,3775,0.001,5,3777.5,"Rep",0,50,FALSE,FALSE,FALSE,0.13,"young",43,185,88,"m"
10,"LEG CURL",2,"Rep05",3900,3920,3950,3950,3910,3950,0.01,-40,3930,"Rep",-20,0,FALSE,FALSE,FALSE,1.01,"young",43,185,88,"m"
10,"LEG CURL",2,"Rep06",3640,3620,3600,3650,3630,3625,0.001,5,3627.5,"Rep",20,-50,FALSE,FALSE,FALSE,0.14,"young",43,185,88,"m"
10,"LEG CURL",2,"Rep07",3580,3560,3600,3600,3570,3600,0.008,-30,3585,"Rep",20,0,FALSE,FALSE,FALSE,0.83,"young",43,185,88,"m"
10,"LEG CURL",2,"Rep08",4000,4000,3900,3950,4000,3925,0.019,75,3962.5,"Rep",0,-50,FALSE,FALSE,FALSE,1.91,"young",43,185,88,"m"
10,"LEG CURL",2,"Rep09",4300,4320,4250,4300,4310,4275,0.008,35,4292.5,"Rep",-20,-50,FALSE,FALSE,FALSE,0.82,"young",43,185,88,"m"
10,"LEG CURL",2,"Rep10",3180,3180,3450,3400,3180,3425,0.077,-245,3302.5,"Rep",0,50,TRUE,FALSE,FALSE,7.15,"young",43,185,88,"m"
10,"LEG CURL",1,"TuT",42360,42340,42550,42400,42350,42475,0.003,-125,42412.5,"TuT",20,150,FALSE,FALSE,FALSE,0.29,"young",43,185,88,"m"
10,"LEG CURL",2,"TuT",39100,39100,39150,39200,39100,39175,0.002,-75,39137.5,"TuT",0,-50,FALSE,FALSE,FALSE,0.19,"young",43,185,88,"m"
10,"ABDUCTOR",1,"Con01",520,560,750,1150,540,950,0.759,-410,745,"Con",-40,-400,TRUE,TRUE,TRUE,43.16,"young",43,185,88,"m"
10,"ABDUCTOR",1,"Con02",500,500,700,650,500,675,0.35,-175,587.5,"Con",0,50,FALSE,FALSE,FALSE,25.93,"young",43,185,88,"m"
10,"ABDUCTOR",1,"Con03",480,460,550,600,470,575,0.223,-105,522.5,"Con",20,-50,FALSE,FALSE,FALSE,18.26,"young",43,185,88,"m"
10,"ABDUCTOR",1,"Con04",480,480,600,600,480,600,0.25,-120,540,"Con",0,0,FALSE,FALSE,FALSE,20,"young",43,185,88,"m"
10,"ABDUCTOR",1,"Con05",480,520,600,600,500,600,0.2,-100,550,"Con",-40,0,FALSE,TRUE,FALSE,16.67,"young",43,185,88,"m"
10,"ABDUCTOR",1,"Con06",480,500,850,700,490,775,0.582,-285,632.5,"Con",-20,150,FALSE,FALSE,FALSE,36.77,"young",43,185,88,"m"
10,"ABDUCTOR",1,"Con07",480,480,750,700,480,725,0.51,-245,602.5,"Con",0,50,FALSE,FALSE,FALSE,33.79,"young",43,185,88,"m"
10,"ABDUCTOR",1,"Con08",480,500,800,750,490,775,0.582,-285,632.5,"Con",-20,50,FALSE,FALSE,FALSE,36.77,"young",43,185,88,"m"
10,"ABDUCTOR",1,"Con09",540,560,750,750,550,750,0.364,-200,650,"Con",-20,0,FALSE,FALSE,FALSE,26.67,"young",43,185,88,"m"
10,"ABDUCTOR",1,"Con10",560,560,1450,1500,560,1475,1.634,-915,1017.5,"Con",0,-50,TRUE,FALSE,FALSE,62.03,"young",43,185,88,"m"
10,"ABDUCTOR",2,"Con01",560,540,650,750,550,700,0.273,-150,625,"Con",20,-100,FALSE,FALSE,FALSE,21.43,"young",43,185,88,"m"
10,"ABDUCTOR",2,"Con02",480,460,600,1100,470,850,0.809,-380,660,"Con",20,-500,TRUE,FALSE,TRUE,44.71,"young",43,185,88,"m"
10,"ABDUCTOR",2,"Con03",480,480,1100,600,480,850,0.771,-370,665,"Con",0,500,TRUE,FALSE,TRUE,43.53,"young",43,185,88,"m"
10,"ABDUCTOR",2,"Con04",520,520,750,600,520,675,0.298,-155,597.5,"Con",0,150,FALSE,FALSE,FALSE,22.96,"young",43,185,88,"m"
10,"ABDUCTOR",2,"Con05",500,480,1100,600,490,850,0.735,-360,670,"Con",20,500,TRUE,FALSE,TRUE,42.35,"young",43,185,88,"m"
10,"ABDUCTOR",2,"Con06",460,500,700,700,480,700,0.458,-220,590,"Con",-40,0,FALSE,TRUE,FALSE,31.43,"young",43,185,88,"m"
10,"ABDUCTOR",2,"Con07",520,540,650,650,530,650,0.226,-120,590,"Con",-20,0,FALSE,FALSE,FALSE,18.46,"young",43,185,88,"m"
10,"ABDUCTOR",2,"Con08",460,460,600,700,460,650,0.413,-190,555,"Con",0,-100,FALSE,FALSE,FALSE,29.23,"young",43,185,88,"m"
10,"ABDUCTOR",2,"Con09",500,500,600,750,500,675,0.35,-175,587.5,"Con",0,-150,FALSE,FALSE,FALSE,25.93,"young",43,185,88,"m"
10,"ABDUCTOR",2,"Con10",460,460,600,800,460,700,0.522,-240,580,"Con",0,-200,FALSE,FALSE,FALSE,34.29,"young",43,185,88,"m"
10,"ABDUCTOR",1,"Ecc01",1840,1820,1600,1650,1830,1625,0.112,205,1727.5,"Ecc",20,-50,FALSE,FALSE,FALSE,12.62,"young",43,185,88,"m"
10,"ABDUCTOR",1,"Ecc02",1640,1660,1500,1500,1650,1500,0.091,150,1575,"Ecc",-20,0,FALSE,FALSE,FALSE,10,"young",43,185,88,"m"
10,"ABDUCTOR",1,"Ecc03",1640,1620,1550,1500,1630,1525,0.064,105,1577.5,"Ecc",20,50,FALSE,FALSE,FALSE,6.89,"young",43,185,88,"m"
10,"ABDUCTOR",1,"Ecc04",1540,1540,1450,1450,1540,1450,0.058,90,1495,"Ecc",0,0,FALSE,FALSE,FALSE,6.21,"young",43,185,88,"m"
10,"ABDUCTOR",1,"Ecc05",1580,1540,1250,1400,1560,1325,0.151,235,1442.5,"Ecc",40,-150,FALSE,TRUE,FALSE,17.74,"young",43,185,88,"m"
10,"ABDUCTOR",1,"Ecc06",1680,1680,1400,1450,1680,1425,0.152,255,1552.5,"Ecc",0,-50,FALSE,FALSE,FALSE,17.89,"young",43,185,88,"m"
10,"ABDUCTOR",1,"Ecc07",1540,1540,1250,1300,1540,1275,0.172,265,1407.5,"Ecc",0,-50,FALSE,FALSE,FALSE,20.78,"young",43,185,88,"m"
10,"ABDUCTOR",1,"Ecc08",1380,1360,1150,1150,1370,1150,0.161,220,1260,"Ecc",20,0,FALSE,FALSE,FALSE,19.13,"young",43,185,88,"m"
10,"ABDUCTOR",1,"Ecc09",1740,1720,850,800,1730,825,0.523,905,1277.5,"Ecc",20,50,TRUE,FALSE,FALSE,109.7,"young",43,185,88,"m"
10,"ABDUCTOR",1,"Ecc10",1280,1240,1200,1250,1260,1225,0.028,35,1242.5,"Ecc",40,-50,FALSE,TRUE,FALSE,2.86,"young",43,185,88,"m"
10,"ABDUCTOR",2,"Ecc01",1620,1640,1550,1000,1630,1275,0.218,355,1452.5,"Ecc",-20,550,TRUE,FALSE,TRUE,27.84,"young",43,185,88,"m"
10,"ABDUCTOR",2,"Ecc02",1400,1420,800,1200,1410,1000,0.291,410,1205,"Ecc",-20,-400,TRUE,FALSE,TRUE,41,"young",43,185,88,"m"
10,"ABDUCTOR",2,"Ecc03",1220,1220,950,1150,1220,1050,0.139,170,1135,"Ecc",0,-200,FALSE,FALSE,FALSE,16.19,"young",43,185,88,"m"
10,"ABDUCTOR",2,"Ecc04",1340,1340,750,1250,1340,1000,0.254,340,1170,"Ecc",0,-500,TRUE,FALSE,TRUE,34,"young",43,185,88,"m"
10,"ABDUCTOR",2,"Ecc05",1280,1280,1050,1100,1280,1075,0.16,205,1177.5,"Ecc",0,-50,FALSE,FALSE,FALSE,19.07,"young",43,185,88,"m"
10,"ABDUCTOR",2,"Ecc06",1360,1320,1200,1200,1340,1200,0.104,140,1270,"Ecc",40,0,FALSE,TRUE,FALSE,11.67,"young",43,185,88,"m"
10,"ABDUCTOR",2,"Ecc07",1460,1460,1300,1250,1460,1275,0.127,185,1367.5,"Ecc",0,50,FALSE,FALSE,FALSE,14.51,"young",43,185,88,"m"
10,"ABDUCTOR",2,"Ecc08",1220,1220,1100,950,1220,1025,0.16,195,1122.5,"Ecc",0,150,FALSE,FALSE,FALSE,19.02,"young",43,185,88,"m"
10,"ABDUCTOR",2,"Ecc09",1260,1260,1150,950,1260,1050,0.167,210,1155,"Ecc",0,200,FALSE,FALSE,FALSE,20,"young",43,185,88,"m"
10,"ABDUCTOR",2,"Ecc10",1340,1340,2050,1300,1340,1675,0.25,-335,1507.5,"Ecc",0,750,TRUE,FALSE,TRUE,20,"young",43,185,88,"m"
10,"ABDUCTOR",1,"Rep01",2360,2380,2350,2800,2370,2575,0.086,-205,2472.5,"Rep",-20,-450,FALSE,FALSE,TRUE,7.96,"young",43,185,88,"m"
10,"ABDUCTOR",1,"Rep02",2140,2160,2200,2150,2150,2175,0.012,-25,2162.5,"Rep",-20,50,FALSE,FALSE,FALSE,1.15,"young",43,185,88,"m"
10,"ABDUCTOR",1,"Rep03",2120,2080,2100,2100,2100,2100,0,0,2100,"Rep",40,0,FALSE,FALSE,FALSE,0,"young",43,185,88,"m"
10,"ABDUCTOR",1,"Rep04",2020,2020,2050,2050,2020,2050,0.015,-30,2035,"Rep",0,0,FALSE,FALSE,FALSE,1.46,"young",43,185,88,"m"
10,"ABDUCTOR",1,"Rep05",2060,2060,1850,2000,2060,1925,0.066,135,1992.5,"Rep",0,-150,FALSE,FALSE,FALSE,7.01,"young",43,185,88,"m"
10,"ABDUCTOR",1,"Rep06",2160,2180,2250,2150,2170,2200,0.014,-30,2185,"Rep",-20,100,FALSE,FALSE,FALSE,1.36,"young",43,185,88,"m"
10,"ABDUCTOR",1,"Rep07",2020,2020,2000,2000,2020,2000,0.01,20,2010,"Rep",0,0,FALSE,FALSE,FALSE,1,"young",43,185,88,"m"
10,"ABDUCTOR",1,"Rep08",1860,1860,1950,1900,1860,1925,0.035,-65,1892.5,"Rep",0,50,FALSE,FALSE,FALSE,3.38,"young",43,185,88,"m"
10,"ABDUCTOR",1,"Rep09",2280,2280,1600,1550,2280,1575,0.309,705,1927.5,"Rep",0,50,TRUE,FALSE,FALSE,44.76,"young",43,185,88,"m"
10,"ABDUCTOR",1,"Rep10",1840,1800,2650,2750,1820,2700,0.484,-880,2260,"Rep",40,-100,TRUE,FALSE,FALSE,32.59,"young",43,185,88,"m"
10,"ABDUCTOR",2,"Rep01",2180,2180,2200,1750,2180,1975,0.094,205,2077.5,"Rep",0,450,FALSE,FALSE,TRUE,10.38,"young",43,185,88,"m"
10,"ABDUCTOR",2,"Rep02",1880,1880,1400,2300,1880,1850,0.016,30,1865,"Rep",0,-900,FALSE,FALSE,TRUE,1.62,"young",43,185,88,"m"
10,"ABDUCTOR",2,"Rep03",1700,1700,2050,1750,1700,1900,0.118,-200,1800,"Rep",0,300,FALSE,FALSE,FALSE,10.53,"young",43,185,88,"m"
10,"ABDUCTOR",2,"Rep04",1860,1860,1500,1850,1860,1675,0.099,185,1767.5,"Rep",0,-350,FALSE,FALSE,TRUE,11.04,"young",43,185,88,"m"
10,"ABDUCTOR",2,"Rep05",1780,1760,2150,1700,1770,1925,0.088,-155,1847.5,"Rep",20,450,FALSE,FALSE,TRUE,8.05,"young",43,185,88,"m"
10,"ABDUCTOR",2,"Rep06",1820,1820,1900,1900,1820,1900,0.044,-80,1860,"Rep",0,0,FALSE,FALSE,FALSE,4.21,"young",43,185,88,"m"
10,"ABDUCTOR",2,"Rep07",1980,2000,1950,1900,1990,1925,0.033,65,1957.5,"Rep",-20,50,FALSE,FALSE,FALSE,3.38,"young",43,185,88,"m"
10,"ABDUCTOR",2,"Rep08",1680,1680,1700,1650,1680,1675,0.003,5,1677.5,"Rep",0,50,FALSE,FALSE,FALSE,0.3,"young",43,185,88,"m"
10,"ABDUCTOR",2,"Rep09",1760,1760,1750,1700,1760,1725,0.02,35,1742.5,"Rep",0,50,FALSE,FALSE,FALSE,2.03,"young",43,185,88,"m"
10,"ABDUCTOR",2,"Rep10",1800,1800,2650,2100,1800,2375,0.319,-575,2087.5,"Rep",0,550,TRUE,FALSE,TRUE,24.21,"young",43,185,88,"m"
10,"ABDUCTOR",1,"TuT",20860,20840,21000,21450,20850,21225,0.018,-375,21037.5,"TuT",20,-450,FALSE,FALSE,FALSE,1.77,"young",43,185,88,"m"
10,"ABDUCTOR",2,"TuT",18440,18440,19250,18600,18440,18925,0.026,-485,18682.5,"TuT",0,650,TRUE,FALSE,TRUE,2.56,"young",43,185,88,"m"
10,"ADDUCTOR",1,"Con01",760,760,950,850,760,900,0.184,-140,830,"Con",0,100,FALSE,FALSE,FALSE,15.56,"young",43,185,88,"m"
10,"ADDUCTOR",1,"Con02",600,620,700,700,610,700,0.148,-90,655,"Con",-20,0,FALSE,FALSE,FALSE,12.86,"young",43,185,88,"m"
10,"ADDUCTOR",1,"Con03",600,600,650,550,600,600,0,0,600,"Con",0,100,FALSE,FALSE,FALSE,0,"young",43,185,88,"m"
10,"ADDUCTOR",1,"Con04",580,600,750,750,590,750,0.271,-160,670,"Con",-20,0,FALSE,FALSE,FALSE,21.33,"young",43,185,88,"m"
10,"ADDUCTOR",1,"Con05",620,640,1000,800,630,900,0.429,-270,765,"Con",-20,200,FALSE,FALSE,FALSE,30,"young",43,185,88,"m"
10,"ADDUCTOR",1,"Con06",640,660,900,850,650,875,0.346,-225,762.5,"Con",-20,50,FALSE,FALSE,FALSE,25.71,"young",43,185,88,"m"
10,"ADDUCTOR",1,"Con07",660,680,1100,1350,670,1225,0.828,-555,947.5,"Con",-20,-250,FALSE,FALSE,FALSE,45.31,"young",43,185,88,"m"
10,"ADDUCTOR",1,"Con08",680,720,850,1000,700,925,0.321,-225,812.5,"Con",-40,-150,FALSE,TRUE,FALSE,24.32,"young",43,185,88,"m"
10,"ADDUCTOR",1,"Con09",640,640,700,850,640,775,0.211,-135,707.5,"Con",0,-150,FALSE,FALSE,FALSE,17.42,"young",43,185,88,"m"
10,"ADDUCTOR",1,"Con10",660,680,750,800,670,775,0.157,-105,722.5,"Con",-20,-50,FALSE,FALSE,FALSE,13.55,"young",43,185,88,"m"
10,"ADDUCTOR",2,"Con01",680,680,750,750,680,750,0.103,-70,715,"Con",0,0,FALSE,FALSE,FALSE,9.33,"young",43,185,88,"m"
10,"ADDUCTOR",2,"Con02",580,600,1300,1300,590,1300,1.203,-710,945,"Con",-20,0,TRUE,FALSE,FALSE,54.62,"young",43,185,88,"m"
10,"ADDUCTOR",2,"Con03",660,660,800,800,660,800,0.212,-140,730,"Con",0,0,FALSE,FALSE,FALSE,17.5,"young",43,185,88,"m"
10,"ADDUCTOR",2,"Con04",600,620,900,950,610,925,0.516,-315,767.5,"Con",-20,-50,FALSE,FALSE,FALSE,34.05,"young",43,185,88,"m"
10,"ADDUCTOR",2,"Con05",580,600,800,750,590,775,0.314,-185,682.5,"Con",-20,50,FALSE,FALSE,FALSE,23.87,"young",43,185,88,"m"
10,"ADDUCTOR",2,"Con06",620,600,850,850,610,850,0.393,-240,730,"Con",20,0,FALSE,FALSE,FALSE,28.24,"young",43,185,88,"m"
10,"ADDUCTOR",2,"Con07",560,600,750,800,580,775,0.336,-195,677.5,"Con",-40,-50,FALSE,TRUE,FALSE,25.16,"young",43,185,88,"m"
10,"ADDUCTOR",2,"Con08",620,620,700,700,620,700,0.129,-80,660,"Con",0,0,FALSE,FALSE,FALSE,11.43,"young",43,185,88,"m"
10,"ADDUCTOR",2,"Con09",620,640,850,900,630,875,0.389,-245,752.5,"Con",-20,-50,FALSE,FALSE,FALSE,28,"young",43,185,88,"m"
10,"ADDUCTOR",2,"Con10",620,660,1400,1400,640,1400,1.188,-760,1020,"Con",-40,0,TRUE,TRUE,FALSE,54.29,"young",43,185,88,"m"
10,"ADDUCTOR",1,"Ecc01",1960,1960,1850,1750,1960,1800,0.082,160,1880,"Ecc",0,100,FALSE,FALSE,FALSE,8.89,"young",43,185,88,"m"
10,"ADDUCTOR",1,"Ecc02",1800,1800,1750,1850,1800,1800,0,0,1800,"Ecc",0,-100,FALSE,FALSE,FALSE,0,"young",43,185,88,"m"
10,"ADDUCTOR",1,"Ecc03",1760,1740,1650,1700,1750,1675,0.043,75,1712.5,"Ecc",20,-50,FALSE,FALSE,FALSE,4.48,"young",43,185,88,"m"
10,"ADDUCTOR",1,"Ecc04",1800,1800,1450,1600,1800,1525,0.153,275,1662.5,"Ecc",0,-150,FALSE,FALSE,FALSE,18.03,"young",43,185,88,"m"
10,"ADDUCTOR",1,"Ecc05",1720,1700,1500,1550,1710,1525,0.108,185,1617.5,"Ecc",20,-50,FALSE,FALSE,FALSE,12.13,"young",43,185,88,"m"
10,"ADDUCTOR",1,"Ecc06",1940,1900,1450,1250,1920,1350,0.297,570,1635,"Ecc",40,200,TRUE,TRUE,FALSE,42.22,"young",43,185,88,"m"
10,"ADDUCTOR",1,"Ecc07",1740,1720,1500,1350,1730,1425,0.176,305,1577.5,"Ecc",20,150,FALSE,FALSE,FALSE,21.4,"young",43,185,88,"m"
10,"ADDUCTOR",1,"Ecc08",1540,1520,1450,1350,1530,1400,0.085,130,1465,"Ecc",20,100,FALSE,FALSE,FALSE,9.29,"young",43,185,88,"m"
10,"ADDUCTOR",1,"Ecc09",1820,1800,1750,1650,1810,1700,0.061,110,1755,"Ecc",20,100,FALSE,FALSE,FALSE,6.47,"young",43,185,88,"m"
10,"ADDUCTOR",1,"Ecc10",1280,1260,1750,1200,1270,1475,0.161,-205,1372.5,"Ecc",20,550,FALSE,FALSE,TRUE,13.9,"young",43,185,88,"m"
10,"ADDUCTOR",2,"Ecc01",2240,2220,1500,1500,2230,1500,0.327,730,1865,"Ecc",20,0,TRUE,FALSE,FALSE,48.67,"young",43,185,88,"m"
10,"ADDUCTOR",2,"Ecc02",1960,1960,1850,1850,1960,1850,0.056,110,1905,"Ecc",0,0,FALSE,FALSE,FALSE,5.95,"young",43,185,88,"m"
10,"ADDUCTOR",2,"Ecc03",1960,1940,1700,1650,1950,1675,0.141,275,1812.5,"Ecc",20,50,FALSE,FALSE,FALSE,16.42,"young",43,185,88,"m"
10,"ADDUCTOR",2,"Ecc04",1980,1960,1700,1750,1970,1725,0.124,245,1847.5,"Ecc",20,-50,FALSE,FALSE,FALSE,14.2,"young",43,185,88,"m"
10,"ADDUCTOR",2,"Ecc05",1820,1820,1600,1600,1820,1600,0.121,220,1710,"Ecc",0,0,FALSE,FALSE,FALSE,13.75,"young",43,185,88,"m"
10,"ADDUCTOR",2,"Ecc06",1560,1560,1350,1300,1560,1325,0.151,235,1442.5,"Ecc",0,50,FALSE,FALSE,FALSE,17.74,"young",43,185,88,"m"
10,"ADDUCTOR",2,"Ecc07",2000,1980,1900,1900,1990,1900,0.045,90,1945,"Ecc",20,0,FALSE,FALSE,FALSE,4.74,"young",43,185,88,"m"
10,"ADDUCTOR",2,"Ecc08",1600,1600,1500,1500,1600,1500,0.062,100,1550,"Ecc",0,0,FALSE,FALSE,FALSE,6.67,"young",43,185,88,"m"
10,"ADDUCTOR",2,"Ecc09",2100,2060,1350,1300,2080,1325,0.363,755,1702.5,"Ecc",40,50,TRUE,TRUE,FALSE,56.98,"young",43,185,88,"m"
10,"ADDUCTOR",2,"Ecc10",1600,1600,2000,1950,1600,1975,0.234,-375,1787.5,"Ecc",0,50,FALSE,FALSE,FALSE,18.99,"young",43,185,88,"m"
10,"ADDUCTOR",1,"Rep01",2720,2720,2800,2600,2720,2700,0.007,20,2710,"Rep",0,200,FALSE,FALSE,FALSE,0.74,"young",43,185,88,"m"
10,"ADDUCTOR",1,"Rep02",2400,2420,2450,2550,2410,2500,0.037,-90,2455,"Rep",-20,-100,FALSE,FALSE,FALSE,3.6,"young",43,185,88,"m"
10,"ADDUCTOR",1,"Rep03",2360,2340,2300,2250,2350,2275,0.032,75,2312.5,"Rep",20,50,FALSE,FALSE,FALSE,3.3,"young",43,185,88,"m"
10,"ADDUCTOR",1,"Rep04",2380,2400,2200,2350,2390,2275,0.048,115,2332.5,"Rep",-20,-150,FALSE,FALSE,FALSE,5.05,"young",43,185,88,"m"
10,"ADDUCTOR",1,"Rep05",2340,2340,2500,2350,2340,2425,0.036,-85,2382.5,"Rep",0,150,FALSE,FALSE,FALSE,3.51,"young",43,185,88,"m"
10,"ADDUCTOR",1,"Rep06",2580,2560,2350,2100,2570,2225,0.134,345,2397.5,"Rep",20,250,FALSE,FALSE,TRUE,15.51,"young",43,185,88,"m"
10,"ADDUCTOR",1,"Rep07",2400,2400,2600,2700,2400,2650,0.104,-250,2525,"Rep",0,-100,FALSE,FALSE,FALSE,9.43,"young",43,185,88,"m"
10,"ADDUCTOR",1,"Rep08",2220,2240,2300,2350,2230,2325,0.043,-95,2277.5,"Rep",-20,-50,FALSE,FALSE,FALSE,4.09,"young",43,185,88,"m"
10,"ADDUCTOR",1,"Rep09",2460,2440,2450,2500,2450,2475,0.01,-25,2462.5,"Rep",20,-50,FALSE,FALSE,FALSE,1.01,"young",43,185,88,"m"
10,"ADDUCTOR",1,"Rep10",1940,1940,2500,2000,1940,2250,0.16,-310,2095,"Rep",0,500,FALSE,FALSE,TRUE,13.78,"young",43,185,88,"m"
10,"ADDUCTOR",2,"Rep01",2920,2900,2250,2250,2910,2250,0.227,660,2580,"Rep",20,0,TRUE,FALSE,FALSE,29.33,"young",43,185,88,"m"
10,"ADDUCTOR",2,"Rep02",2540,2560,3150,3150,2550,3150,0.235,-600,2850,"Rep",-20,0,TRUE,FALSE,FALSE,19.05,"young",43,185,88,"m"
10,"ADDUCTOR",2,"Rep03",2620,2600,2500,2450,2610,2475,0.052,135,2542.5,"Rep",20,50,FALSE,FALSE,FALSE,5.45,"young",43,185,88,"m"
10,"ADDUCTOR",2,"Rep04",2580,2580,2600,2700,2580,2650,0.027,-70,2615,"Rep",0,-100,FALSE,FALSE,FALSE,2.64,"young",43,185,88,"m"
10,"ADDUCTOR",2,"Rep05",2400,2420,2400,2350,2410,2375,0.015,35,2392.5,"Rep",-20,50,FALSE,FALSE,FALSE,1.47,"young",43,185,88,"m"
10,"ADDUCTOR",2,"Rep06",2180,2160,2200,2150,2170,2175,0.002,-5,2172.5,"Rep",20,50,FALSE,FALSE,FALSE,0.23,"young",43,185,88,"m"
10,"ADDUCTOR",2,"Rep07",2560,2580,2650,2700,2570,2675,0.041,-105,2622.5,"Rep",-20,-50,FALSE,FALSE,FALSE,3.93,"young",43,185,88,"m"
10,"ADDUCTOR",2,"Rep08",2220,2220,2200,2200,2220,2200,0.009,20,2210,"Rep",0,0,FALSE,FALSE,FALSE,0.91,"young",43,185,88,"m"
10,"ADDUCTOR",2,"Rep09",2720,2700,2200,2200,2710,2200,0.188,510,2455,"Rep",20,0,TRUE,FALSE,FALSE,23.18,"young",43,185,88,"m"
10,"ADDUCTOR",2,"Rep10",2220,2260,3400,3350,2240,3375,0.507,-1135,2807.5,"Rep",-40,50,TRUE,FALSE,FALSE,33.63,"young",43,185,88,"m"
10,"ADDUCTOR",1,"TuT",23800,23800,24450,23750,23800,24100,0.013,-300,23950,"TuT",0,700,FALSE,FALSE,TRUE,1.24,"young",43,185,88,"m"
10,"ADDUCTOR",2,"TuT",24960,24980,25550,25500,24970,25525,0.022,-555,25247.5,"TuT",-20,50,FALSE,FALSE,FALSE,2.17,"young",43,185,88,"m"
10,"LOWER BACK",1,"Con01",1060,1080,1200,1200,1070,1200,0.121,-130,1135,"Con",-20,0,FALSE,FALSE,FALSE,10.83,"young",43,185,88,"m"
10,"LOWER BACK",1,"Con02",880,880,1050,1000,880,1025,0.165,-145,952.5,"Con",0,50,FALSE,FALSE,FALSE,14.15,"young",43,185,88,"m"
10,"LOWER BACK",1,"Con03",1040,1040,1150,1100,1040,1125,0.082,-85,1082.5,"Con",0,50,FALSE,FALSE,FALSE,7.56,"young",43,185,88,"m"
10,"LOWER BACK",1,"Con04",980,980,1050,1050,980,1050,0.071,-70,1015,"Con",0,0,FALSE,FALSE,FALSE,6.67,"young",43,185,88,"m"
10,"LOWER BACK",1,"Con05",1000,1000,1050,1100,1000,1075,0.075,-75,1037.5,"Con",0,-50,FALSE,FALSE,FALSE,6.98,"young",43,185,88,"m"
10,"LOWER BACK",1,"Con06",940,960,1050,1050,950,1050,0.105,-100,1000,"Con",-20,0,FALSE,FALSE,FALSE,9.52,"young",43,185,88,"m"
10,"LOWER BACK",1,"Con07",1020,1040,1150,1150,1030,1150,0.117,-120,1090,"Con",-20,0,FALSE,FALSE,FALSE,10.43,"young",43,185,88,"m"
10,"LOWER BACK",1,"Con08",1000,1000,1100,1100,1000,1100,0.1,-100,1050,"Con",0,0,FALSE,FALSE,FALSE,9.09,"young",43,185,88,"m"
10,"LOWER BACK",1,"Con09",1020,1020,1150,1200,1020,1175,0.152,-155,1097.5,"Con",0,-50,FALSE,FALSE,FALSE,13.19,"young",43,185,88,"m"
10,"LOWER BACK",1,"Con10",1040,1060,1200,1250,1050,1225,0.167,-175,1137.5,"Con",-20,-50,FALSE,FALSE,FALSE,14.29,"young",43,185,88,"m"
10,"LOWER BACK",2,"Con01",980,1000,1150,2100,990,1625,0.641,-635,1307.5,"Con",-20,-950,TRUE,FALSE,TRUE,39.08,"young",43,185,88,"m"
10,"LOWER BACK",2,"Con02",920,900,1000,1400,910,1200,0.319,-290,1055,"Con",20,-400,TRUE,FALSE,TRUE,24.17,"young",43,185,88,"m"
10,"LOWER BACK",2,"Con03",900,920,950,850,910,900,0.011,10,905,"Con",-20,100,FALSE,FALSE,FALSE,1.11,"young",43,185,88,"m"
10,"LOWER BACK",2,"Con04",900,920,1000,900,910,950,0.044,-40,930,"Con",-20,100,FALSE,FALSE,FALSE,4.21,"young",43,185,88,"m"
10,"LOWER BACK",2,"Con05",840,860,1000,950,850,975,0.147,-125,912.5,"Con",-20,50,FALSE,FALSE,FALSE,12.82,"young",43,185,88,"m"
10,"LOWER BACK",2,"Con06",900,920,1050,1100,910,1075,0.181,-165,992.5,"Con",-20,-50,FALSE,FALSE,FALSE,15.35,"young",43,185,88,"m"
10,"LOWER BACK",2,"Con07",900,900,1050,1100,900,1075,0.194,-175,987.5,"Con",0,-50,FALSE,FALSE,FALSE,16.28,"young",43,185,88,"m"
10,"LOWER BACK",2,"Con08",840,860,950,1050,850,1000,0.176,-150,925,"Con",-20,-100,FALSE,FALSE,FALSE,15,"young",43,185,88,"m"
10,"LOWER BACK",2,"Con09",920,920,1000,1100,920,1050,0.141,-130,985,"Con",0,-100,FALSE,FALSE,FALSE,12.38,"young",43,185,88,"m"
10,"LOWER BACK",2,"Con10",940,920,1050,1150,930,1100,0.183,-170,1015,"Con",20,-100,FALSE,FALSE,FALSE,15.45,"young",43,185,88,"m"
10,"LOWER BACK",1,"Ecc01",2320,2320,2200,2250,2320,2225,0.041,95,2272.5,"Ecc",0,-50,FALSE,FALSE,FALSE,4.27,"young",43,185,88,"m"
10,"LOWER BACK",1,"Ecc02",2080,2080,1950,2000,2080,1975,0.05,105,2027.5,"Ecc",0,-50,FALSE,FALSE,FALSE,5.32,"young",43,185,88,"m"
10,"LOWER BACK",1,"Ecc03",1940,1920,1850,1850,1930,1850,0.041,80,1890,"Ecc",20,0,FALSE,FALSE,FALSE,4.32,"young",43,185,88,"m"
10,"LOWER BACK",1,"Ecc04",1960,1980,1900,1900,1970,1900,0.036,70,1935,"Ecc",-20,0,FALSE,FALSE,FALSE,3.68,"young",43,185,88,"m"
10,"LOWER BACK",1,"Ecc05",1840,1820,1750,1750,1830,1750,0.044,80,1790,"Ecc",20,0,FALSE,FALSE,FALSE,4.57,"young",43,185,88,"m"
10,"LOWER BACK",1,"Ecc06",1860,1840,1750,1750,1850,1750,0.054,100,1800,"Ecc",20,0,FALSE,FALSE,FALSE,5.71,"young",43,185,88,"m"
10,"LOWER BACK",1,"Ecc07",1860,1860,1750,1700,1860,1725,0.073,135,1792.5,"Ecc",0,50,FALSE,FALSE,FALSE,7.83,"young",43,185,88,"m"
10,"LOWER BACK",1,"Ecc08",1680,1680,1550,1550,1680,1550,0.077,130,1615,"Ecc",0,0,FALSE,FALSE,FALSE,8.39,"young",43,185,88,"m"
10,"LOWER BACK",1,"Ecc09",1680,1660,1550,1500,1670,1525,0.087,145,1597.5,"Ecc",20,50,FALSE,FALSE,FALSE,9.51,"young",43,185,88,"m"
10,"LOWER BACK",1,"Ecc10",1740,1740,1750,1800,1740,1775,0.02,-35,1757.5,"Ecc",0,-50,FALSE,FALSE,FALSE,1.97,"young",43,185,88,"m"
10,"LOWER BACK",2,"Ecc01",2040,2060,1950,1400,2050,1675,0.183,375,1862.5,"Ecc",-20,550,TRUE,FALSE,TRUE,22.39,"young",43,185,88,"m"
10,"LOWER BACK",2,"Ecc02",1900,1900,1850,2000,1900,1925,0.013,-25,1912.5,"Ecc",0,-150,FALSE,FALSE,FALSE,1.3,"young",43,185,88,"m"
10,"LOWER BACK",2,"Ecc03",1780,1740,1700,1800,1760,1750,0.006,10,1755,"Ecc",40,-100,FALSE,FALSE,FALSE,0.57,"young",43,185,88,"m"
10,"LOWER BACK",2,"Ecc04",1760,1740,1600,1700,1750,1650,0.057,100,1700,"Ecc",20,-100,FALSE,FALSE,FALSE,6.06,"young",43,185,88,"m"
10,"LOWER BACK",2,"Ecc05",1820,1800,1700,1650,1810,1675,0.075,135,1742.5,"Ecc",20,50,FALSE,FALSE,FALSE,8.06,"young",43,185,88,"m"
10,"LOWER BACK",2,"Ecc06",1640,1640,1500,1450,1640,1475,0.101,165,1557.5,"Ecc",0,50,FALSE,FALSE,FALSE,11.19,"young",43,185,88,"m"
10,"LOWER BACK",2,"Ecc07",1740,1740,1600,1550,1740,1575,0.095,165,1657.5,"Ecc",0,50,FALSE,FALSE,FALSE,10.48,"young",43,185,88,"m"
10,"LOWER BACK",2,"Ecc08",1720,1720,1650,1500,1720,1575,0.084,145,1647.5,"Ecc",0,150,FALSE,FALSE,FALSE,9.21,"young",43,185,88,"m"
10,"LOWER BACK",2,"Ecc09",1580,1580,1450,1400,1580,1425,0.098,155,1502.5,"Ecc",0,50,FALSE,FALSE,FALSE,10.88,"young",43,185,88,"m"
10,"LOWER BACK",2,"Ecc10",1580,1600,1650,1550,1590,1600,0.006,-10,1595,"Ecc",-20,100,FALSE,FALSE,FALSE,0.62,"young",43,185,88,"m"
10,"LOWER BACK",1,"Rep01",3380,3400,3400,3450,3390,3425,0.01,-35,3407.5,"Rep",-20,-50,FALSE,FALSE,FALSE,1.02,"young",43,185,88,"m"
10,"LOWER BACK",1,"Rep02",2960,2960,3000,3000,2960,3000,0.014,-40,2980,"Rep",0,0,FALSE,FALSE,FALSE,1.33,"young",43,185,88,"m"
10,"LOWER BACK",1,"Rep03",2980,2960,3000,2950,2970,2975,0.002,-5,2972.5,"Rep",20,50,FALSE,FALSE,FALSE,0.17,"young",43,185,88,"m"
10,"LOWER BACK",1,"Rep04",2940,2960,2950,2950,2950,2950,0,0,2950,"Rep",-20,0,FALSE,FALSE,FALSE,0,"young",43,185,88,"m"
10,"LOWER BACK",1,"Rep05",2840,2820,2800,2850,2830,2825,0.002,5,2827.5,"Rep",20,-50,FALSE,FALSE,FALSE,0.18,"young",43,185,88,"m"
10,"LOWER BACK",1,"Rep06",2800,2800,2800,2800,2800,2800,0,0,2800,"Rep",0,0,FALSE,FALSE,FALSE,0,"young",43,185,88,"m"
10,"LOWER BACK",1,"Rep07",2880,2900,2900,2850,2890,2875,0.005,15,2882.5,"Rep",-20,50,FALSE,FALSE,FALSE,0.52,"young",43,185,88,"m"
10,"LOWER BACK",1,"Rep08",2680,2680,2650,2650,2680,2650,0.011,30,2665,"Rep",0,0,FALSE,FALSE,FALSE,1.13,"young",43,185,88,"m"
10,"LOWER BACK",1,"Rep09",2700,2680,2700,2700,2690,2700,0.004,-10,2695,"Rep",20,0,FALSE,FALSE,FALSE,0.37,"young",43,185,88,"m"
10,"LOWER BACK",1,"Rep10",2780,2800,2950,3050,2790,3000,0.075,-210,2895,"Rep",-20,-100,TRUE,FALSE,FALSE,7,"young",43,185,88,"m"
10,"LOWER BACK",2,"Rep01",3020,3060,3100,3500,3040,3300,0.086,-260,3170,"Rep",-40,-400,TRUE,FALSE,TRUE,7.88,"young",43,185,88,"m"
10,"LOWER BACK",2,"Rep02",2820,2800,2850,3400,2810,3125,0.112,-315,2967.5,"Rep",20,-550,TRUE,FALSE,TRUE,10.08,"young",43,185,88,"m"
10,"LOWER BACK",2,"Rep03",2680,2660,2650,2650,2670,2650,0.007,20,2660,"Rep",20,0,FALSE,FALSE,FALSE,0.75,"young",43,185,88,"m"
10,"LOWER BACK",2,"Rep04",2660,2660,2600,2600,2660,2600,0.023,60,2630,"Rep",0,0,FALSE,FALSE,FALSE,2.31,"young",43,185,88,"m"
10,"LOWER BACK",2,"Rep05",2660,2660,2700,2600,2660,2650,0.004,10,2655,"Rep",0,100,FALSE,FALSE,FALSE,0.38,"young",43,185,88,"m"
10,"LOWER BACK",2,"Rep06",2540,2560,2550,2550,2550,2550,0,0,2550,"Rep",-20,0,FALSE,FALSE,FALSE,0,"young",43,185,88,"m"
10,"LOWER BACK",2,"Rep07",2640,2640,2650,2650,2640,2650,0.004,-10,2645,"Rep",0,0,FALSE,FALSE,FALSE,0.38,"young",43,185,88,"m"
10,"LOWER BACK",2,"Rep08",2560,2580,2600,2550,2570,2575,0.002,-5,2572.5,"Rep",-20,50,FALSE,FALSE,FALSE,0.19,"young",43,185,88,"m"
10,"LOWER BACK",2,"Rep09",2500,2500,2450,2500,2500,2475,0.01,25,2487.5,"Rep",0,-50,FALSE,FALSE,FALSE,1.01,"young",43,185,88,"m"
10,"LOWER BACK",2,"Rep10",2520,2520,2700,2700,2520,2700,0.071,-180,2610,"Rep",0,0,TRUE,FALSE,FALSE,6.67,"young",43,185,88,"m"
10,"LOWER BACK",1,"TuT",28940,28960,29150,29250,28950,29200,0.009,-250,29075,"TuT",-20,-100,TRUE,FALSE,FALSE,0.86,"young",43,185,88,"m"
10,"LOWER BACK",2,"TuT",26600,26640,26850,27700,26620,27275,0.025,-655,26947.5,"TuT",-40,-850,TRUE,FALSE,TRUE,2.4,"young",43,185,88,"m"
10,"TOTAL ABDOMINAL",1,"Con01",920,920,1000,1050,920,1025,0.114,-105,972.5,"Con",0,-50,FALSE,FALSE,FALSE,10.24,"young",43,185,88,"m"
10,"TOTAL ABDOMINAL",1,"Con02",660,660,700,700,660,700,0.061,-40,680,"Con",0,0,FALSE,FALSE,FALSE,5.71,"young",43,185,88,"m"
10,"TOTAL ABDOMINAL",1,"Con03",640,640,750,700,640,725,0.133,-85,682.5,"Con",0,50,FALSE,FALSE,FALSE,11.72,"young",43,185,88,"m"
10,"TOTAL ABDOMINAL",1,"Con04",720,740,800,800,730,800,0.096,-70,765,"Con",-20,0,FALSE,FALSE,FALSE,8.75,"young",43,185,88,"m"
10,"TOTAL ABDOMINAL",1,"Con05",680,660,700,750,670,725,0.082,-55,697.5,"Con",20,-50,FALSE,FALSE,FALSE,7.59,"young",43,185,88,"m"
10,"TOTAL ABDOMINAL",1,"Con06",680,700,750,800,690,775,0.123,-85,732.5,"Con",-20,-50,FALSE,FALSE,FALSE,10.97,"young",43,185,88,"m"
10,"TOTAL ABDOMINAL",1,"Con07",680,700,750,750,690,750,0.087,-60,720,"Con",-20,0,FALSE,FALSE,FALSE,8,"young",43,185,88,"m"
10,"TOTAL ABDOMINAL",1,"Con08",700,700,850,850,700,850,0.214,-150,775,"Con",0,0,TRUE,FALSE,FALSE,17.65,"young",43,185,88,"m"
10,"TOTAL ABDOMINAL",1,"Con09",620,620,850,850,620,850,0.371,-230,735,"Con",0,0,TRUE,FALSE,FALSE,27.06,"young",43,185,88,"m"
10,"TOTAL ABDOMINAL",1,"Con10",720,700,1000,950,710,975,0.373,-265,842.5,"Con",20,50,TRUE,FALSE,FALSE,27.18,"young",43,185,88,"m"
10,"TOTAL ABDOMINAL",2,"Con01",700,700,850,800,700,825,0.179,-125,762.5,"Con",0,50,FALSE,FALSE,FALSE,15.15,"young",43,185,88,"m"
10,"TOTAL ABDOMINAL",2,"Con02",660,660,750,750,660,750,0.136,-90,705,"Con",0,0,FALSE,FALSE,FALSE,12,"young",43,185,88,"m"
10,"TOTAL ABDOMINAL",2,"Con03",620,620,750,700,620,725,0.169,-105,672.5,"Con",0,50,FALSE,FALSE,FALSE,14.48,"young",43,185,88,"m"
10,"TOTAL ABDOMINAL",2,"Con04",640,640,750,750,640,750,0.172,-110,695,"Con",0,0,FALSE,FALSE,FALSE,14.67,"young",43,185,88,"m"
10,"TOTAL ABDOMINAL",2,"Con05",640,660,750,750,650,750,0.154,-100,700,"Con",-20,0,FALSE,FALSE,FALSE,13.33,"young",43,185,88,"m"
10,"TOTAL ABDOMINAL",2,"Con06",640,620,750,750,630,750,0.19,-120,690,"Con",20,0,FALSE,FALSE,FALSE,16,"young",43,185,88,"m"
10,"TOTAL ABDOMINAL",2,"Con07",620,620,750,750,620,750,0.21,-130,685,"Con",0,0,FALSE,FALSE,FALSE,17.33,"young",43,185,88,"m"
10,"TOTAL ABDOMINAL",2,"Con08",640,660,800,800,650,800,0.231,-150,725,"Con",-20,0,TRUE,FALSE,FALSE,18.75,"young",43,185,88,"m"
10,"TOTAL ABDOMINAL",2,"Con09",620,620,800,750,620,775,0.25,-155,697.5,"Con",0,50,TRUE,FALSE,FALSE,20,"young",43,185,88,"m"
10,"TOTAL ABDOMINAL",2,"Con10",660,700,850,850,680,850,0.25,-170,765,"Con",-40,0,TRUE,TRUE,FALSE,20,"young",43,185,88,"m"
10,"TOTAL ABDOMINAL",1,"Ecc01",1320,1320,1400,1300,1320,1350,0.023,-30,1335,"Ecc",0,100,FALSE,FALSE,FALSE,2.22,"young",43,185,88,"m"
10,"TOTAL ABDOMINAL",1,"Ecc02",1280,1280,1150,1250,1280,1200,0.062,80,1240,"Ecc",0,-100,FALSE,FALSE,FALSE,6.67,"young",43,185,88,"m"
10,"TOTAL ABDOMINAL",1,"Ecc03",1280,1260,1150,1150,1270,1150,0.094,120,1210,"Ecc",20,0,FALSE,FALSE,FALSE,10.43,"young",43,185,88,"m"
10,"TOTAL ABDOMINAL",1,"Ecc04",1280,1280,1250,1250,1280,1250,0.023,30,1265,"Ecc",0,0,FALSE,FALSE,FALSE,2.4,"young",43,185,88,"m"
10,"TOTAL ABDOMINAL",1,"Ecc05",1200,1200,1150,1100,1200,1125,0.062,75,1162.5,"Ecc",0,50,FALSE,FALSE,FALSE,6.67,"young",43,185,88,"m"
10,"TOTAL ABDOMINAL",1,"Ecc06",1200,1180,1150,1100,1190,1125,0.055,65,1157.5,"Ecc",20,50,FALSE,FALSE,FALSE,5.78,"young",43,185,88,"m"
10,"TOTAL ABDOMINAL",1,"Ecc07",1260,1260,1150,1150,1260,1150,0.087,110,1205,"Ecc",0,0,FALSE,FALSE,FALSE,9.57,"young",43,185,88,"m"
10,"TOTAL ABDOMINAL",1,"Ecc08",1180,1180,1000,1000,1180,1000,0.153,180,1090,"Ecc",0,0,TRUE,FALSE,FALSE,18,"young",43,185,88,"m"
10,"TOTAL ABDOMINAL",1,"Ecc09",1240,1240,950,1000,1240,975,0.214,265,1107.5,"Ecc",0,-50,TRUE,FALSE,FALSE,27.18,"young",43,185,88,"m"
10,"TOTAL ABDOMINAL",1,"Ecc10",1260,1280,1250,1200,1270,1225,0.035,45,1247.5,"Ecc",-20,50,FALSE,FALSE,FALSE,3.67,"young",43,185,88,"m"
10,"TOTAL ABDOMINAL",2,"Ecc01",1220,1220,1150,1150,1220,1150,0.057,70,1185,"Ecc",0,0,FALSE,FALSE,FALSE,6.09,"young",43,185,88,"m"
10,"TOTAL ABDOMINAL",2,"Ecc02",1240,1240,1150,1150,1240,1150,0.073,90,1195,"Ecc",0,0,FALSE,FALSE,FALSE,7.83,"young",43,185,88,"m"
10,"TOTAL ABDOMINAL",2,"Ecc03",1160,1160,1000,1050,1160,1025,0.116,135,1092.5,"Ecc",0,-50,FALSE,FALSE,FALSE,13.17,"young",43,185,88,"m"
10,"TOTAL ABDOMINAL",2,"Ecc04",1180,1180,1100,1100,1180,1100,0.068,80,1140,"Ecc",0,0,FALSE,FALSE,FALSE,7.27,"young",43,185,88,"m"
10,"TOTAL ABDOMINAL",2,"Ecc05",1220,1220,1100,1100,1220,1100,0.098,120,1160,"Ecc",0,0,FALSE,FALSE,FALSE,10.91,"young",43,185,88,"m"
10,"TOTAL ABDOMINAL",2,"Ecc06",1400,1400,1300,1250,1400,1275,0.089,125,1337.5,"Ecc",0,50,FALSE,FALSE,FALSE,9.8,"young",43,185,88,"m"
10,"TOTAL ABDOMINAL",2,"Ecc07",1360,1360,1200,1250,1360,1225,0.099,135,1292.5,"Ecc",0,-50,FALSE,FALSE,FALSE,11.02,"young",43,185,88,"m"
10,"TOTAL ABDOMINAL",2,"Ecc08",1140,1120,950,1000,1130,975,0.137,155,1052.5,"Ecc",20,-50,TRUE,FALSE,FALSE,15.9,"young",43,185,88,"m"
10,"TOTAL ABDOMINAL",2,"Ecc09",1260,1240,1100,1100,1250,1100,0.12,150,1175,"Ecc",20,0,TRUE,FALSE,FALSE,13.64,"young",43,185,88,"m"
10,"TOTAL ABDOMINAL",2,"Ecc10",1260,1240,1200,1200,1250,1200,0.04,50,1225,"Ecc",20,0,FALSE,FALSE,FALSE,4.17,"young",43,185,88,"m"
10,"TOTAL ABDOMINAL",1,"Rep01",2240,2240,2400,2350,2240,2375,0.06,-135,2307.5,"Rep",0,50,TRUE,FALSE,FALSE,5.68,"young",43,185,88,"m"
10,"TOTAL ABDOMINAL",1,"Rep02",1940,1940,1850,1950,1940,1900,0.021,40,1920,"Rep",0,-100,FALSE,FALSE,FALSE,2.11,"young",43,185,88,"m"
10,"TOTAL ABDOMINAL",1,"Rep03",1920,1900,1900,1850,1910,1875,0.018,35,1892.5,"Rep",20,50,FALSE,FALSE,FALSE,1.87,"young",43,185,88,"m"
10,"TOTAL ABDOMINAL",1,"Rep04",2000,2020,2050,2050,2010,2050,0.02,-40,2030,"Rep",-20,0,FALSE,FALSE,FALSE,1.95,"young",43,185,88,"m"
10,"TOTAL ABDOMINAL",1,"Rep05",1880,1860,1850,1850,1870,1850,0.011,20,1860,"Rep",20,0,FALSE,FALSE,FALSE,1.08,"young",43,185,88,"m"
10,"TOTAL ABDOMINAL",1,"Rep06",1880,1880,1900,1900,1880,1900,0.011,-20,1890,"Rep",0,0,FALSE,FALSE,FALSE,1.05,"young",43,185,88,"m"
10,"TOTAL ABDOMINAL",1,"Rep07",1940,1960,1900,1900,1950,1900,0.026,50,1925,"Rep",-20,0,FALSE,FALSE,FALSE,2.63,"young",43,185,88,"m"
10,"TOTAL ABDOMINAL",1,"Rep08",1880,1880,1850,1850,1880,1850,0.016,30,1865,"Rep",0,0,FALSE,FALSE,FALSE,1.62,"young",43,185,88,"m"
10,"TOTAL ABDOMINAL",1,"Rep09",1860,1860,1800,1850,1860,1825,0.019,35,1842.5,"Rep",0,-50,FALSE,FALSE,FALSE,1.92,"young",43,185,88,"m"
10,"TOTAL ABDOMINAL",1,"Rep10",1980,1980,2250,2150,1980,2200,0.111,-220,2090,"Rep",0,100,TRUE,FALSE,FALSE,10,"young",43,185,88,"m"
10,"TOTAL ABDOMINAL",2,"Rep01",1920,1920,2000,1950,1920,1975,0.029,-55,1947.5,"Rep",0,50,FALSE,FALSE,FALSE,2.78,"young",43,185,88,"m"
10,"TOTAL ABDOMINAL",2,"Rep02",1900,1900,1900,1900,1900,1900,0,0,1900,"Rep",0,0,FALSE,FALSE,FALSE,0,"young",43,185,88,"m"
10,"TOTAL ABDOMINAL",2,"Rep03",1780,1780,1750,1750,1780,1750,0.017,30,1765,"Rep",0,0,FALSE,FALSE,FALSE,1.71,"young",43,185,88,"m"
10,"TOTAL ABDOMINAL",2,"Rep04",1820,1820,1850,1850,1820,1850,0.016,-30,1835,"Rep",0,0,FALSE,FALSE,FALSE,1.62,"young",43,185,88,"m"
10,"TOTAL ABDOMINAL",2,"Rep05",1860,1880,1850,1850,1870,1850,0.011,20,1860,"Rep",-20,0,FALSE,FALSE,FALSE,1.08,"young",43,185,88,"m"
10,"TOTAL ABDOMINAL",2,"Rep06",2040,2020,2050,2000,2030,2025,0.002,5,2027.5,"Rep",20,50,FALSE,FALSE,FALSE,0.25,"young",43,185,88,"m"
10,"TOTAL ABDOMINAL",2,"Rep07",1980,1980,1950,2000,1980,1975,0.003,5,1977.5,"Rep",0,-50,FALSE,FALSE,FALSE,0.25,"young",43,185,88,"m"
10,"TOTAL ABDOMINAL",2,"Rep08",1780,1780,1750,1800,1780,1775,0.003,5,1777.5,"Rep",0,-50,FALSE,FALSE,FALSE,0.28,"young",43,185,88,"m"
10,"TOTAL ABDOMINAL",2,"Rep09",1880,1860,1900,1850,1870,1875,0.003,-5,1872.5,"Rep",20,50,FALSE,FALSE,FALSE,0.27,"young",43,185,88,"m"
10,"TOTAL ABDOMINAL",2,"Rep10",1920,1940,2050,2050,1930,2050,0.062,-120,1990,"Rep",-20,0,FALSE,FALSE,FALSE,5.85,"young",43,185,88,"m"
10,"TOTAL ABDOMINAL",1,"TuT",19520,19520,19750,19700,19520,19725,0.011,-205,19622.5,"TuT",0,50,TRUE,FALSE,FALSE,1.04,"young",43,185,88,"m"
10,"TOTAL ABDOMINAL",2,"TuT",18880,18880,19050,19000,18880,19025,0.008,-145,18952.5,"TuT",0,50,FALSE,FALSE,FALSE,0.76,"young",43,185,88,"m"
10,"VERTICAL TRACTION",1,"Con01",940,960,3550,3650,950,3600,2.789,-2650,2275,"Con",-20,-100,TRUE,FALSE,FALSE,73.61,"young",43,185,88,"m"
10,"VERTICAL TRACTION",1,"Con02",860,860,1050,950,860,1000,0.163,-140,930,"Con",0,100,FALSE,FALSE,FALSE,14,"young",43,185,88,"m"
10,"VERTICAL TRACTION",1,"Con03",880,880,1000,950,880,975,0.108,-95,927.5,"Con",0,50,FALSE,FALSE,FALSE,9.74,"young",43,185,88,"m"
10,"VERTICAL TRACTION",1,"Con04",840,860,950,850,850,900,0.059,-50,875,"Con",-20,100,FALSE,FALSE,FALSE,5.56,"young",43,185,88,"m"
10,"VERTICAL TRACTION",1,"Con05",920,920,950,950,920,950,0.033,-30,935,"Con",0,0,FALSE,FALSE,FALSE,3.16,"young",43,185,88,"m"
10,"VERTICAL TRACTION",1,"Con06",900,920,950,1000,910,975,0.071,-65,942.5,"Con",-20,-50,FALSE,FALSE,FALSE,6.67,"young",43,185,88,"m"
10,"VERTICAL TRACTION",1,"Con07",960,960,1000,1000,960,1000,0.042,-40,980,"Con",0,0,FALSE,FALSE,FALSE,4,"young",43,185,88,"m"
10,"VERTICAL TRACTION",1,"Con08",940,940,950,1000,940,975,0.037,-35,957.5,"Con",0,-50,FALSE,FALSE,FALSE,3.59,"young",43,185,88,"m"
10,"VERTICAL TRACTION",1,"Con09",900,900,900,950,900,925,0.028,-25,912.5,"Con",0,-50,FALSE,FALSE,FALSE,2.7,"young",43,185,88,"m"
10,"VERTICAL TRACTION",1,"Con10",920,920,900,1000,920,950,0.033,-30,935,"Con",0,-100,FALSE,FALSE,FALSE,3.16,"young",43,185,88,"m"
10,"VERTICAL TRACTION",2,"Con01",940,940,1550,4400,940,2975,2.165,-2035,1957.5,"Con",0,-2850,TRUE,FALSE,TRUE,68.4,"young",43,185,88,"m"
10,"VERTICAL TRACTION",2,"Con02",900,920,950,1100,910,1025,0.126,-115,967.5,"Con",-20,-150,FALSE,FALSE,FALSE,11.22,"young",43,185,88,"m"
10,"VERTICAL TRACTION",2,"Con03",800,780,900,900,790,900,0.139,-110,845,"Con",20,0,FALSE,FALSE,FALSE,12.22,"young",43,185,88,"m"
10,"VERTICAL TRACTION",2,"Con04",880,860,1000,950,870,975,0.121,-105,922.5,"Con",20,50,FALSE,FALSE,FALSE,10.77,"young",43,185,88,"m"
10,"VERTICAL TRACTION",2,"Con05",840,840,950,950,840,950,0.131,-110,895,"Con",0,0,FALSE,FALSE,FALSE,11.58,"young",43,185,88,"m"
10,"VERTICAL TRACTION",2,"Con06",960,960,1050,1000,960,1025,0.068,-65,992.5,"Con",0,50,FALSE,FALSE,FALSE,6.34,"young",43,185,88,"m"
10,"VERTICAL TRACTION",2,"Con07",800,820,900,850,810,875,0.08,-65,842.5,"Con",-20,50,FALSE,FALSE,FALSE,7.43,"young",43,185,88,"m"
10,"VERTICAL TRACTION",2,"Con08",860,880,950,900,870,925,0.063,-55,897.5,"Con",-20,50,FALSE,FALSE,FALSE,5.95,"young",43,185,88,"m"
10,"VERTICAL TRACTION",2,"Con09",820,820,900,850,820,875,0.067,-55,847.5,"Con",0,50,FALSE,FALSE,FALSE,6.29,"young",43,185,88,"m"
10,"VERTICAL TRACTION",2,"Con10",1060,1020,1250,1250,1040,1250,0.202,-210,1145,"Con",40,0,FALSE,FALSE,FALSE,16.8,"young",43,185,88,"m"
10,"VERTICAL TRACTION",1,"Ecc01",1480,1480,1300,1350,1480,1325,0.105,155,1402.5,"Ecc",0,-50,FALSE,FALSE,FALSE,11.7,"young",43,185,88,"m"
10,"VERTICAL TRACTION",1,"Ecc02",1460,1460,1300,1400,1460,1350,0.075,110,1405,"Ecc",0,-100,FALSE,FALSE,FALSE,8.15,"young",43,185,88,"m"
10,"VERTICAL TRACTION",1,"Ecc03",1440,1420,1350,1400,1430,1375,0.038,55,1402.5,"Ecc",20,-50,FALSE,FALSE,FALSE,4,"young",43,185,88,"m"
10,"VERTICAL TRACTION",1,"Ecc04",1460,1460,1400,1500,1460,1450,0.007,10,1455,"Ecc",0,-100,FALSE,FALSE,FALSE,0.69,"young",43,185,88,"m"
10,"VERTICAL TRACTION",1,"Ecc05",1520,1500,1450,1400,1510,1425,0.056,85,1467.5,"Ecc",20,50,FALSE,FALSE,FALSE,5.96,"young",43,185,88,"m"
10,"VERTICAL TRACTION",1,"Ecc06",1520,1520,1500,1450,1520,1475,0.03,45,1497.5,"Ecc",0,50,FALSE,FALSE,FALSE,3.05,"young",43,185,88,"m"
10,"VERTICAL TRACTION",1,"Ecc07",1320,1320,1300,1250,1320,1275,0.034,45,1297.5,"Ecc",0,50,FALSE,FALSE,FALSE,3.53,"young",43,185,88,"m"
10,"VERTICAL TRACTION",1,"Ecc08",1340,1340,1300,1300,1340,1300,0.03,40,1320,"Ecc",0,0,FALSE,FALSE,FALSE,3.08,"young",43,185,88,"m"
10,"VERTICAL TRACTION",1,"Ecc09",1460,1460,1500,1400,1460,1450,0.007,10,1455,"Ecc",0,100,FALSE,FALSE,FALSE,0.69,"young",43,185,88,"m"
10,"VERTICAL TRACTION",1,"Ecc10",1460,1460,1400,1500,1460,1450,0.007,10,1455,"Ecc",0,-100,FALSE,FALSE,FALSE,0.69,"young",43,185,88,"m"
10,"VERTICAL TRACTION",2,"Ecc01",1860,1860,1800,1600,1860,1700,0.086,160,1780,"Ecc",0,200,FALSE,FALSE,TRUE,9.41,"young",43,185,88,"m"
10,"VERTICAL TRACTION",2,"Ecc02",1620,1620,1500,1500,1620,1500,0.074,120,1560,"Ecc",0,0,FALSE,FALSE,FALSE,8,"young",43,185,88,"m"
10,"VERTICAL TRACTION",2,"Ecc03",1760,1780,1650,1700,1770,1675,0.054,95,1722.5,"Ecc",-20,-50,FALSE,FALSE,FALSE,5.67,"young",43,185,88,"m"
10,"VERTICAL TRACTION",2,"Ecc04",1460,1460,1350,1350,1460,1350,0.075,110,1405,"Ecc",0,0,FALSE,FALSE,FALSE,8.15,"young",43,185,88,"m"
10,"VERTICAL TRACTION",2,"Ecc05",1600,1600,1500,1500,1600,1500,0.062,100,1550,"Ecc",0,0,FALSE,FALSE,FALSE,6.67,"young",43,185,88,"m"
10,"VERTICAL TRACTION",2,"Ecc06",1400,1400,1300,1400,1400,1350,0.036,50,1375,"Ecc",0,-100,FALSE,FALSE,FALSE,3.7,"young",43,185,88,"m"
10,"VERTICAL TRACTION",2,"Ecc07",1540,1520,1450,1500,1530,1475,0.036,55,1502.5,"Ecc",20,-50,FALSE,FALSE,FALSE,3.73,"young",43,185,88,"m"
10,"VERTICAL TRACTION",2,"Ecc08",1520,1480,1450,1500,1500,1475,0.017,25,1487.5,"Ecc",40,-50,FALSE,FALSE,FALSE,1.69,"young",43,185,88,"m"
10,"VERTICAL TRACTION",2,"Ecc09",1600,1640,1400,1400,1620,1400,0.136,220,1510,"Ecc",-40,0,FALSE,FALSE,FALSE,15.71,"young",43,185,88,"m"
10,"VERTICAL TRACTION",2,"Ecc10",1520,1500,1550,1550,1510,1550,0.026,-40,1530,"Ecc",20,0,FALSE,FALSE,FALSE,2.58,"young",43,185,88,"m"
10,"VERTICAL TRACTION",1,"Rep01",2420,2440,4850,5000,2430,4925,1.027,-2495,3677.5,"Rep",-20,-150,TRUE,FALSE,FALSE,50.66,"young",43,185,88,"m"
10,"VERTICAL TRACTION",1,"Rep02",2320,2320,2350,2350,2320,2350,0.013,-30,2335,"Rep",0,0,FALSE,FALSE,FALSE,1.28,"young",43,185,88,"m"
10,"VERTICAL TRACTION",1,"Rep03",2320,2300,2350,2350,2310,2350,0.017,-40,2330,"Rep",20,0,FALSE,FALSE,FALSE,1.7,"young",43,185,88,"m"
10,"VERTICAL TRACTION",1,"Rep04",2300,2320,2350,2350,2310,2350,0.017,-40,2330,"Rep",-20,0,FALSE,FALSE,FALSE,1.7,"young",43,185,88,"m"
10,"VERTICAL TRACTION",1,"Rep05",2440,2420,2400,2350,2430,2375,0.023,55,2402.5,"Rep",20,50,FALSE,FALSE,FALSE,2.32,"young",43,185,88,"m"
10,"VERTICAL TRACTION",1,"Rep06",2420,2440,2450,2450,2430,2450,0.008,-20,2440,"Rep",-20,0,FALSE,FALSE,FALSE,0.82,"young",43,185,88,"m"
10,"VERTICAL TRACTION",1,"Rep07",2280,2280,2300,2250,2280,2275,0.002,5,2277.5,"Rep",0,50,FALSE,FALSE,FALSE,0.22,"young",43,185,88,"m"
10,"VERTICAL TRACTION",1,"Rep08",2280,2280,2250,2300,2280,2275,0.002,5,2277.5,"Rep",0,-50,FALSE,FALSE,FALSE,0.22,"young",43,185,88,"m"
10,"VERTICAL TRACTION",1,"Rep09",2360,2360,2400,2350,2360,2375,0.006,-15,2367.5,"Rep",0,50,FALSE,FALSE,FALSE,0.63,"young",43,185,88,"m"
10,"VERTICAL TRACTION",1,"Rep10",2380,2380,2300,2500,2380,2400,0.008,-20,2390,"Rep",0,-200,FALSE,FALSE,TRUE,0.83,"young",43,185,88,"m"
10,"VERTICAL TRACTION",2,"Rep01",2800,2800,3350,6000,2800,4675,0.67,-1875,3737.5,"Rep",0,-2650,TRUE,FALSE,TRUE,40.11,"young",43,185,88,"m"
10,"VERTICAL TRACTION",2,"Rep02",2520,2540,2450,2600,2530,2525,0.002,5,2527.5,"Rep",-20,-150,FALSE,FALSE,FALSE,0.2,"young",43,185,88,"m"
10,"VERTICAL TRACTION",2,"Rep03",2560,2560,2550,2600,2560,2575,0.006,-15,2567.5,"Rep",0,-50,FALSE,FALSE,FALSE,0.58,"young",43,185,88,"m"
10,"VERTICAL TRACTION",2,"Rep04",2340,2320,2350,2300,2330,2325,0.002,5,2327.5,"Rep",20,50,FALSE,FALSE,FALSE,0.22,"young",43,185,88,"m"
10,"VERTICAL TRACTION",2,"Rep05",2440,2440,2450,2450,2440,2450,0.004,-10,2445,"Rep",0,0,FALSE,FALSE,FALSE,0.41,"young",43,185,88,"m"
10,"VERTICAL TRACTION",2,"Rep06",2360,2360,2350,2400,2360,2375,0.006,-15,2367.5,"Rep",0,-50,FALSE,FALSE,FALSE,0.63,"young",43,185,88,"m"
10,"VERTICAL TRACTION",2,"Rep07",2340,2340,2350,2350,2340,2350,0.004,-10,2345,"Rep",0,0,FALSE,FALSE,FALSE,0.43,"young",43,185,88,"m"
10,"VERTICAL TRACTION",2,"Rep08",2380,2360,2400,2400,2370,2400,0.013,-30,2385,"Rep",20,0,FALSE,FALSE,FALSE,1.25,"young",43,185,88,"m"
10,"VERTICAL TRACTION",2,"Rep09",2420,2460,2300,2250,2440,2275,0.068,165,2357.5,"Rep",-40,50,TRUE,FALSE,FALSE,7.25,"young",43,185,88,"m"
10,"VERTICAL TRACTION",2,"Rep10",2580,2520,2800,2800,2550,2800,0.098,-250,2675,"Rep",60,0,TRUE,FALSE,FALSE,8.93,"young",43,185,88,"m"
10,"VERTICAL TRACTION",1,"TuT",23520,23540,26000,26250,23530,26125,0.11,-2595,24827.5,"TuT",-20,-250,TRUE,FALSE,FALSE,9.93,"young",43,185,88,"m"
10,"VERTICAL TRACTION",2,"TuT",24740,24700,25350,28150,24720,26750,0.082,-2030,25735,"TuT",40,-2800,FALSE,FALSE,TRUE,7.59,"young",43,185,88,"m"
10,"CHEST PRESS",1,"Con01",1100,1100,1450,1150,1100,1300,0.182,-200,1200,"Con",0,300,FALSE,FALSE,FALSE,15.38,"young",43,185,88,"m"
10,"CHEST PRESS",1,"Con02",700,700,800,750,700,775,0.107,-75,737.5,"Con",0,50,FALSE,FALSE,FALSE,9.68,"young",43,185,88,"m"
10,"CHEST PRESS",1,"Con03",740,720,850,750,730,800,0.096,-70,765,"Con",20,100,FALSE,FALSE,FALSE,8.75,"young",43,185,88,"m"
10,"CHEST PRESS",1,"Con04",660,660,750,700,660,725,0.098,-65,692.5,"Con",0,50,FALSE,FALSE,FALSE,8.97,"young",43,185,88,"m"
10,"CHEST PRESS",1,"Con05",720,720,800,800,720,800,0.111,-80,760,"Con",0,0,FALSE,FALSE,FALSE,10,"young",43,185,88,"m"
10,"CHEST PRESS",1,"Con06",740,740,800,850,740,825,0.115,-85,782.5,"Con",0,-50,FALSE,FALSE,FALSE,10.3,"young",43,185,88,"m"
10,"CHEST PRESS",1,"Con07",780,780,900,900,780,900,0.154,-120,840,"Con",0,0,FALSE,FALSE,FALSE,13.33,"young",43,185,88,"m"
10,"CHEST PRESS",1,"Con08",800,800,800,900,800,850,0.062,-50,825,"Con",0,-100,FALSE,FALSE,FALSE,5.88,"young",43,185,88,"m"
10,"CHEST PRESS",1,"Con09",760,760,800,850,760,825,0.086,-65,792.5,"Con",0,-50,FALSE,FALSE,FALSE,7.88,"young",43,185,88,"m"
10,"CHEST PRESS",1,"Con10",720,740,750,850,730,800,0.096,-70,765,"Con",-20,-100,FALSE,FALSE,FALSE,8.75,"young",43,185,88,"m"
10,"CHEST PRESS",2,"Con01",880,860,1400,1500,870,1450,0.667,-580,1160,"Con",20,-100,TRUE,FALSE,FALSE,40,"young",43,185,88,"m"
10,"CHEST PRESS",2,"Con02",660,660,750,750,660,750,0.136,-90,705,"Con",0,0,FALSE,FALSE,FALSE,12,"young",43,185,88,"m"
10,"CHEST PRESS",2,"Con03",680,680,750,750,680,750,0.103,-70,715,"Con",0,0,FALSE,FALSE,FALSE,9.33,"young",43,185,88,"m"
10,"CHEST PRESS",2,"Con04",740,740,850,800,740,825,0.115,-85,782.5,"Con",0,50,FALSE,FALSE,FALSE,10.3,"young",43,185,88,"m"
10,"CHEST PRESS",2,"Con05",740,720,800,750,730,775,0.062,-45,752.5,"Con",20,50,FALSE,FALSE,FALSE,5.81,"young",43,185,88,"m"
10,"CHEST PRESS",2,"Con06",780,780,900,900,780,900,0.154,-120,840,"Con",0,0,FALSE,FALSE,FALSE,13.33,"young",43,185,88,"m"
10,"CHEST PRESS",2,"Con07",740,740,800,800,740,800,0.081,-60,770,"Con",0,0,FALSE,FALSE,FALSE,7.5,"young",43,185,88,"m"
10,"CHEST PRESS",2,"Con08",720,720,750,750,720,750,0.042,-30,735,"Con",0,0,FALSE,FALSE,FALSE,4,"young",43,185,88,"m"
10,"CHEST PRESS",2,"Con09",740,740,700,750,740,725,0.02,15,732.5,"Con",0,-50,FALSE,FALSE,FALSE,2.07,"young",43,185,88,"m"
10,"CHEST PRESS",2,"Con10",780,780,750,800,780,775,0.006,5,777.5,"Con",0,-50,FALSE,FALSE,FALSE,0.65,"young",43,185,88,"m"
10,"CHEST PRESS",1,"Ecc01",1960,1960,1700,1850,1960,1775,0.094,185,1867.5,"Ecc",0,-150,FALSE,FALSE,FALSE,10.42,"young",43,185,88,"m"
10,"CHEST PRESS",1,"Ecc02",1080,1080,950,1050,1080,1000,0.074,80,1040,"Ecc",0,-100,FALSE,FALSE,FALSE,8,"young",43,185,88,"m"
10,"CHEST PRESS",1,"Ecc03",860,880,800,850,870,825,0.052,45,847.5,"Ecc",-20,-50,FALSE,FALSE,FALSE,5.45,"young",43,185,88,"m"
10,"CHEST PRESS",1,"Ecc04",1040,1040,950,950,1040,950,0.087,90,995,"Ecc",0,0,FALSE,FALSE,FALSE,9.47,"young",43,185,88,"m"
10,"CHEST PRESS",1,"Ecc05",1180,1180,1100,1100,1180,1100,0.068,80,1140,"Ecc",0,0,FALSE,FALSE,FALSE,7.27,"young",43,185,88,"m"
10,"CHEST PRESS",1,"Ecc06",1180,1180,1100,1050,1180,1075,0.089,105,1127.5,"Ecc",0,50,FALSE,FALSE,FALSE,9.77,"young",43,185,88,"m"
10,"CHEST PRESS",1,"Ecc07",1060,1060,1000,950,1060,975,0.08,85,1017.5,"Ecc",0,50,FALSE,FALSE,FALSE,8.72,"young",43,185,88,"m"
10,"CHEST PRESS",1,"Ecc08",1120,1120,1100,1050,1120,1075,0.04,45,1097.5,"Ecc",0,50,FALSE,FALSE,FALSE,4.19,"young",43,185,88,"m"
10,"CHEST PRESS",1,"Ecc09",1020,1000,1000,900,1010,950,0.059,60,980,"Ecc",20,100,FALSE,FALSE,FALSE,6.32,"young",43,185,88,"m"
10,"CHEST PRESS",1,"Ecc10",2280,2280,1700,600,2280,1150,0.496,1130,1715,"Ecc",0,1100,TRUE,FALSE,TRUE,98.26,"young",43,185,88,"m"
10,"CHEST PRESS",2,"Ecc01",1200,1200,1050,1050,1200,1050,0.125,150,1125,"Ecc",0,0,FALSE,FALSE,FALSE,14.29,"young",43,185,88,"m"
10,"CHEST PRESS",2,"Ecc02",960,960,900,900,960,900,0.062,60,930,"Ecc",0,0,FALSE,FALSE,FALSE,6.67,"young",43,185,88,"m"
10,"CHEST PRESS",2,"Ecc03",980,980,900,900,980,900,0.082,80,940,"Ecc",0,0,FALSE,FALSE,FALSE,8.89,"young",43,185,88,"m"
10,"CHEST PRESS",2,"Ecc04",900,920,800,850,910,825,0.093,85,867.5,"Ecc",-20,-50,FALSE,FALSE,FALSE,10.3,"young",43,185,88,"m"
10,"CHEST PRESS",2,"Ecc05",1100,1100,1000,1050,1100,1025,0.068,75,1062.5,"Ecc",0,-50,FALSE,FALSE,FALSE,7.32,"young",43,185,88,"m"
10,"CHEST PRESS",2,"Ecc06",1100,1100,1000,1000,1100,1000,0.091,100,1050,"Ecc",0,0,FALSE,FALSE,FALSE,10,"young",43,185,88,"m"
10,"CHEST PRESS",2,"Ecc07",1100,1100,1050,1050,1100,1050,0.045,50,1075,"Ecc",0,0,FALSE,FALSE,FALSE,4.76,"young",43,185,88,"m"
10,"CHEST PRESS",2,"Ecc08",960,960,1000,950,960,975,0.016,-15,967.5,"Ecc",0,50,FALSE,FALSE,FALSE,1.54,"young",43,185,88,"m"
10,"CHEST PRESS",2,"Ecc09",1120,1120,1150,1100,1120,1125,0.004,-5,1122.5,"Ecc",0,50,FALSE,FALSE,FALSE,0.44,"young",43,185,88,"m"
10,"CHEST PRESS",2,"Ecc10",1480,1500,1500,1450,1490,1475,0.01,15,1482.5,"Ecc",-20,50,FALSE,FALSE,FALSE,1.02,"young",43,185,88,"m"
10,"CHEST PRESS",1,"Rep01",3060,3060,3150,3000,3060,3075,0.005,-15,3067.5,"Rep",0,150,FALSE,FALSE,FALSE,0.49,"young",43,185,88,"m"
10,"CHEST PRESS",1,"Rep02",1780,1780,1750,1800,1780,1775,0.003,5,1777.5,"Rep",0,-50,FALSE,FALSE,FALSE,0.28,"young",43,185,88,"m"
10,"CHEST PRESS",1,"Rep03",1600,1600,1650,1600,1600,1625,0.016,-25,1612.5,"Rep",0,50,FALSE,FALSE,FALSE,1.54,"young",43,185,88,"m"
10,"CHEST PRESS",1,"Rep04",1700,1700,1700,1650,1700,1675,0.015,25,1687.5,"Rep",0,50,FALSE,FALSE,FALSE,1.49,"young",43,185,88,"m"
10,"CHEST PRESS",1,"Rep05",1900,1900,1900,1900,1900,1900,0,0,1900,"Rep",0,0,FALSE,FALSE,FALSE,0,"young",43,185,88,"m"
10,"CHEST PRESS",1,"Rep06",1920,1920,1900,1900,1920,1900,0.01,20,1910,"Rep",0,0,FALSE,FALSE,FALSE,1.05,"young",43,185,88,"m"
10,"CHEST PRESS",1,"Rep07",1840,1840,1900,1850,1840,1875,0.019,-35,1857.5,"Rep",0,50,FALSE,FALSE,FALSE,1.87,"young",43,185,88,"m"
10,"CHEST PRESS",1,"Rep08",1920,1920,1900,1950,1920,1925,0.003,-5,1922.5,"Rep",0,-50,FALSE,FALSE,FALSE,0.26,"young",43,185,88,"m"
10,"CHEST PRESS",1,"Rep09",1780,1760,1800,1750,1770,1775,0.003,-5,1772.5,"Rep",20,50,FALSE,FALSE,FALSE,0.28,"young",43,185,88,"m"
10,"CHEST PRESS",1,"Rep10",3000,3020,2450,1450,3010,1950,0.352,1060,2480,"Rep",-20,1000,TRUE,FALSE,TRUE,54.36,"young",43,185,88,"m"
10,"CHEST PRESS",2,"Rep01",2080,2060,2450,2550,2070,2500,0.208,-430,2285,"Rep",20,-100,TRUE,FALSE,FALSE,17.2,"young",43,185,88,"m"
10,"CHEST PRESS",2,"Rep02",1620,1620,1650,1650,1620,1650,0.019,-30,1635,"Rep",0,0,FALSE,FALSE,FALSE,1.82,"young",43,185,88,"m"
10,"CHEST PRESS",2,"Rep03",1660,1660,1650,1650,1660,1650,0.006,10,1655,"Rep",0,0,FALSE,FALSE,FALSE,0.61,"young",43,185,88,"m"
10,"CHEST PRESS",2,"Rep04",1640,1660,1650,1650,1650,1650,0,0,1650,"Rep",-20,0,FALSE,FALSE,FALSE,0,"young",43,185,88,"m"
10,"CHEST PRESS",2,"Rep05",1840,1820,1800,1800,1830,1800,0.016,30,1815,"Rep",20,0,FALSE,FALSE,FALSE,1.67,"young",43,185,88,"m"
10,"CHEST PRESS",2,"Rep06",1880,1880,1900,1900,1880,1900,0.011,-20,1890,"Rep",0,0,FALSE,FALSE,FALSE,1.05,"young",43,185,88,"m"
10,"CHEST PRESS",2,"Rep07",1840,1840,1850,1850,1840,1850,0.005,-10,1845,"Rep",0,0,FALSE,FALSE,FALSE,0.54,"young",43,185,88,"m"
10,"CHEST PRESS",2,"Rep08",1680,1680,1750,1700,1680,1725,0.027,-45,1702.5,"Rep",0,50,FALSE,FALSE,FALSE,2.61,"young",43,185,88,"m"
10,"CHEST PRESS",2,"Rep09",1860,1860,1850,1850,1860,1850,0.005,10,1855,"Rep",0,0,FALSE,FALSE,FALSE,0.54,"young",43,185,88,"m"
10,"CHEST PRESS",2,"Rep10",2260,2280,2250,2250,2270,2250,0.009,20,2260,"Rep",-20,0,FALSE,FALSE,FALSE,0.89,"young",43,185,88,"m"
10,"CHEST PRESS",1,"TuT",20500,20500,20100,18850,20500,19475,0.05,1025,19987.5,"TuT",0,1250,FALSE,FALSE,TRUE,5.26,"young",43,185,88,"m"
10,"CHEST PRESS",2,"TuT",18360,18360,18800,18850,18360,18825,0.025,-465,18592.5,"TuT",0,-50,FALSE,FALSE,FALSE,2.47,"young",43,185,88,"m"
11,"LEG PRESS",1,"Con01",1360,1360,1450,1500,1360,1475,0.085,-115,1417.5,"Con",0,-50,FALSE,FALSE,FALSE,7.8,"young",51,186,80,"m"
11,"LEG PRESS",1,"Con02",1100,1100,1300,1200,1100,1250,0.136,-150,1175,"Con",0,100,FALSE,FALSE,FALSE,12,"young",51,186,80,"m"
11,"LEG PRESS",1,"Con03",1200,1200,1350,1250,1200,1300,0.083,-100,1250,"Con",0,100,FALSE,FALSE,FALSE,7.69,"young",51,186,80,"m"
11,"LEG PRESS",1,"Con04",1200,1160,1300,1300,1180,1300,0.102,-120,1240,"Con",40,0,FALSE,FALSE,FALSE,9.23,"young",51,186,80,"m"
11,"LEG PRESS",1,"Con05",1260,1240,1350,1400,1250,1375,0.1,-125,1312.5,"Con",20,-50,FALSE,FALSE,FALSE,9.09,"young",51,186,80,"m"
11,"LEG PRESS",1,"Con06",1280,1240,1400,1400,1260,1400,0.111,-140,1330,"Con",40,0,FALSE,FALSE,FALSE,10,"young",51,186,80,"m"
11,"LEG PRESS",1,"Con07",1200,1180,1450,1400,1190,1425,0.197,-235,1307.5,"Con",20,50,FALSE,FALSE,FALSE,16.49,"young",51,186,80,"m"
11,"LEG PRESS",1,"Con08",1240,1220,1800,1800,1230,1800,0.463,-570,1515,"Con",20,0,TRUE,FALSE,FALSE,31.67,"young",51,186,80,"m"
11,"LEG PRESS",1,"Con09",1180,1180,1450,2000,1180,1725,0.462,-545,1452.5,"Con",0,-550,TRUE,FALSE,TRUE,31.59,"young",51,186,80,"m"
11,"LEG PRESS",1,"Con10",1140,1140,1450,2100,1140,1775,0.557,-635,1457.5,"Con",0,-650,TRUE,FALSE,TRUE,35.77,"young",51,186,80,"m"
11,"LEG PRESS",2,"Con01",1100,1100,1300,1350,1100,1325,0.205,-225,1212.5,"Con",0,-50,FALSE,FALSE,FALSE,16.98,"young",51,186,80,"m"
11,"LEG PRESS",2,"Con02",1000,980,1150,1100,990,1125,0.136,-135,1057.5,"Con",20,50,FALSE,FALSE,FALSE,12,"young",51,186,80,"m"
11,"LEG PRESS",2,"Con03",980,980,1150,1050,980,1100,0.122,-120,1040,"Con",0,100,FALSE,FALSE,FALSE,10.91,"young",51,186,80,"m"
11,"LEG PRESS",2,"Con04",1040,1040,1200,1150,1040,1175,0.13,-135,1107.5,"Con",0,50,FALSE,FALSE,FALSE,11.49,"young",51,186,80,"m"
11,"LEG PRESS",2,"Con05",1100,1080,1300,1850,1090,1575,0.445,-485,1332.5,"Con",20,-550,TRUE,FALSE,TRUE,30.79,"young",51,186,80,"m"
11,"LEG PRESS",2,"Con06",1200,1200,1400,1450,1200,1425,0.188,-225,1312.5,"Con",0,-50,FALSE,FALSE,FALSE,15.79,"young",51,186,80,"m"
11,"LEG PRESS",2,"Con07",1100,1100,1250,2000,1100,1625,0.477,-525,1362.5,"Con",0,-750,TRUE,FALSE,TRUE,32.31,"young",51,186,80,"m"
11,"LEG PRESS",2,"Con08",1100,1060,1300,1350,1080,1325,0.227,-245,1202.5,"Con",40,-50,FALSE,FALSE,FALSE,18.49,"young",51,186,80,"m"
11,"LEG PRESS",2,"Con09",1060,1100,1350,1350,1080,1350,0.25,-270,1215,"Con",-40,0,FALSE,FALSE,FALSE,20,"young",51,186,80,"m"
11,"LEG PRESS",2,"Con10",1240,1280,2300,2300,1260,2300,0.825,-1040,1780,"Con",-40,0,TRUE,FALSE,FALSE,45.22,"young",51,186,80,"m"
11,"LEG PRESS",1,"Ecc01",2240,2240,2150,2150,2240,2150,0.04,90,2195,"Ecc",0,0,FALSE,FALSE,FALSE,4.19,"young",51,186,80,"m"
11,"LEG PRESS",1,"Ecc02",2020,2020,1850,2000,2020,1925,0.047,95,1972.5,"Ecc",0,-150,FALSE,FALSE,FALSE,4.94,"young",51,186,80,"m"
11,"LEG PRESS",1,"Ecc03",2280,2300,2150,2200,2290,2175,0.05,115,2232.5,"Ecc",-20,-50,FALSE,FALSE,FALSE,5.29,"young",51,186,80,"m"
11,"LEG PRESS",1,"Ecc04",2340,2380,2250,2200,2360,2225,0.057,135,2292.5,"Ecc",-40,50,FALSE,FALSE,FALSE,6.07,"young",51,186,80,"m"
11,"LEG PRESS",1,"Ecc05",2160,2200,2100,2050,2180,2075,0.048,105,2127.5,"Ecc",-40,50,FALSE,FALSE,FALSE,5.06,"young",51,186,80,"m"
11,"LEG PRESS",1,"Ecc06",2400,2420,2150,2250,2410,2200,0.087,210,2305,"Ecc",-20,-100,FALSE,FALSE,FALSE,9.55,"young",51,186,80,"m"
11,"LEG PRESS",1,"Ecc07",2200,2200,1950,1950,2200,1950,0.114,250,2075,"Ecc",0,0,FALSE,FALSE,FALSE,12.82,"young",51,186,80,"m"
11,"LEG PRESS",1,"Ecc08",2100,2120,1550,1550,2110,1550,0.265,560,1830,"Ecc",-20,0,TRUE,FALSE,FALSE,36.13,"young",51,186,80,"m"
11,"LEG PRESS",1,"Ecc09",2280,2280,2000,1450,2280,1725,0.243,555,2002.5,"Ecc",0,550,TRUE,FALSE,TRUE,32.17,"young",51,186,80,"m"
11,"LEG PRESS",1,"Ecc10",2960,2960,2750,1950,2960,2350,0.206,610,2655,"Ecc",0,800,TRUE,FALSE,TRUE,25.96,"young",51,186,80,"m"
11,"LEG PRESS",2,"Ecc01",2300,2300,2150,2200,2300,2175,0.054,125,2237.5,"Ecc",0,-50,FALSE,FALSE,FALSE,5.75,"young",51,186,80,"m"
11,"LEG PRESS",2,"Ecc02",2360,2380,2200,2300,2370,2250,0.051,120,2310,"Ecc",-20,-100,FALSE,FALSE,FALSE,5.33,"young",51,186,80,"m"
11,"LEG PRESS",2,"Ecc03",2260,2260,2100,2150,2260,2125,0.06,135,2192.5,"Ecc",0,-50,FALSE,FALSE,FALSE,6.35,"young",51,186,80,"m"
11,"LEG PRESS",2,"Ecc04",2260,2280,2100,2100,2270,2100,0.075,170,2185,"Ecc",-20,0,FALSE,FALSE,FALSE,8.1,"young",51,186,80,"m"
11,"LEG PRESS",2,"Ecc05",2160,2160,1950,1450,2160,1700,0.213,460,1930,"Ecc",0,500,TRUE,FALSE,TRUE,27.06,"young",51,186,80,"m"
11,"LEG PRESS",2,"Ecc06",2240,2240,2050,1950,2240,2000,0.107,240,2120,"Ecc",0,100,FALSE,FALSE,FALSE,12,"young",51,186,80,"m"
11,"LEG PRESS",2,"Ecc07",2260,2280,2100,1350,2270,1725,0.24,545,1997.5,"Ecc",-20,750,TRUE,FALSE,TRUE,31.59,"young",51,186,80,"m"
11,"LEG PRESS",2,"Ecc08",2340,2340,2150,2100,2340,2125,0.092,215,2232.5,"Ecc",0,50,FALSE,FALSE,FALSE,10.12,"young",51,186,80,"m"
11,"LEG PRESS",2,"Ecc09",2360,2300,2050,2050,2330,2050,0.12,280,2190,"Ecc",60,0,FALSE,FALSE,FALSE,13.66,"young",51,186,80,"m"
11,"LEG PRESS",2,"Ecc10",2900,2900,1950,1950,2900,1950,0.328,950,2425,"Ecc",0,0,TRUE,FALSE,FALSE,48.72,"young",51,186,80,"m"
11,"LEG PRESS",1,"Rep01",3600,3600,3600,3650,3600,3625,0.007,-25,3612.5,"Rep",0,-50,FALSE,FALSE,FALSE,0.69,"young",51,186,80,"m"
11,"LEG PRESS",1,"Rep02",3120,3120,3150,3200,3120,3175,0.018,-55,3147.5,"Rep",0,-50,FALSE,FALSE,FALSE,1.73,"young",51,186,80,"m"
11,"LEG PRESS",1,"Rep03",3480,3500,3500,3450,3490,3475,0.004,15,3482.5,"Rep",-20,50,FALSE,FALSE,FALSE,0.43,"young",51,186,80,"m"
11,"LEG PRESS",1,"Rep04",3540,3540,3550,3500,3540,3525,0.004,15,3532.5,"Rep",0,50,FALSE,FALSE,FALSE,0.43,"young",51,186,80,"m"
11,"LEG PRESS",1,"Rep05",3420,3440,3450,3450,3430,3450,0.006,-20,3440,"Rep",-20,0,FALSE,FALSE,FALSE,0.58,"young",51,186,80,"m"
11,"LEG PRESS",1,"Rep06",3680,3660,3550,3650,3670,3600,0.019,70,3635,"Rep",20,-100,FALSE,FALSE,TRUE,1.94,"young",51,186,80,"m"
11,"LEG PRESS",1,"Rep07",3400,3380,3400,3350,3390,3375,0.004,15,3382.5,"Rep",20,50,FALSE,FALSE,FALSE,0.44,"young",51,186,80,"m"
11,"LEG PRESS",1,"Rep08",3340,3340,3350,3350,3340,3350,0.003,-10,3345,"Rep",0,0,FALSE,FALSE,FALSE,0.3,"young",51,186,80,"m"
11,"LEG PRESS",1,"Rep09",3460,3460,3450,3450,3460,3450,0.003,10,3455,"Rep",0,0,FALSE,FALSE,FALSE,0.29,"young",51,186,80,"m"
11,"LEG PRESS",1,"Rep10",4100,4100,4200,4050,4100,4125,0.006,-25,4112.5,"Rep",0,150,FALSE,FALSE,TRUE,0.61,"young",51,186,80,"m"
11,"LEG PRESS",2,"Rep01",3400,3400,3450,3550,3400,3500,0.029,-100,3450,"Rep",0,-100,FALSE,FALSE,TRUE,2.86,"young",51,186,80,"m"
11,"LEG PRESS",2,"Rep02",3360,3360,3350,3400,3360,3375,0.004,-15,3367.5,"Rep",0,-50,FALSE,FALSE,FALSE,0.44,"young",51,186,80,"m"
11,"LEG PRESS",2,"Rep03",3240,3240,3250,3200,3240,3225,0.005,15,3232.5,"Rep",0,50,FALSE,FALSE,FALSE,0.47,"young",51,186,80,"m"
11,"LEG PRESS",2,"Rep04",3300,3320,3300,3250,3310,3275,0.011,35,3292.5,"Rep",-20,50,FALSE,FALSE,FALSE,1.07,"young",51,186,80,"m"
11,"LEG PRESS",2,"Rep05",3260,3240,3250,3300,3250,3275,0.008,-25,3262.5,"Rep",20,-50,FALSE,FALSE,FALSE,0.76,"young",51,186,80,"m"
11,"LEG PRESS",2,"Rep06",3440,3440,3450,3400,3440,3425,0.004,15,3432.5,"Rep",0,50,FALSE,FALSE,FALSE,0.44,"young",51,186,80,"m"
11,"LEG PRESS",2,"Rep07",3360,3380,3350,3350,3370,3350,0.006,20,3360,"Rep",-20,0,FALSE,FALSE,FALSE,0.6,"young",51,186,80,"m"
11,"LEG PRESS",2,"Rep08",3440,3400,3450,3450,3420,3450,0.009,-30,3435,"Rep",40,0,FALSE,FALSE,FALSE,0.87,"young",51,186,80,"m"
11,"LEG PRESS",2,"Rep09",3420,3400,3400,3400,3410,3400,0.003,10,3405,"Rep",20,0,FALSE,FALSE,FALSE,0.29,"young",51,186,80,"m"
11,"LEG PRESS",2,"Rep10",4140,4180,4250,4250,4160,4250,0.022,-90,4205,"Rep",-40,0,FALSE,FALSE,FALSE,2.12,"young",51,186,80,"m"
11,"LEG PRESS",1,"TuT",35140,35140,35200,35100,35140,35150,0,-10,35145,"TuT",0,100,FALSE,FALSE,FALSE,0.03,"young",51,186,80,"m"
11,"LEG PRESS",2,"TuT",34360,34360,34500,34550,34360,34525,0.005,-165,34442.5,"TuT",0,-50,FALSE,FALSE,FALSE,0.48,"young",51,186,80,"m"
11,"LEG EXTENSION",1,"Con01",1060,1060,1100,1100,1060,1100,0.038,-40,1080,"Con",0,0,FALSE,FALSE,FALSE,3.64,"young",51,186,80,"m"
11,"LEG EXTENSION",1,"Con02",1080,1100,1050,1000,1090,1025,0.06,65,1057.5,"Con",-20,50,FALSE,FALSE,FALSE,6.34,"young",51,186,80,"m"
11,"LEG EXTENSION",1,"Con03",1080,1080,1100,1050,1080,1075,0.005,5,1077.5,"Con",0,50,FALSE,FALSE,FALSE,0.47,"young",51,186,80,"m"
11,"LEG EXTENSION",1,"Con04",1220,1240,1200,1150,1230,1175,0.045,55,1202.5,"Con",-20,50,FALSE,FALSE,FALSE,4.68,"young",51,186,80,"m"
11,"LEG EXTENSION",1,"Con05",880,880,950,950,880,950,0.08,-70,915,"Con",0,0,FALSE,FALSE,FALSE,7.37,"young",51,186,80,"m"
11,"LEG EXTENSION",1,"Con06",940,960,950,1000,950,975,0.026,-25,962.5,"Con",-20,-50,FALSE,FALSE,FALSE,2.56,"young",51,186,80,"m"
11,"LEG EXTENSION",1,"Con07",1000,980,1100,1100,990,1100,0.111,-110,1045,"Con",20,0,FALSE,FALSE,FALSE,10,"young",51,186,80,"m"
11,"LEG EXTENSION",1,"Con08",920,920,1050,1000,920,1025,0.114,-105,972.5,"Con",0,50,FALSE,FALSE,FALSE,10.24,"young",51,186,80,"m"
11,"LEG EXTENSION",1,"Con09",1100,1100,1150,1100,1100,1125,0.023,-25,1112.5,"Con",0,50,FALSE,FALSE,FALSE,2.22,"young",51,186,80,"m"
11,"LEG EXTENSION",1,"Con10",1300,1280,1450,1400,1290,1425,0.105,-135,1357.5,"Con",20,50,FALSE,FALSE,FALSE,9.47,"young",51,186,80,"m"
11,"LEG EXTENSION",2,"Con01",1040,1040,1200,1150,1040,1175,0.13,-135,1107.5,"Con",0,50,FALSE,FALSE,FALSE,11.49,"young",51,186,80,"m"
11,"LEG EXTENSION",2,"Con02",980,940,1000,1000,960,1000,0.042,-40,980,"Con",40,0,FALSE,TRUE,FALSE,4,"young",51,186,80,"m"
11,"LEG EXTENSION",2,"Con03",1040,1060,1100,1100,1050,1100,0.048,-50,1075,"Con",-20,0,FALSE,FALSE,FALSE,4.55,"young",51,186,80,"m"
11,"LEG EXTENSION",2,"Con04",1040,1040,1050,1000,1040,1025,0.014,15,1032.5,"Con",0,50,FALSE,FALSE,FALSE,1.46,"young",51,186,80,"m"
11,"LEG EXTENSION",2,"Con05",1100,1100,1050,1100,1100,1075,0.023,25,1087.5,"Con",0,-50,FALSE,FALSE,FALSE,2.33,"young",51,186,80,"m"
11,"LEG EXTENSION",2,"Con06",1080,1080,1100,1050,1080,1075,0.005,5,1077.5,"Con",0,50,FALSE,FALSE,FALSE,0.47,"young",51,186,80,"m"
11,"LEG EXTENSION",2,"Con07",1080,1040,1000,1000,1060,1000,0.057,60,1030,"Con",40,0,FALSE,TRUE,FALSE,6,"young",51,186,80,"m"
11,"LEG EXTENSION",2,"Con08",1060,1100,1100,1100,1080,1100,0.019,-20,1090,"Con",-40,0,FALSE,TRUE,FALSE,1.82,"young",51,186,80,"m"
11,"LEG EXTENSION",2,"Con09",1100,1060,1250,1200,1080,1225,0.134,-145,1152.5,"Con",40,50,FALSE,TRUE,FALSE,11.84,"young",51,186,80,"m"
11,"LEG EXTENSION",2,"Con10",1120,1140,1450,1400,1130,1425,0.261,-295,1277.5,"Con",-20,50,TRUE,FALSE,FALSE,20.7,"young",51,186,80,"m"
11,"LEG EXTENSION",1,"Ecc01",1120,1120,1200,1250,1120,1225,0.094,-105,1172.5,"Ecc",0,-50,FALSE,FALSE,FALSE,8.57,"young",51,186,80,"m"
11,"LEG EXTENSION",1,"Ecc02",1440,1420,1400,1450,1430,1425,0.003,5,1427.5,"Ecc",20,-50,FALSE,FALSE,FALSE,0.35,"young",51,186,80,"m"
11,"LEG EXTENSION",1,"Ecc03",1220,1220,1250,1300,1220,1275,0.045,-55,1247.5,"Ecc",0,-50,FALSE,FALSE,FALSE,4.31,"young",51,186,80,"m"
11,"LEG EXTENSION",1,"Ecc04",1320,1300,1250,1250,1310,1250,0.046,60,1280,"Ecc",20,0,FALSE,FALSE,FALSE,4.8,"young",51,186,80,"m"
11,"LEG EXTENSION",1,"Ecc05",1280,1280,1250,1250,1280,1250,0.023,30,1265,"Ecc",0,0,FALSE,FALSE,FALSE,2.4,"young",51,186,80,"m"
11,"LEG EXTENSION",1,"Ecc06",1260,1260,1200,1150,1260,1175,0.067,85,1217.5,"Ecc",0,50,FALSE,FALSE,FALSE,7.23,"young",51,186,80,"m"
11,"LEG EXTENSION",1,"Ecc07",1580,1580,1450,1500,1580,1475,0.066,105,1527.5,"Ecc",0,-50,FALSE,FALSE,FALSE,7.12,"young",51,186,80,"m"
11,"LEG EXTENSION",1,"Ecc08",1220,1220,1150,1200,1220,1175,0.037,45,1197.5,"Ecc",0,-50,FALSE,FALSE,FALSE,3.83,"young",51,186,80,"m"
11,"LEG EXTENSION",1,"Ecc09",1260,1280,1150,1200,1270,1175,0.075,95,1222.5,"Ecc",-20,-50,FALSE,FALSE,FALSE,8.09,"young",51,186,80,"m"
11,"LEG EXTENSION",1,"Ecc10",1820,1800,1800,1800,1810,1800,0.006,10,1805,"Ecc",20,0,FALSE,FALSE,FALSE,0.56,"young",51,186,80,"m"
11,"LEG EXTENSION",2,"Ecc01",1620,1640,1550,1600,1630,1575,0.034,55,1602.5,"Ecc",-20,-50,FALSE,FALSE,FALSE,3.49,"young",51,186,80,"m"
11,"LEG EXTENSION",2,"Ecc02",1360,1360,1350,1300,1360,1325,0.026,35,1342.5,"Ecc",0,50,FALSE,FALSE,FALSE,2.64,"young",51,186,80,"m"
11,"LEG EXTENSION",2,"Ecc03",1280,1280,1250,1300,1280,1275,0.004,5,1277.5,"Ecc",0,-50,FALSE,FALSE,FALSE,0.39,"young",51,186,80,"m"
11,"LEG EXTENSION",2,"Ecc04",1220,1200,1250,1250,1210,1250,0.033,-40,1230,"Ecc",20,0,FALSE,FALSE,FALSE,3.2,"young",51,186,80,"m"
11,"LEG EXTENSION",2,"Ecc05",1400,1420,1400,1400,1410,1400,0.007,10,1405,"Ecc",-20,0,FALSE,FALSE,FALSE,0.71,"young",51,186,80,"m"
11,"LEG EXTENSION",2,"Ecc06",1180,1200,1250,1250,1190,1250,0.05,-60,1220,"Ecc",-20,0,FALSE,FALSE,FALSE,4.8,"young",51,186,80,"m"
11,"LEG EXTENSION",2,"Ecc07",1420,1400,1400,1400,1410,1400,0.007,10,1405,"Ecc",20,0,FALSE,FALSE,FALSE,0.71,"young",51,186,80,"m"
11,"LEG EXTENSION",2,"Ecc08",1300,1320,1150,1200,1310,1175,0.103,135,1242.5,"Ecc",-20,-50,FALSE,FALSE,FALSE,11.49,"young",51,186,80,"m"
11,"LEG EXTENSION",2,"Ecc09",1340,1340,1050,1100,1340,1075,0.198,265,1207.5,"Ecc",0,-50,TRUE,FALSE,FALSE,24.65,"young",51,186,80,"m"
11,"LEG EXTENSION",2,"Ecc10",1560,1540,550,1550,1550,1050,0.323,500,1300,"Ecc",20,-1000,TRUE,FALSE,TRUE,47.62,"young",51,186,80,"m"
11,"LEG EXTENSION",1,"Rep01",2180,2180,2300,2350,2180,2325,0.067,-145,2252.5,"Rep",0,-50,TRUE,FALSE,FALSE,6.24,"young",51,186,80,"m"
11,"LEG EXTENSION",1,"Rep02",2520,2520,2450,2450,2520,2450,0.028,70,2485,"Rep",0,0,FALSE,FALSE,FALSE,2.86,"young",51,186,80,"m"
11,"LEG EXTENSION",1,"Rep03",2300,2300,2350,2350,2300,2350,0.022,-50,2325,"Rep",0,0,FALSE,FALSE,FALSE,2.13,"young",51,186,80,"m"
11,"LEG EXTENSION",1,"Rep04",2540,2540,2450,2400,2540,2425,0.045,115,2482.5,"Rep",0,50,TRUE,FALSE,FALSE,4.74,"young",51,186,80,"m"
11,"LEG EXTENSION",1,"Rep05",2160,2160,2200,2200,2160,2200,0.019,-40,2180,"Rep",0,0,FALSE,FALSE,FALSE,1.82,"young",51,186,80,"m"
11,"LEG EXTENSION",1,"Rep06",2200,2220,2150,2150,2210,2150,0.027,60,2180,"Rep",-20,0,FALSE,FALSE,FALSE,2.79,"young",51,186,80,"m"
11,"LEG EXTENSION",1,"Rep07",2580,2560,2550,2600,2570,2575,0.002,-5,2572.5,"Rep",20,-50,FALSE,FALSE,FALSE,0.19,"young",51,186,80,"m"
11,"LEG EXTENSION",1,"Rep08",2140,2140,2200,2200,2140,2200,0.028,-60,2170,"Rep",0,0,FALSE,FALSE,FALSE,2.73,"young",51,186,80,"m"
11,"LEG EXTENSION",1,"Rep09",2360,2380,2300,2300,2370,2300,0.03,70,2335,"Rep",-20,0,FALSE,FALSE,FALSE,3.04,"young",51,186,80,"m"
11,"LEG EXTENSION",1,"Rep10",3120,3080,3250,3200,3100,3225,0.04,-125,3162.5,"Rep",40,50,TRUE,FALSE,FALSE,3.88,"young",51,186,80,"m"
11,"LEG EXTENSION",2,"Rep01",2660,2680,2750,2750,2670,2750,0.03,-80,2710,"Rep",-20,0,FALSE,FALSE,FALSE,2.91,"young",51,186,80,"m"
11,"LEG EXTENSION",2,"Rep02",2340,2300,2350,2300,2320,2325,0.002,-5,2322.5,"Rep",40,50,FALSE,FALSE,FALSE,0.22,"young",51,186,80,"m"
11,"LEG EXTENSION",2,"Rep03",2320,2340,2350,2400,2330,2375,0.019,-45,2352.5,"Rep",-20,-50,FALSE,FALSE,FALSE,1.89,"young",51,186,80,"m"
11,"LEG EXTENSION",2,"Rep04",2260,2240,2300,2250,2250,2275,0.011,-25,2262.5,"Rep",20,50,FALSE,FALSE,FALSE,1.1,"young",51,186,80,"m"
11,"LEG EXTENSION",2,"Rep05",2500,2520,2450,2500,2510,2475,0.014,35,2492.5,"Rep",-20,-50,FALSE,FALSE,FALSE,1.41,"young",51,186,80,"m"
11,"LEG EXTENSION",2,"Rep06",2260,2280,2350,2300,2270,2325,0.024,-55,2297.5,"Rep",-20,50,FALSE,FALSE,FALSE,2.37,"young",51,186,80,"m"
11,"LEG EXTENSION",2,"Rep07",2500,2440,2400,2400,2470,2400,0.028,70,2435,"Rep",60,0,FALSE,FALSE,FALSE,2.92,"young",51,186,80,"m"
11,"LEG EXTENSION",2,"Rep08",2360,2420,2250,2300,2390,2275,0.048,115,2332.5,"Rep",-60,-50,TRUE,FALSE,FALSE,5.05,"young",51,186,80,"m"
11,"LEG EXTENSION",2,"Rep09",2440,2400,2300,2300,2420,2300,0.05,120,2360,"Rep",40,0,TRUE,FALSE,FALSE,5.22,"young",51,186,80,"m"
11,"LEG EXTENSION",2,"Rep10",2680,2680,2000,2950,2680,2475,0.076,205,2577.5,"Rep",0,-950,TRUE,FALSE,TRUE,8.28,"young",51,186,80,"m"
11,"LEG EXTENSION",1,"TuT",24100,24080,24200,24200,24090,24200,0.005,-110,24145,"TuT",20,0,FALSE,FALSE,FALSE,0.45,"young",51,186,80,"m"
11,"LEG EXTENSION",2,"TuT",24320,24300,23500,24450,24310,23975,0.014,335,24142.5,"TuT",20,-950,TRUE,FALSE,TRUE,1.4,"young",51,186,80,"m"
11,"LEG CURL",1,"Con01",1360,1320,1400,1500,1340,1450,0.082,-110,1395,"Con",40,-100,FALSE,FALSE,FALSE,7.59,"young",51,186,80,"m"
11,"LEG CURL",1,"Con02",1240,1240,1250,1250,1240,1250,0.008,-10,1245,"Con",0,0,FALSE,FALSE,FALSE,0.8,"young",51,186,80,"m"
11,"LEG CURL",1,"Con03",1320,1280,1300,1250,1300,1275,0.019,25,1287.5,"Con",40,50,FALSE,FALSE,FALSE,1.96,"young",51,186,80,"m"
11,"LEG CURL",1,"Con04",1140,1140,1200,1150,1140,1175,0.031,-35,1157.5,"Con",0,50,FALSE,FALSE,FALSE,2.98,"young",51,186,80,"m"
11,"LEG CURL",1,"Con05",1160,1160,1150,1150,1160,1150,0.009,10,1155,"Con",0,0,FALSE,FALSE,FALSE,0.87,"young",51,186,80,"m"
11,"LEG CURL",1,"Con06",1080,1080,1150,1100,1080,1125,0.042,-45,1102.5,"Con",0,50,FALSE,FALSE,FALSE,4,"young",51,186,80,"m"
11,"LEG CURL",1,"Con07",1220,1220,1300,1300,1220,1300,0.066,-80,1260,"Con",0,0,FALSE,FALSE,FALSE,6.15,"young",51,186,80,"m"
11,"LEG CURL",1,"Con08",1340,1360,1450,1550,1350,1500,0.111,-150,1425,"Con",-20,-100,FALSE,FALSE,FALSE,10,"young",51,186,80,"m"
11,"LEG CURL",1,"Con09",1180,1200,1400,1550,1190,1475,0.239,-285,1332.5,"Con",-20,-150,TRUE,FALSE,FALSE,19.32,"young",51,186,80,"m"
11,"LEG CURL",1,"Con10",1240,1240,1550,1950,1240,1750,0.411,-510,1495,"Con",0,-400,TRUE,FALSE,TRUE,29.14,"young",51,186,80,"m"
11,"LEG CURL",2,"Con01",1280,1260,1350,1400,1270,1375,0.083,-105,1322.5,"Con",20,-50,FALSE,FALSE,FALSE,7.64,"young",51,186,80,"m"
11,"LEG CURL",2,"Con02",1160,1140,1150,1150,1150,1150,0,0,1150,"Con",20,0,FALSE,FALSE,FALSE,0,"young",51,186,80,"m"
11,"LEG CURL",2,"Con03",1300,1300,1200,1200,1300,1200,0.077,100,1250,"Con",0,0,FALSE,FALSE,FALSE,8.33,"young",51,186,80,"m"
11,"LEG CURL",2,"Con04",1100,1080,1100,1100,1090,1100,0.009,-10,1095,"Con",20,0,FALSE,FALSE,FALSE,0.91,"young",51,186,80,"m"
11,"LEG CURL",2,"Con05",1280,1240,1300,1350,1260,1325,0.052,-65,1292.5,"Con",40,-50,FALSE,FALSE,FALSE,4.91,"young",51,186,80,"m"
11,"LEG CURL",2,"Con06",1120,1140,1200,1200,1130,1200,0.062,-70,1165,"Con",-20,0,FALSE,FALSE,FALSE,5.83,"young",51,186,80,"m"
11,"LEG CURL",2,"Con07",1160,1140,1250,1200,1150,1225,0.065,-75,1187.5,"Con",20,50,FALSE,FALSE,FALSE,6.12,"young",51,186,80,"m"
11,"LEG CURL",2,"Con08",1300,1280,1350,1350,1290,1350,0.047,-60,1320,"Con",20,0,FALSE,FALSE,FALSE,4.44,"young",51,186,80,"m"
11,"LEG CURL",2,"Con09",1000,960,1200,1150,980,1175,0.199,-195,1077.5,"Con",40,50,FALSE,FALSE,FALSE,16.6,"young",51,186,80,"m"
11,"LEG CURL",2,"Con10",1180,1200,1350,1300,1190,1325,0.113,-135,1257.5,"Con",-20,50,FALSE,FALSE,FALSE,10.19,"young",51,186,80,"m"
11,"LEG CURL",1,"Ecc01",2340,2340,2350,2300,2340,2325,0.006,15,2332.5,"Ecc",0,50,FALSE,FALSE,FALSE,0.65,"young",51,186,80,"m"
11,"LEG CURL",1,"Ecc02",2320,2340,2300,2350,2330,2325,0.002,5,2327.5,"Ecc",-20,-50,FALSE,FALSE,FALSE,0.22,"young",51,186,80,"m"
11,"LEG CURL",1,"Ecc03",2280,2300,2250,2300,2290,2275,0.007,15,2282.5,"Ecc",-20,-50,FALSE,FALSE,FALSE,0.66,"young",51,186,80,"m"
11,"LEG CURL",1,"Ecc04",2260,2260,2250,2250,2260,2250,0.004,10,2255,"Ecc",0,0,FALSE,FALSE,FALSE,0.44,"young",51,186,80,"m"
11,"LEG CURL",1,"Ecc05",2140,2140,2100,2150,2140,2125,0.007,15,2132.5,"Ecc",0,-50,FALSE,FALSE,FALSE,0.71,"young",51,186,80,"m"
11,"LEG CURL",1,"Ecc06",2620,2620,2550,2550,2620,2550,0.027,70,2585,"Ecc",0,0,FALSE,FALSE,FALSE,2.75,"young",51,186,80,"m"
11,"LEG CURL",1,"Ecc07",2280,2260,2150,2100,2270,2125,0.064,145,2197.5,"Ecc",20,50,FALSE,FALSE,FALSE,6.82,"young",51,186,80,"m"
11,"LEG CURL",1,"Ecc08",2380,2360,2150,2000,2370,2075,0.124,295,2222.5,"Ecc",20,150,TRUE,FALSE,FALSE,14.22,"young",51,186,80,"m"
11,"LEG CURL",1,"Ecc09",2280,2280,2050,1650,2280,1850,0.189,430,2065,"Ecc",0,400,TRUE,FALSE,TRUE,23.24,"young",51,186,80,"m"
11,"LEG CURL",1,"Ecc10",2180,2180,2150,2100,2180,2125,0.025,55,2152.5,"Ecc",0,50,FALSE,FALSE,FALSE,2.59,"young",51,186,80,"m"
11,"LEG CURL",2,"Ecc01",2160,2200,2200,2150,2180,2175,0.002,5,2177.5,"Ecc",-40,50,FALSE,FALSE,FALSE,0.23,"young",51,186,80,"m"
11,"LEG CURL",2,"Ecc02",2400,2400,2500,2550,2400,2525,0.052,-125,2462.5,"Ecc",0,-50,FALSE,FALSE,FALSE,4.95,"young",51,186,80,"m"
11,"LEG CURL",2,"Ecc03",1940,1960,1950,1900,1950,1925,0.013,25,1937.5,"Ecc",-20,50,FALSE,FALSE,FALSE,1.3,"young",51,186,80,"m"
11,"LEG CURL",2,"Ecc04",2060,2100,2050,2050,2080,2050,0.014,30,2065,"Ecc",-40,0,FALSE,FALSE,FALSE,1.46,"young",51,186,80,"m"
11,"LEG CURL",2,"Ecc05",2640,2620,2550,2550,2630,2550,0.03,80,2590,"Ecc",20,0,FALSE,FALSE,FALSE,3.14,"young",51,186,80,"m"
11,"LEG CURL",2,"Ecc06",2000,2020,1950,1950,2010,1950,0.03,60,1980,"Ecc",-20,0,FALSE,FALSE,FALSE,3.08,"young",51,186,80,"m"
11,"LEG CURL",2,"Ecc07",1920,1940,1850,1900,1930,1875,0.028,55,1902.5,"Ecc",-20,-50,FALSE,FALSE,FALSE,2.93,"young",51,186,80,"m"
11,"LEG CURL",2,"Ecc08",2400,2440,2200,2200,2420,2200,0.091,220,2310,"Ecc",-40,0,FALSE,FALSE,FALSE,10,"young",51,186,80,"m"
11,"LEG CURL",2,"Ecc09",1700,1660,1550,1600,1680,1575,0.062,105,1627.5,"Ecc",40,-50,FALSE,FALSE,FALSE,6.67,"young",51,186,80,"m"
11,"LEG CURL",2,"Ecc10",3400,3420,3400,3400,3410,3400,0.003,10,3405,"Ecc",-20,0,FALSE,FALSE,FALSE,0.29,"young",51,186,80,"m"
11,"LEG CURL",1,"Rep01",3700,3660,3750,3800,3680,3775,0.026,-95,3727.5,"Rep",40,-50,FALSE,FALSE,FALSE,2.52,"young",51,186,80,"m"
11,"LEG CURL",1,"Rep02",3560,3580,3550,3600,3570,3575,0.001,-5,3572.5,"Rep",-20,-50,FALSE,FALSE,FALSE,0.14,"young",51,186,80,"m"
11,"LEG CURL",1,"Rep03",3600,3580,3550,3550,3590,3550,0.011,40,3570,"Rep",20,0,FALSE,FALSE,FALSE,1.13,"young",51,186,80,"m"
11,"LEG CURL",1,"Rep04",3400,3400,3450,3400,3400,3425,0.007,-25,3412.5,"Rep",0,50,FALSE,FALSE,FALSE,0.73,"young",51,186,80,"m"
11,"LEG CURL",1,"Rep05",3300,3300,3250,3300,3300,3275,0.008,25,3287.5,"Rep",0,-50,FALSE,FALSE,FALSE,0.76,"young",51,186,80,"m"
11,"LEG CURL",1,"Rep06",3700,3700,3700,3650,3700,3675,0.007,25,3687.5,"Rep",0,50,FALSE,FALSE,FALSE,0.68,"young",51,186,80,"m"
11,"LEG CURL",1,"Rep07",3500,3480,3450,3400,3490,3425,0.019,65,3457.5,"Rep",20,50,FALSE,FALSE,FALSE,1.9,"young",51,186,80,"m"
11,"LEG CURL",1,"Rep08",3720,3720,3600,3550,3720,3575,0.039,145,3647.5,"Rep",0,50,FALSE,FALSE,FALSE,4.06,"young",51,186,80,"m"
11,"LEG CURL",1,"Rep09",3460,3480,3450,3200,3470,3325,0.042,145,3397.5,"Rep",-20,250,FALSE,FALSE,TRUE,4.36,"young",51,186,80,"m"
11,"LEG CURL",1,"Rep10",3420,3420,3700,4050,3420,3875,0.133,-455,3647.5,"Rep",0,-350,TRUE,FALSE,TRUE,11.74,"young",51,186,80,"m"
11,"LEG CURL",2,"Rep01",3440,3460,3550,3550,3450,3550,0.029,-100,3500,"Rep",-20,0,FALSE,FALSE,FALSE,2.82,"young",51,186,80,"m"
11,"LEG CURL",2,"Rep02",3560,3540,3650,3700,3550,3675,0.035,-125,3612.5,"Rep",20,-50,FALSE,FALSE,FALSE,3.4,"young",51,186,80,"m"
11,"LEG CURL",2,"Rep03",3240,3260,3150,3100,3250,3125,0.038,125,3187.5,"Rep",-20,50,FALSE,FALSE,FALSE,4,"young",51,186,80,"m"
11,"LEG CURL",2,"Rep04",3160,3180,3150,3150,3170,3150,0.006,20,3160,"Rep",-20,0,FALSE,FALSE,FALSE,0.63,"young",51,186,80,"m"
11,"LEG CURL",2,"Rep05",3920,3860,3850,3900,3890,3875,0.004,15,3882.5,"Rep",60,-50,FALSE,FALSE,FALSE,0.39,"young",51,186,80,"m"
11,"LEG CURL",2,"Rep06",3120,3160,3150,3150,3140,3150,0.003,-10,3145,"Rep",-40,0,FALSE,FALSE,FALSE,0.32,"young",51,186,80,"m"
11,"LEG CURL",2,"Rep07",3080,3080,3100,3100,3080,3100,0.006,-20,3090,"Rep",0,0,FALSE,FALSE,FALSE,0.65,"young",51,186,80,"m"
11,"LEG CURL",2,"Rep08",3700,3720,3550,3550,3710,3550,0.043,160,3630,"Rep",-20,0,TRUE,FALSE,FALSE,4.51,"young",51,186,80,"m"
11,"LEG CURL",2,"Rep09",2700,2620,2750,2750,2660,2750,0.034,-90,2705,"Rep",80,0,FALSE,TRUE,FALSE,3.27,"young",51,186,80,"m"
11,"LEG CURL",2,"Rep10",4580,4620,4750,4700,4600,4725,0.027,-125,4662.5,"Rep",-40,50,FALSE,FALSE,FALSE,2.65,"young",51,186,80,"m"
11,"LEG CURL",1,"TuT",35360,35320,35450,35500,35340,35475,0.004,-135,35407.5,"TuT",40,-50,FALSE,TRUE,FALSE,0.38,"young",51,186,80,"m"
11,"LEG CURL",2,"TuT",34500,34500,34650,34650,34500,34650,0.004,-150,34575,"TuT",0,0,FALSE,FALSE,FALSE,0.43,"young",51,186,80,"m"
11,"ABDUCTOR",1,"Con01",980,980,1250,1100,980,1175,0.199,-195,1077.5,"Con",0,150,FALSE,FALSE,FALSE,16.6,"young",51,186,80,"m"
11,"ABDUCTOR",1,"Con02",800,820,950,1000,810,975,0.204,-165,892.5,"Con",-20,-50,FALSE,FALSE,FALSE,16.92,"young",51,186,80,"m"
11,"ABDUCTOR",1,"Con03",1060,1060,1050,1250,1060,1150,0.085,-90,1105,"Con",0,-200,FALSE,FALSE,FALSE,7.83,"young",51,186,80,"m"
11,"ABDUCTOR",1,"Con04",960,940,950,950,950,950,0,0,950,"Con",20,0,FALSE,FALSE,FALSE,0,"young",51,186,80,"m"
11,"ABDUCTOR",1,"Con05",1060,1100,1000,1050,1080,1025,0.051,55,1052.5,"Con",-40,-50,FALSE,TRUE,FALSE,5.37,"young",51,186,80,"m"
11,"ABDUCTOR",1,"Con06",820,860,1400,1100,840,1250,0.488,-410,1045,"Con",-40,300,TRUE,TRUE,TRUE,32.8,"young",51,186,80,"m"
11,"ABDUCTOR",1,"Con07",960,920,900,900,940,900,0.043,40,920,"Con",40,0,FALSE,TRUE,FALSE,4.44,"young",51,186,80,"m"
11,"ABDUCTOR",1,"Con08",700,700,850,850,700,850,0.214,-150,775,"Con",0,0,FALSE,FALSE,FALSE,17.65,"young",51,186,80,"m"
11,"ABDUCTOR",1,"Con09",700,700,950,850,700,900,0.286,-200,800,"Con",0,100,FALSE,FALSE,FALSE,22.22,"young",51,186,80,"m"
11,"ABDUCTOR",1,"Con10",780,800,1000,900,790,950,0.203,-160,870,"Con",-20,100,FALSE,FALSE,FALSE,16.84,"young",51,186,80,"m"
11,"ABDUCTOR",2,"Con01",880,880,850,950,880,900,0.023,-20,890,"Con",0,-100,FALSE,FALSE,FALSE,2.22,"young",51,186,80,"m"
11,"ABDUCTOR",2,"Con02",720,740,1100,900,730,1000,0.37,-270,865,"Con",-20,200,FALSE,FALSE,FALSE,27,"young",51,186,80,"m"
11,"ABDUCTOR",2,"Con03",1020,1020,1350,850,1020,1100,0.078,-80,1060,"Con",0,500,FALSE,FALSE,TRUE,7.27,"young",51,186,80,"m"
11,"ABDUCTOR",2,"Con04",760,760,1250,800,760,1025,0.349,-265,892.5,"Con",0,450,FALSE,FALSE,TRUE,25.85,"young",51,186,80,"m"
11,"ABDUCTOR",2,"Con05",700,720,1050,850,710,950,0.338,-240,830,"Con",-20,200,FALSE,FALSE,FALSE,25.26,"young",51,186,80,"m"
11,"ABDUCTOR",2,"Con06",760,760,900,900,760,900,0.184,-140,830,"Con",0,0,FALSE,FALSE,FALSE,15.56,"young",51,186,80,"m"
11,"ABDUCTOR",2,"Con07",720,740,800,850,730,825,0.13,-95,777.5,"Con",-20,-50,FALSE,FALSE,FALSE,11.52,"young",51,186,80,"m"
11,"ABDUCTOR",2,"Con08",740,740,850,1000,740,925,0.25,-185,832.5,"Con",0,-150,FALSE,FALSE,FALSE,20,"young",51,186,80,"m"
11,"ABDUCTOR",2,"Con09",760,760,850,1250,760,1050,0.382,-290,905,"Con",0,-400,FALSE,FALSE,TRUE,27.62,"young",51,186,80,"m"
11,"ABDUCTOR",2,"Con10",800,820,950,1400,810,1175,0.451,-365,992.5,"Con",-20,-450,TRUE,FALSE,TRUE,31.06,"young",51,186,80,"m"
11,"ABDUCTOR",1,"Ecc01",1940,1920,1750,1700,1930,1725,0.106,205,1827.5,"Ecc",20,50,FALSE,FALSE,FALSE,11.88,"young",51,186,80,"m"
11,"ABDUCTOR",1,"Ecc02",1800,1800,1850,1600,1800,1725,0.042,75,1762.5,"Ecc",0,250,FALSE,FALSE,FALSE,4.35,"young",51,186,80,"m"
11,"ABDUCTOR",1,"Ecc03",2060,2080,2000,2000,2070,2000,0.034,70,2035,"Ecc",-20,0,FALSE,FALSE,FALSE,3.5,"young",51,186,80,"m"
11,"ABDUCTOR",1,"Ecc04",2040,2000,2150,2100,2020,2125,0.052,-105,2072.5,"Ecc",40,50,FALSE,TRUE,FALSE,4.94,"young",51,186,80,"m"
11,"ABDUCTOR",1,"Ecc05",2260,2240,1700,2000,2250,1850,0.178,400,2050,"Ecc",20,-300,TRUE,FALSE,FALSE,21.62,"young",51,186,80,"m"
11,"ABDUCTOR",1,"Ecc06",1840,1840,1850,1850,1840,1850,0.005,-10,1845,"Ecc",0,0,FALSE,FALSE,FALSE,0.54,"young",51,186,80,"m"
11,"ABDUCTOR",1,"Ecc07",1820,1840,1650,1650,1830,1650,0.098,180,1740,"Ecc",-20,0,FALSE,FALSE,FALSE,10.91,"young",51,186,80,"m"
11,"ABDUCTOR",1,"Ecc08",1800,1800,1600,1650,1800,1625,0.097,175,1712.5,"Ecc",0,-50,FALSE,FALSE,FALSE,10.77,"young",51,186,80,"m"
11,"ABDUCTOR",1,"Ecc09",1880,1860,1650,1750,1870,1700,0.091,170,1785,"Ecc",20,-100,FALSE,FALSE,FALSE,10,"young",51,186,80,"m"
11,"ABDUCTOR",1,"Ecc10",1760,1740,1750,1800,1750,1775,0.014,-25,1762.5,"Ecc",20,-50,FALSE,FALSE,FALSE,1.41,"young",51,186,80,"m"
11,"ABDUCTOR",2,"Ecc01",2160,2140,1850,1950,2150,1900,0.116,250,2025,"Ecc",20,-100,FALSE,FALSE,FALSE,13.16,"young",51,186,80,"m"
11,"ABDUCTOR",2,"Ecc02",1680,1680,1400,1850,1680,1625,0.033,55,1652.5,"Ecc",0,-450,FALSE,FALSE,TRUE,3.38,"young",51,186,80,"m"
11,"ABDUCTOR",2,"Ecc03",1740,1740,1200,1700,1740,1450,0.167,290,1595,"Ecc",0,-500,FALSE,FALSE,TRUE,20,"young",51,186,80,"m"
11,"ABDUCTOR",2,"Ecc04",1980,1960,1650,1850,1970,1750,0.112,220,1860,"Ecc",20,-200,FALSE,FALSE,FALSE,12.57,"young",51,186,80,"m"
11,"ABDUCTOR",2,"Ecc05",2000,2000,1850,1850,2000,1850,0.075,150,1925,"Ecc",0,0,FALSE,FALSE,FALSE,8.11,"young",51,186,80,"m"
11,"ABDUCTOR",2,"Ecc06",2040,2020,1900,1900,2030,1900,0.064,130,1965,"Ecc",20,0,FALSE,FALSE,FALSE,6.84,"young",51,186,80,"m"
11,"ABDUCTOR",2,"Ecc07",1820,1820,1700,1600,1820,1650,0.093,170,1735,"Ecc",0,100,FALSE,FALSE,FALSE,10.3,"young",51,186,80,"m"
11,"ABDUCTOR",2,"Ecc08",1920,1920,1850,1450,1920,1650,0.141,270,1785,"Ecc",0,400,FALSE,FALSE,TRUE,16.36,"young",51,186,80,"m"
11,"ABDUCTOR",2,"Ecc09",2020,2000,1900,1400,2010,1650,0.179,360,1830,"Ecc",20,500,TRUE,FALSE,TRUE,21.82,"young",51,186,80,"m"
11,"ABDUCTOR",2,"Ecc10",1480,1480,1500,1450,1480,1475,0.003,5,1477.5,"Ecc",0,50,FALSE,FALSE,FALSE,0.34,"young",51,186,80,"m"
11,"ABDUCTOR",1,"Rep01",2920,2900,3000,2800,2910,2900,0.003,10,2905,"Rep",20,200,FALSE,FALSE,FALSE,0.34,"young",51,186,80,"m"
11,"ABDUCTOR",1,"Rep02",2600,2620,2800,2600,2610,2700,0.034,-90,2655,"Rep",-20,200,FALSE,FALSE,FALSE,3.33,"young",51,186,80,"m"
11,"ABDUCTOR",1,"Rep03",3120,3140,3050,3250,3130,3150,0.006,-20,3140,"Rep",-20,-200,FALSE,FALSE,FALSE,0.63,"young",51,186,80,"m"
11,"ABDUCTOR",1,"Rep04",3000,2940,3100,3050,2970,3075,0.035,-105,3022.5,"Rep",60,50,FALSE,FALSE,FALSE,3.41,"young",51,186,80,"m"
11,"ABDUCTOR",1,"Rep05",3320,3340,2700,3050,3330,2875,0.137,455,3102.5,"Rep",-20,-350,TRUE,FALSE,TRUE,15.83,"young",51,186,80,"m"
11,"ABDUCTOR",1,"Rep06",2660,2700,3250,2950,2680,3100,0.157,-420,2890,"Rep",-40,300,TRUE,FALSE,FALSE,13.55,"young",51,186,80,"m"
11,"ABDUCTOR",1,"Rep07",2780,2760,2550,2550,2770,2550,0.079,220,2660,"Rep",20,0,FALSE,FALSE,FALSE,8.63,"young",51,186,80,"m"
11,"ABDUCTOR",1,"Rep08",2500,2500,2450,2500,2500,2475,0.01,25,2487.5,"Rep",0,-50,FALSE,FALSE,FALSE,1.01,"young",51,186,80,"m"
11,"ABDUCTOR",1,"Rep09",2580,2560,2600,2600,2570,2600,0.012,-30,2585,"Rep",20,0,FALSE,FALSE,FALSE,1.15,"young",51,186,80,"m"
11,"ABDUCTOR",1,"Rep10",2540,2540,2750,2700,2540,2725,0.073,-185,2632.5,"Rep",0,50,FALSE,FALSE,FALSE,6.79,"young",51,186,80,"m"
11,"ABDUCTOR",2,"Rep01",3040,3020,2700,2900,3030,2800,0.076,230,2915,"Rep",20,-200,FALSE,FALSE,FALSE,8.21,"young",51,186,80,"m"
11,"ABDUCTOR",2,"Rep02",2400,2420,2500,2750,2410,2625,0.089,-215,2517.5,"Rep",-20,-250,FALSE,FALSE,FALSE,8.19,"young",51,186,80,"m"
11,"ABDUCTOR",2,"Rep03",2760,2760,2550,2550,2760,2550,0.076,210,2655,"Rep",0,0,FALSE,FALSE,FALSE,8.24,"young",51,186,80,"m"
11,"ABDUCTOR",2,"Rep04",2740,2720,2900,2650,2730,2775,0.016,-45,2752.5,"Rep",20,250,FALSE,FALSE,FALSE,1.62,"young",51,186,80,"m"
11,"ABDUCTOR",2,"Rep05",2700,2720,2900,2700,2710,2800,0.033,-90,2755,"Rep",-20,200,FALSE,FALSE,FALSE,3.21,"young",51,186,80,"m"
11,"ABDUCTOR",2,"Rep06",2800,2780,2800,2800,2790,2800,0.004,-10,2795,"Rep",20,0,FALSE,FALSE,FALSE,0.36,"young",51,186,80,"m"
11,"ABDUCTOR",2,"Rep07",2540,2560,2500,2450,2550,2475,0.029,75,2512.5,"Rep",-20,50,FALSE,FALSE,FALSE,3.03,"young",51,186,80,"m"
11,"ABDUCTOR",2,"Rep08",2660,2660,2700,2450,2660,2575,0.032,85,2617.5,"Rep",0,250,FALSE,FALSE,FALSE,3.3,"young",51,186,80,"m"
11,"ABDUCTOR",2,"Rep09",2780,2760,2750,2650,2770,2700,0.025,70,2735,"Rep",20,100,FALSE,FALSE,FALSE,2.59,"young",51,186,80,"m"
11,"ABDUCTOR",2,"Rep10",2280,2300,2450,2850,2290,2650,0.157,-360,2470,"Rep",-20,-400,TRUE,FALSE,TRUE,13.58,"young",51,186,80,"m"
11,"ABDUCTOR",1,"TuT",28020,28000,28250,28050,28010,28150,0.005,-140,28080,"TuT",20,200,FALSE,FALSE,FALSE,0.5,"young",51,186,80,"m"
11,"ABDUCTOR",2,"TuT",26700,26700,26750,26750,26700,26750,0.002,-50,26725,"TuT",0,0,FALSE,FALSE,FALSE,0.19,"young",51,186,80,"m"
11,"ADDUCTOR",1,"Con01",900,900,1100,1250,900,1175,0.306,-275,1037.5,"Con",0,-150,FALSE,FALSE,FALSE,23.4,"young",51,186,80,"m"
11,"ADDUCTOR",1,"Con02",780,760,1350,1050,770,1200,0.558,-430,985,"Con",20,300,FALSE,FALSE,FALSE,35.83,"young",51,186,80,"m"
11,"ADDUCTOR",1,"Con03",1140,1140,1650,1050,1140,1350,0.184,-210,1245,"Con",0,600,FALSE,FALSE,TRUE,15.56,"young",51,186,80,"m"
11,"ADDUCTOR",1,"Con04",880,900,1850,1150,890,1500,0.685,-610,1195,"Con",-20,700,TRUE,FALSE,TRUE,40.67,"young",51,186,80,"m"
11,"ADDUCTOR",1,"Con05",920,920,1850,1100,920,1475,0.603,-555,1197.5,"Con",0,750,FALSE,FALSE,TRUE,37.63,"young",51,186,80,"m"
11,"ADDUCTOR",1,"Con06",1160,1180,1750,1650,1170,1700,0.453,-530,1435,"Con",-20,100,FALSE,FALSE,FALSE,31.18,"young",51,186,80,"m"
11,"ADDUCTOR",1,"Con07",920,980,1100,1100,950,1100,0.158,-150,1025,"Con",-60,0,FALSE,TRUE,FALSE,13.64,"young",51,186,80,"m"
11,"ADDUCTOR",1,"Con08",900,900,950,1700,900,1325,0.472,-425,1112.5,"Con",0,-750,FALSE,FALSE,TRUE,32.08,"young",51,186,80,"m"
11,"ADDUCTOR",1,"Con09",820,820,900,1100,820,1000,0.22,-180,910,"Con",0,-200,FALSE,FALSE,FALSE,18,"young",51,186,80,"m"
11,"ADDUCTOR",1,"Con10",1040,1060,850,1400,1050,1125,0.071,-75,1087.5,"Con",-20,-550,FALSE,FALSE,TRUE,6.67,"young",51,186,80,"m"
11,"ADDUCTOR",2,"Con01",960,960,1700,1500,960,1600,0.667,-640,1280,"Con",0,200,TRUE,FALSE,FALSE,40,"young",51,186,80,"m"
11,"ADDUCTOR",2,"Con02",920,900,1150,1150,910,1150,0.264,-240,1030,"Con",20,0,FALSE,FALSE,FALSE,20.87,"young",51,186,80,"m"
11,"ADDUCTOR",2,"Con03",1260,1280,1000,1050,1270,1025,0.193,245,1147.5,"Con",-20,-50,FALSE,FALSE,FALSE,23.9,"young",51,186,80,"m"
11,"ADDUCTOR",2,"Con04",900,940,1000,1000,920,1000,0.087,-80,960,"Con",-40,0,FALSE,TRUE,FALSE,8,"young",51,186,80,"m"
11,"ADDUCTOR",2,"Con05",800,820,850,950,810,900,0.111,-90,855,"Con",-20,-100,FALSE,FALSE,FALSE,10,"young",51,186,80,"m"
11,"ADDUCTOR",2,"Con06",900,900,1500,1400,900,1450,0.611,-550,1175,"Con",0,100,FALSE,FALSE,FALSE,37.93,"young",51,186,80,"m"
11,"ADDUCTOR",2,"Con07",880,900,1750,1500,890,1625,0.826,-735,1257.5,"Con",-20,250,TRUE,FALSE,FALSE,45.23,"young",51,186,80,"m"
11,"ADDUCTOR",2,"Con08",780,760,1300,1450,770,1375,0.786,-605,1072.5,"Con",20,-150,TRUE,FALSE,FALSE,44,"young",51,186,80,"m"
11,"ADDUCTOR",2,"Con09",680,680,900,1050,680,975,0.434,-295,827.5,"Con",0,-150,FALSE,FALSE,FALSE,30.26,"young",51,186,80,"m"
11,"ADDUCTOR",2,"Con10",780,780,850,1250,780,1050,0.346,-270,915,"Con",0,-400,FALSE,FALSE,TRUE,25.71,"young",51,186,80,"m"
11,"ADDUCTOR",1,"Ecc01",1660,1660,1400,1400,1660,1400,0.157,260,1530,"Ecc",0,0,FALSE,FALSE,FALSE,18.57,"young",51,186,80,"m"
11,"ADDUCTOR",1,"Ecc02",1620,1620,1150,1450,1620,1300,0.198,320,1460,"Ecc",0,-300,FALSE,FALSE,FALSE,24.62,"young",51,186,80,"m"
11,"ADDUCTOR",1,"Ecc03",1820,1820,1150,1800,1820,1475,0.19,345,1647.5,"Ecc",0,-650,FALSE,FALSE,TRUE,23.39,"young",51,186,80,"m"
11,"ADDUCTOR",1,"Ecc04",2120,2120,1200,1900,2120,1550,0.269,570,1835,"Ecc",0,-700,TRUE,FALSE,TRUE,36.77,"young",51,186,80,"m"
11,"ADDUCTOR",1,"Ecc05",1920,1920,1150,1850,1920,1500,0.219,420,1710,"Ecc",0,-700,FALSE,FALSE,TRUE,28,"young",51,186,80,"m"
11,"ADDUCTOR",1,"Ecc06",2280,2220,1600,1700,2250,1650,0.267,600,1950,"Ecc",60,-100,TRUE,TRUE,FALSE,36.36,"young",51,186,80,"m"
11,"ADDUCTOR",1,"Ecc07",2580,2560,2500,2400,2570,2450,0.047,120,2510,"Ecc",20,100,FALSE,FALSE,FALSE,4.9,"young",51,186,80,"m"
11,"ADDUCTOR",1,"Ecc08",2160,2160,2100,1300,2160,1700,0.213,460,1930,"Ecc",0,800,FALSE,FALSE,TRUE,27.06,"young",51,186,80,"m"
11,"ADDUCTOR",1,"Ecc09",2340,2340,2250,2050,2340,2150,0.081,190,2245,"Ecc",0,200,FALSE,FALSE,FALSE,8.84,"young",51,186,80,"m"
11,"ADDUCTOR",1,"Ecc10",1640,1620,1850,1400,1630,1625,0.003,5,1627.5,"Ecc",20,450,FALSE,FALSE,TRUE,0.31,"young",51,186,80,"m"
11,"ADDUCTOR",2,"Ecc01",1560,1580,950,1100,1570,1025,0.347,545,1297.5,"Ecc",-20,-150,FALSE,FALSE,FALSE,53.17,"young",51,186,80,"m"
11,"ADDUCTOR",2,"Ecc02",1620,1600,1750,1750,1610,1750,0.087,-140,1680,"Ecc",20,0,FALSE,FALSE,FALSE,8,"young",51,186,80,"m"
11,"ADDUCTOR",2,"Ecc03",1840,1800,1800,1750,1820,1775,0.025,45,1797.5,"Ecc",40,50,FALSE,TRUE,FALSE,2.54,"young",51,186,80,"m"
11,"ADDUCTOR",2,"Ecc04",2040,2020,1950,1900,2030,1925,0.052,105,1977.5,"Ecc",20,50,FALSE,FALSE,FALSE,5.45,"young",51,186,80,"m"
11,"ADDUCTOR",2,"Ecc05",2060,2060,1900,1850,2060,1875,0.09,185,1967.5,"Ecc",0,50,FALSE,FALSE,FALSE,9.87,"young",51,186,80,"m"
11,"ADDUCTOR",2,"Ecc06",1900,1900,1150,1350,1900,1250,0.342,650,1575,"Ecc",0,-200,TRUE,FALSE,FALSE,52,"young",51,186,80,"m"
11,"ADDUCTOR",2,"Ecc07",2300,2300,1350,1600,2300,1475,0.359,825,1887.5,"Ecc",0,-250,TRUE,FALSE,FALSE,55.93,"young",51,186,80,"m"
11,"ADDUCTOR",2,"Ecc08",2160,2160,1800,1450,2160,1625,0.248,535,1892.5,"Ecc",0,350,FALSE,FALSE,TRUE,32.92,"young",51,186,80,"m"
11,"ADDUCTOR",2,"Ecc09",2120,2120,2100,1950,2120,2025,0.045,95,2072.5,"Ecc",0,150,FALSE,FALSE,FALSE,4.69,"young",51,186,80,"m"
11,"ADDUCTOR",2,"Ecc10",1680,1660,1600,1300,1670,1450,0.132,220,1560,"Ecc",20,300,FALSE,FALSE,FALSE,15.17,"young",51,186,80,"m"
11,"ADDUCTOR",1,"Rep01",2560,2560,2500,2650,2560,2575,0.006,-15,2567.5,"Rep",0,-150,FALSE,FALSE,FALSE,0.58,"young",51,186,80,"m"
11,"ADDUCTOR",1,"Rep02",2400,2380,2500,2500,2390,2500,0.046,-110,2445,"Rep",20,0,FALSE,FALSE,FALSE,4.4,"young",51,186,80,"m"
11,"ADDUCTOR",1,"Rep03",2960,2960,2800,2850,2960,2825,0.046,135,2892.5,"Rep",0,-50,FALSE,FALSE,FALSE,4.78,"young",51,186,80,"m"
11,"ADDUCTOR",1,"Rep04",3000,3020,3050,3050,3010,3050,0.013,-40,3030,"Rep",-20,0,FALSE,FALSE,FALSE,1.31,"young",51,186,80,"m"
11,"ADDUCTOR",1,"Rep05",2840,2840,3000,2950,2840,2975,0.048,-135,2907.5,"Rep",0,50,FALSE,FALSE,FALSE,4.54,"young",51,186,80,"m"
11,"ADDUCTOR",1,"Rep06",3440,3400,3350,3350,3420,3350,0.02,70,3385,"Rep",40,0,FALSE,FALSE,FALSE,2.09,"young",51,186,80,"m"
11,"ADDUCTOR",1,"Rep07",3500,3540,3600,3500,3520,3550,0.009,-30,3535,"Rep",-40,100,FALSE,FALSE,FALSE,0.85,"young",51,186,80,"m"
11,"ADDUCTOR",1,"Rep08",3060,3060,3050,3000,3060,3025,0.011,35,3042.5,"Rep",0,50,FALSE,FALSE,FALSE,1.16,"young",51,186,80,"m"
11,"ADDUCTOR",1,"Rep09",3160,3160,3150,3150,3160,3150,0.003,10,3155,"Rep",0,0,FALSE,FALSE,FALSE,0.32,"young",51,186,80,"m"
11,"ADDUCTOR",1,"Rep10",2680,2680,2700,2800,2680,2750,0.026,-70,2715,"Rep",0,-100,FALSE,FALSE,FALSE,2.55,"young",51,186,80,"m"
11,"ADDUCTOR",2,"Rep01",2520,2540,2650,2600,2530,2625,0.038,-95,2577.5,"Rep",-20,50,FALSE,FALSE,FALSE,3.62,"young",51,186,80,"m"
11,"ADDUCTOR",2,"Rep02",2540,2500,2900,2900,2520,2900,0.151,-380,2710,"Rep",40,0,TRUE,FALSE,FALSE,13.1,"young",51,186,80,"m"
11,"ADDUCTOR",2,"Rep03",3100,3080,2800,2800,3090,2800,0.094,290,2945,"Rep",20,0,FALSE,FALSE,FALSE,10.36,"young",51,186,80,"m"
11,"ADDUCTOR",2,"Rep04",2940,2960,2950,2900,2950,2925,0.008,25,2937.5,"Rep",-20,50,FALSE,FALSE,FALSE,0.85,"young",51,186,80,"m"
11,"ADDUCTOR",2,"Rep05",2860,2880,2750,2800,2870,2775,0.033,95,2822.5,"Rep",-20,-50,FALSE,FALSE,FALSE,3.42,"young",51,186,80,"m"
11,"ADDUCTOR",2,"Rep06",2800,2800,2650,2750,2800,2700,0.036,100,2750,"Rep",0,-100,FALSE,FALSE,FALSE,3.7,"young",51,186,80,"m"
11,"ADDUCTOR",2,"Rep07",3180,3200,3100,3100,3190,3100,0.028,90,3145,"Rep",-20,0,FALSE,FALSE,FALSE,2.9,"young",51,186,80,"m"
11,"ADDUCTOR",2,"Rep08",2940,2920,3100,2900,2930,3000,0.024,-70,2965,"Rep",20,200,FALSE,FALSE,FALSE,2.33,"young",51,186,80,"m"
11,"ADDUCTOR",2,"Rep09",2800,2800,3000,3000,2800,3000,0.071,-200,2900,"Rep",0,0,FALSE,FALSE,FALSE,6.67,"young",51,186,80,"m"
11,"ADDUCTOR",2,"Rep10",2460,2440,2450,2550,2450,2500,0.02,-50,2475,"Rep",20,-100,FALSE,FALSE,FALSE,2,"young",51,186,80,"m"
11,"ADDUCTOR",1,"TuT",29600,29600,29700,29800,29600,29750,0.005,-150,29675,"TuT",0,-100,FALSE,FALSE,FALSE,0.5,"young",51,186,80,"m"
11,"ADDUCTOR",2,"TuT",28140,28120,28350,28300,28130,28325,0.007,-195,28227.5,"TuT",20,50,FALSE,FALSE,FALSE,0.69,"young",51,186,80,"m"
11,"LOWER BACK",1,"Con01",1120,1120,1300,1250,1120,1275,0.138,-155,1197.5,"Con",0,50,FALSE,FALSE,FALSE,12.16,"young",51,186,80,"m"
11,"LOWER BACK",1,"Con02",1320,1320,1400,1300,1320,1350,0.023,-30,1335,"Con",0,100,FALSE,FALSE,FALSE,2.22,"young",51,186,80,"m"
11,"LOWER BACK",1,"Con03",1300,1320,1350,1300,1310,1325,0.011,-15,1317.5,"Con",-20,50,FALSE,FALSE,FALSE,1.13,"young",51,186,80,"m"
11,"LOWER BACK",1,"Con04",1320,1320,1300,1350,1320,1325,0.004,-5,1322.5,"Con",0,-50,FALSE,FALSE,FALSE,0.38,"young",51,186,80,"m"
11,"LOWER BACK",1,"Con05",1340,1280,1250,1450,1310,1350,0.031,-40,1330,"Con",60,-200,FALSE,TRUE,TRUE,2.96,"young",51,186,80,"m"
11,"LOWER BACK",1,"Con06",1260,1240,1350,1350,1250,1350,0.08,-100,1300,"Con",20,0,FALSE,FALSE,FALSE,7.41,"young",51,186,80,"m"
11,"LOWER BACK",1,"Con07",1260,1220,1400,1350,1240,1375,0.109,-135,1307.5,"Con",40,50,FALSE,TRUE,FALSE,9.82,"young",51,186,80,"m"
11,"LOWER BACK",1,"Con08",1500,1440,1650,1550,1470,1600,0.088,-130,1535,"Con",60,100,FALSE,TRUE,FALSE,8.12,"young",51,186,80,"m"
11,"LOWER BACK",1,"Con09",1380,1360,1600,1550,1370,1575,0.15,-205,1472.5,"Con",20,50,TRUE,FALSE,FALSE,13.02,"young",51,186,80,"m"
11,"LOWER BACK",1,"Con10",1360,1320,1450,1500,1340,1475,0.101,-135,1407.5,"Con",40,-50,FALSE,TRUE,FALSE,9.15,"young",51,186,80,"m"
11,"LOWER BACK",2,"Con01",1200,1200,1400,1350,1200,1375,0.146,-175,1287.5,"Con",0,50,FALSE,FALSE,FALSE,12.73,"young",51,186,80,"m"
11,"LOWER BACK",2,"Con02",1340,1340,1300,1350,1340,1325,0.011,15,1332.5,"Con",0,-50,FALSE,FALSE,FALSE,1.13,"young",51,186,80,"m"
11,"LOWER BACK",2,"Con03",1260,1240,1300,1250,1250,1275,0.02,-25,1262.5,"Con",20,50,FALSE,FALSE,FALSE,1.96,"young",51,186,80,"m"
11,"LOWER BACK",2,"Con04",1500,1460,1500,1500,1480,1500,0.014,-20,1490,"Con",40,0,FALSE,TRUE,FALSE,1.33,"young",51,186,80,"m"
11,"LOWER BACK",2,"Con05",1420,1420,1500,1550,1420,1525,0.074,-105,1472.5,"Con",0,-50,FALSE,FALSE,FALSE,6.89,"young",51,186,80,"m"
11,"LOWER BACK",2,"Con06",1320,1280,1300,1450,1300,1375,0.058,-75,1337.5,"Con",40,-150,FALSE,TRUE,FALSE,5.45,"young",51,186,80,"m"
11,"LOWER BACK",2,"Con07",1260,1260,1400,1400,1260,1400,0.111,-140,1330,"Con",0,0,FALSE,FALSE,FALSE,10,"young",51,186,80,"m"
11,"LOWER BACK",2,"Con08",1200,1200,1350,1350,1200,1350,0.125,-150,1275,"Con",0,0,FALSE,FALSE,FALSE,11.11,"young",51,186,80,"m"
11,"LOWER BACK",2,"Con09",1200,1220,1450,1400,1210,1425,0.178,-215,1317.5,"Con",-20,50,TRUE,FALSE,FALSE,15.09,"young",51,186,80,"m"
11,"LOWER BACK",2,"Con10",1280,1280,1500,1400,1280,1450,0.133,-170,1365,"Con",0,100,FALSE,FALSE,FALSE,11.72,"young",51,186,80,"m"
11,"LOWER BACK",1,"Ecc01",2280,2260,2150,2300,2270,2225,0.02,45,2247.5,"Ecc",20,-150,FALSE,FALSE,FALSE,2.02,"young",51,186,80,"m"
11,"LOWER BACK",1,"Ecc02",2080,2100,2050,2050,2090,2050,0.019,40,2070,"Ecc",-20,0,FALSE,FALSE,FALSE,1.95,"young",51,186,80,"m"
11,"LOWER BACK",1,"Ecc03",2220,2200,2200,2250,2210,2225,0.007,-15,2217.5,"Ecc",20,-50,FALSE,FALSE,FALSE,0.67,"young",51,186,80,"m"
11,"LOWER BACK",1,"Ecc04",2000,2060,2100,1900,2030,2000,0.015,30,2015,"Ecc",-60,200,FALSE,FALSE,TRUE,1.5,"young",51,186,80,"m"
11,"LOWER BACK",1,"Ecc05",2260,2280,2200,2100,2270,2150,0.053,120,2210,"Ecc",-20,100,FALSE,FALSE,FALSE,5.58,"young",51,186,80,"m"
11,"LOWER BACK",1,"Ecc06",2100,2120,2000,2050,2110,2025,0.04,85,2067.5,"Ecc",-20,-50,FALSE,FALSE,FALSE,4.2,"young",51,186,80,"m"
11,"LOWER BACK",1,"Ecc07",2320,2380,2200,2300,2350,2250,0.043,100,2300,"Ecc",-60,-100,FALSE,FALSE,FALSE,4.44,"young",51,186,80,"m"
11,"LOWER BACK",1,"Ecc08",2160,2200,1950,2000,2180,1975,0.094,205,2077.5,"Ecc",-40,-50,TRUE,FALSE,FALSE,10.38,"young",51,186,80,"m"
11,"LOWER BACK",1,"Ecc09",2220,2240,2050,2050,2230,2050,0.081,180,2140,"Ecc",-20,0,TRUE,FALSE,FALSE,8.78,"young",51,186,80,"m"
11,"LOWER BACK",1,"Ecc10",2060,2080,2050,2100,2070,2075,0.002,-5,2072.5,"Ecc",-20,-50,FALSE,FALSE,FALSE,0.24,"young",51,186,80,"m"
11,"LOWER BACK",2,"Ecc01",2320,2320,2350,2300,2320,2325,0.002,-5,2322.5,"Ecc",0,50,FALSE,FALSE,FALSE,0.22,"young",51,186,80,"m"
11,"LOWER BACK",2,"Ecc02",2140,2160,2150,2150,2150,2150,0,0,2150,"Ecc",-20,0,FALSE,FALSE,FALSE,0,"young",51,186,80,"m"
11,"LOWER BACK",2,"Ecc03",2180,2220,2150,2150,2200,2150,0.023,50,2175,"Ecc",-40,0,FALSE,FALSE,FALSE,2.33,"young",51,186,80,"m"
11,"LOWER BACK",2,"Ecc04",2240,2260,2200,2150,2250,2175,0.033,75,2212.5,"Ecc",-20,50,FALSE,FALSE,FALSE,3.45,"young",51,186,80,"m"
11,"LOWER BACK",2,"Ecc05",2060,2080,2050,1950,2070,2000,0.034,70,2035,"Ecc",-20,100,FALSE,FALSE,FALSE,3.5,"young",51,186,80,"m"
11,"LOWER BACK",2,"Ecc06",2200,2200,2100,2050,2200,2075,0.057,125,2137.5,"Ecc",0,50,FALSE,FALSE,FALSE,6.02,"young",51,186,80,"m"
11,"LOWER BACK",2,"Ecc07",2080,2100,1950,1950,2090,1950,0.067,140,2020,"Ecc",-20,0,FALSE,FALSE,FALSE,7.18,"young",51,186,80,"m"
11,"LOWER BACK",2,"Ecc08",2200,2160,1950,2000,2180,1975,0.094,205,2077.5,"Ecc",40,-50,TRUE,FALSE,FALSE,10.38,"young",51,186,80,"m"
11,"LOWER BACK",2,"Ecc09",2120,2140,1900,2000,2130,1950,0.085,180,2040,"Ecc",-20,-100,TRUE,FALSE,FALSE,9.23,"young",51,186,80,"m"
11,"LOWER BACK",2,"Ecc10",1960,1960,1900,1900,1960,1900,0.031,60,1930,"Ecc",0,0,FALSE,FALSE,FALSE,3.16,"young",51,186,80,"m"
11,"LOWER BACK",1,"Rep01",3400,3380,3450,3550,3390,3500,0.032,-110,3445,"Rep",20,-100,TRUE,FALSE,FALSE,3.14,"young",51,186,80,"m"
11,"LOWER BACK",1,"Rep02",3400,3420,3450,3350,3410,3400,0.003,10,3405,"Rep",-20,100,FALSE,FALSE,FALSE,0.29,"young",51,186,80,"m"
11,"LOWER BACK",1,"Rep03",3520,3520,3550,3550,3520,3550,0.009,-30,3535,"Rep",0,0,FALSE,FALSE,FALSE,0.85,"young",51,186,80,"m"
11,"LOWER BACK",1,"Rep04",3320,3380,3400,3250,3350,3325,0.007,25,3337.5,"Rep",-60,150,FALSE,FALSE,FALSE,0.75,"young",51,186,80,"m"
11,"LOWER BACK",1,"Rep05",3600,3560,3450,3550,3580,3500,0.022,80,3540,"Rep",40,-100,FALSE,FALSE,FALSE,2.29,"young",51,186,80,"m"
11,"LOWER BACK",1,"Rep06",3360,3360,3350,3400,3360,3375,0.004,-15,3367.5,"Rep",0,-50,FALSE,FALSE,FALSE,0.44,"young",51,186,80,"m"
11,"LOWER BACK",1,"Rep07",3580,3600,3600,3650,3590,3625,0.01,-35,3607.5,"Rep",-20,-50,FALSE,FALSE,FALSE,0.97,"young",51,186,80,"m"
11,"LOWER BACK",1,"Rep08",3660,3640,3600,3550,3650,3575,0.021,75,3612.5,"Rep",20,50,FALSE,FALSE,FALSE,2.1,"young",51,186,80,"m"
11,"LOWER BACK",1,"Rep09",3600,3600,3650,3600,3600,3625,0.007,-25,3612.5,"Rep",0,50,FALSE,FALSE,FALSE,0.69,"young",51,186,80,"m"
11,"LOWER BACK",1,"Rep10",3420,3400,3500,3600,3410,3550,0.041,-140,3480,"Rep",20,-100,TRUE,FALSE,FALSE,3.94,"young",51,186,80,"m"
11,"LOWER BACK",2,"Rep01",3520,3520,3750,3650,3520,3700,0.051,-180,3610,"Rep",0,100,TRUE,FALSE,FALSE,4.86,"young",51,186,80,"m"
11,"LOWER BACK",2,"Rep02",3480,3500,3450,3500,3490,3475,0.004,15,3482.5,"Rep",-20,-50,FALSE,FALSE,FALSE,0.43,"young",51,186,80,"m"
11,"LOWER BACK",2,"Rep03",3440,3460,3450,3400,3450,3425,0.007,25,3437.5,"Rep",-20,50,FALSE,FALSE,FALSE,0.73,"young",51,186,80,"m"
11,"LOWER BACK",2,"Rep04",3740,3720,3700,3650,3730,3675,0.015,55,3702.5,"Rep",20,50,FALSE,FALSE,FALSE,1.5,"young",51,186,80,"m"
11,"LOWER BACK",2,"Rep05",3480,3500,3550,3500,3490,3525,0.01,-35,3507.5,"Rep",-20,50,FALSE,FALSE,FALSE,0.99,"young",51,186,80,"m"
11,"LOWER BACK",2,"Rep06",3520,3480,3400,3500,3500,3450,0.014,50,3475,"Rep",40,-100,FALSE,FALSE,FALSE,1.45,"young",51,186,80,"m"
11,"LOWER BACK",2,"Rep07",3340,3360,3350,3350,3350,3350,0,0,3350,"Rep",-20,0,FALSE,FALSE,FALSE,0,"young",51,186,80,"m"
11,"LOWER BACK",2,"Rep08",3400,3360,3300,3350,3380,3325,0.016,55,3352.5,"Rep",40,-50,FALSE,FALSE,FALSE,1.65,"young",51,186,80,"m"
11,"LOWER BACK",2,"Rep09",3320,3360,3350,3400,3340,3375,0.01,-35,3357.5,"Rep",-40,-50,FALSE,FALSE,FALSE,1.04,"young",51,186,80,"m"
11,"LOWER BACK",2,"Rep10",3240,3240,3400,3300,3240,3350,0.034,-110,3295,"Rep",0,100,TRUE,FALSE,FALSE,3.28,"young",51,186,80,"m"
11,"LOWER BACK",1,"TuT",34860,34860,35000,35050,34860,35025,0.005,-165,34942.5,"TuT",0,-50,FALSE,FALSE,FALSE,0.47,"young",51,186,80,"m"
11,"LOWER BACK",2,"TuT",34480,34500,34700,34600,34490,34650,0.005,-160,34570,"TuT",-20,100,FALSE,FALSE,FALSE,0.46,"young",51,186,80,"m"
11,"TOTAL ABDOMINAL",1,"Con01",1520,1520,1700,1700,1520,1700,0.118,-180,1610,"Con",0,0,TRUE,FALSE,FALSE,10.59,"young",51,186,80,"m"
11,"TOTAL ABDOMINAL",1,"Con02",1040,1060,1100,1100,1050,1100,0.048,-50,1075,"Con",-20,0,FALSE,FALSE,FALSE,4.55,"young",51,186,80,"m"
11,"TOTAL ABDOMINAL",1,"Con03",1060,1080,1050,1050,1070,1050,0.019,20,1060,"Con",-20,0,FALSE,FALSE,FALSE,1.9,"young",51,186,80,"m"
11,"TOTAL ABDOMINAL",1,"Con04",1020,1060,1100,1100,1040,1100,0.058,-60,1070,"Con",-40,0,FALSE,TRUE,FALSE,5.45,"young",51,186,80,"m"
11,"TOTAL ABDOMINAL",1,"Con05",1080,1120,1100,1100,1100,1100,0,0,1100,"Con",-40,0,FALSE,TRUE,FALSE,0,"young",51,186,80,"m"
11,"TOTAL ABDOMINAL",1,"Con06",1120,1140,1300,1300,1130,1300,0.15,-170,1215,"Con",-20,0,TRUE,FALSE,FALSE,13.08,"young",51,186,80,"m"
11,"TOTAL ABDOMINAL",1,"Con07",1280,1280,1400,1400,1280,1400,0.094,-120,1340,"Con",0,0,FALSE,FALSE,FALSE,8.57,"young",51,186,80,"m"
11,"TOTAL ABDOMINAL",1,"Con08",1100,1140,1450,1450,1120,1450,0.295,-330,1285,"Con",-40,0,TRUE,TRUE,FALSE,22.76,"young",51,186,80,"m"
11,"TOTAL ABDOMINAL",1,"Con09",1060,1100,1450,1450,1080,1450,0.343,-370,1265,"Con",-40,0,TRUE,TRUE,FALSE,25.52,"young",51,186,80,"m"
11,"TOTAL ABDOMINAL",1,"Con10",1500,1500,1550,1550,1500,1550,0.033,-50,1525,"Con",0,0,FALSE,FALSE,FALSE,3.23,"young",51,186,80,"m"
11,"TOTAL ABDOMINAL",2,"Con01",1260,1280,1400,1300,1270,1350,0.063,-80,1310,"Con",-20,100,FALSE,FALSE,FALSE,5.93,"young",51,186,80,"m"
11,"TOTAL ABDOMINAL",2,"Con02",1220,1220,1250,1250,1220,1250,0.025,-30,1235,"Con",0,0,FALSE,FALSE,FALSE,2.4,"young",51,186,80,"m"
11,"TOTAL ABDOMINAL",2,"Con03",1460,1460,1350,1450,1460,1400,0.041,60,1430,"Con",0,-100,FALSE,FALSE,FALSE,4.29,"young",51,186,80,"m"
11,"TOTAL ABDOMINAL",2,"Con04",1380,1380,1600,1650,1380,1625,0.178,-245,1502.5,"Con",0,-50,TRUE,FALSE,FALSE,15.08,"young",51,186,80,"m"
11,"TOTAL ABDOMINAL",2,"Con05",1260,1260,1400,1500,1260,1450,0.151,-190,1355,"Con",0,-100,TRUE,FALSE,FALSE,13.1,"young",51,186,80,"m"
11,"TOTAL ABDOMINAL",2,"Con06",1300,1300,1300,1300,1300,1300,0,0,1300,"Con",0,0,FALSE,FALSE,FALSE,0,"young",51,186,80,"m"
11,"TOTAL ABDOMINAL",2,"Con07",1360,1360,1400,1300,1360,1350,0.007,10,1355,"Con",0,100,FALSE,FALSE,FALSE,0.74,"young",51,186,80,"m"
11,"TOTAL ABDOMINAL",2,"Con08",1340,1360,1400,1400,1350,1400,0.037,-50,1375,"Con",-20,0,FALSE,FALSE,FALSE,3.57,"young",51,186,80,"m"
11,"TOTAL ABDOMINAL",2,"Con09",1200,1180,1250,1200,1190,1225,0.029,-35,1207.5,"Con",20,50,FALSE,FALSE,FALSE,2.86,"young",51,186,80,"m"
11,"TOTAL ABDOMINAL",2,"Con10",1480,1460,1600,1550,1470,1575,0.071,-105,1522.5,"Con",20,50,FALSE,FALSE,FALSE,6.67,"young",51,186,80,"m"
11,"TOTAL ABDOMINAL",1,"Ecc01",2080,2100,2050,2050,2090,2050,0.019,40,2070,"Ecc",-20,0,FALSE,FALSE,FALSE,1.95,"young",51,186,80,"m"
11,"TOTAL ABDOMINAL",1,"Ecc02",1880,1820,1850,1850,1850,1850,0,0,1850,"Ecc",60,0,FALSE,TRUE,FALSE,0,"young",51,186,80,"m"
11,"TOTAL ABDOMINAL",1,"Ecc03",1860,1840,1800,1800,1850,1800,0.027,50,1825,"Ecc",20,0,FALSE,FALSE,FALSE,2.78,"young",51,186,80,"m"
11,"TOTAL ABDOMINAL",1,"Ecc04",2020,1980,2000,2000,2000,2000,0,0,2000,"Ecc",40,0,FALSE,TRUE,FALSE,0,"young",51,186,80,"m"
11,"TOTAL ABDOMINAL",1,"Ecc05",2460,2420,2300,2300,2440,2300,0.057,140,2370,"Ecc",40,0,FALSE,TRUE,FALSE,6.09,"young",51,186,80,"m"
11,"TOTAL ABDOMINAL",1,"Ecc06",2260,2260,2100,2100,2260,2100,0.071,160,2180,"Ecc",0,0,TRUE,FALSE,FALSE,7.62,"young",51,186,80,"m"
11,"TOTAL ABDOMINAL",1,"Ecc07",2360,2340,2100,2100,2350,2100,0.106,250,2225,"Ecc",20,0,TRUE,FALSE,FALSE,11.9,"young",51,186,80,"m"
11,"TOTAL ABDOMINAL",1,"Ecc08",2460,2420,2050,2050,2440,2050,0.16,390,2245,"Ecc",40,0,TRUE,TRUE,FALSE,19.02,"young",51,186,80,"m"
11,"TOTAL ABDOMINAL",1,"Ecc09",2180,2160,2100,2100,2170,2100,0.032,70,2135,"Ecc",20,0,FALSE,FALSE,FALSE,3.33,"young",51,186,80,"m"
11,"TOTAL ABDOMINAL",1,"Ecc10",2540,2540,2500,2500,2540,2500,0.016,40,2520,"Ecc",0,0,FALSE,FALSE,FALSE,1.6,"young",51,186,80,"m"
11,"TOTAL ABDOMINAL",2,"Ecc01",2160,2160,2100,2150,2160,2125,0.016,35,2142.5,"Ecc",0,-50,FALSE,FALSE,FALSE,1.65,"young",51,186,80,"m"
11,"TOTAL ABDOMINAL",2,"Ecc02",1980,1980,2100,2000,1980,2050,0.035,-70,2015,"Ecc",0,100,FALSE,FALSE,FALSE,3.41,"young",51,186,80,"m"
11,"TOTAL ABDOMINAL",2,"Ecc03",2320,2300,2150,2100,2310,2125,0.08,185,2217.5,"Ecc",20,50,TRUE,FALSE,FALSE,8.71,"young",51,186,80,"m"
11,"TOTAL ABDOMINAL",2,"Ecc04",2460,2460,2250,2100,2460,2175,0.116,285,2317.5,"Ecc",0,150,TRUE,FALSE,FALSE,13.1,"young",51,186,80,"m"
11,"TOTAL ABDOMINAL",2,"Ecc05",2000,2000,2000,2000,2000,2000,0,0,2000,"Ecc",0,0,FALSE,FALSE,FALSE,0,"young",51,186,80,"m"
11,"TOTAL ABDOMINAL",2,"Ecc06",1940,1940,1900,2000,1940,1950,0.005,-10,1945,"Ecc",0,-100,FALSE,FALSE,FALSE,0.51,"young",51,186,80,"m"
11,"TOTAL ABDOMINAL",2,"Ecc07",2040,2020,2000,2000,2030,2000,0.015,30,2015,"Ecc",20,0,FALSE,FALSE,FALSE,1.5,"young",51,186,80,"m"
11,"TOTAL ABDOMINAL",2,"Ecc08",1840,1860,1800,1850,1850,1825,0.014,25,1837.5,"Ecc",-20,-50,FALSE,FALSE,FALSE,1.37,"young",51,186,80,"m"
11,"TOTAL ABDOMINAL",2,"Ecc09",1880,1900,1800,1850,1890,1825,0.034,65,1857.5,"Ecc",-20,-50,FALSE,FALSE,FALSE,3.56,"young",51,186,80,"m"
11,"TOTAL ABDOMINAL",2,"Ecc10",1980,1980,1800,1950,1980,1875,0.053,105,1927.5,"Ecc",0,-150,FALSE,FALSE,FALSE,5.6,"young",51,186,80,"m"
11,"TOTAL ABDOMINAL",1,"Rep01",3600,3620,3750,3750,3610,3750,0.039,-140,3680,"Rep",-20,0,TRUE,FALSE,FALSE,3.73,"young",51,186,80,"m"
11,"TOTAL ABDOMINAL",1,"Rep02",2920,2880,2950,2950,2900,2950,0.017,-50,2925,"Rep",40,0,FALSE,FALSE,FALSE,1.69,"young",51,186,80,"m"
11,"TOTAL ABDOMINAL",1,"Rep03",2920,2920,2850,2850,2920,2850,0.024,70,2885,"Rep",0,0,FALSE,FALSE,FALSE,2.46,"young",51,186,80,"m"
11,"TOTAL ABDOMINAL",1,"Rep04",3040,3040,3100,3100,3040,3100,0.02,-60,3070,"Rep",0,0,FALSE,FALSE,FALSE,1.94,"young",51,186,80,"m"
11,"TOTAL ABDOMINAL",1,"Rep05",3540,3540,3400,3400,3540,3400,0.04,140,3470,"Rep",0,0,TRUE,FALSE,FALSE,4.12,"young",51,186,80,"m"
11,"TOTAL ABDOMINAL",1,"Rep06",3380,3400,3400,3400,3390,3400,0.003,-10,3395,"Rep",-20,0,FALSE,FALSE,FALSE,0.29,"young",51,186,80,"m"
11,"TOTAL ABDOMINAL",1,"Rep07",3640,3620,3500,3500,3630,3500,0.036,130,3565,"Rep",20,0,TRUE,FALSE,FALSE,3.71,"young",51,186,80,"m"
11,"TOTAL ABDOMINAL",1,"Rep08",3560,3560,3500,3500,3560,3500,0.017,60,3530,"Rep",0,0,FALSE,FALSE,FALSE,1.71,"young",51,186,80,"m"
11,"TOTAL ABDOMINAL",1,"Rep09",3240,3260,3550,3550,3250,3550,0.092,-300,3400,"Rep",-20,0,TRUE,FALSE,FALSE,8.45,"young",51,186,80,"m"
11,"TOTAL ABDOMINAL",1,"Rep10",4040,4040,4050,4050,4040,4050,0.002,-10,4045,"Rep",0,0,FALSE,FALSE,FALSE,0.25,"young",51,186,80,"m"
11,"TOTAL ABDOMINAL",2,"Rep01",3420,3440,3500,3450,3430,3475,0.013,-45,3452.5,"Rep",-20,50,FALSE,FALSE,FALSE,1.29,"young",51,186,80,"m"
11,"TOTAL ABDOMINAL",2,"Rep02",3200,3200,3350,3250,3200,3300,0.031,-100,3250,"Rep",0,100,FALSE,FALSE,FALSE,3.03,"young",51,186,80,"m"
11,"TOTAL ABDOMINAL",2,"Rep03",3780,3760,3500,3550,3770,3525,0.065,245,3647.5,"Rep",20,-50,TRUE,FALSE,FALSE,6.95,"young",51,186,80,"m"
11,"TOTAL ABDOMINAL",2,"Rep04",3840,3840,3850,3750,3840,3800,0.01,40,3820,"Rep",0,100,FALSE,FALSE,FALSE,1.05,"young",51,186,80,"m"
11,"TOTAL ABDOMINAL",2,"Rep05",3260,3260,3400,3500,3260,3450,0.058,-190,3355,"Rep",0,-100,TRUE,FALSE,FALSE,5.51,"young",51,186,80,"m"
11,"TOTAL ABDOMINAL",2,"Rep06",3240,3240,3200,3300,3240,3250,0.003,-10,3245,"Rep",0,-100,FALSE,FALSE,FALSE,0.31,"young",51,186,80,"m"
11,"TOTAL ABDOMINAL",2,"Rep07",3400,3380,3400,3300,3390,3350,0.012,40,3370,"Rep",20,100,FALSE,FALSE,FALSE,1.19,"young",51,186,80,"m"
11,"TOTAL ABDOMINAL",2,"Rep08",3180,3220,3200,3250,3200,3225,0.008,-25,3212.5,"Rep",-40,-50,FALSE,FALSE,FALSE,0.78,"young",51,186,80,"m"
11,"TOTAL ABDOMINAL",2,"Rep09",3080,3080,3050,3050,3080,3050,0.01,30,3065,"Rep",0,0,FALSE,FALSE,FALSE,0.98,"young",51,186,80,"m"
11,"TOTAL ABDOMINAL",2,"Rep10",3460,3440,3400,3500,3450,3450,0,0,3450,"Rep",20,-100,FALSE,FALSE,FALSE,0,"young",51,186,80,"m"
11,"TOTAL ABDOMINAL",1,"TuT",33880,33880,34050,34050,33880,34050,0.005,-170,33965,"TuT",0,0,FALSE,FALSE,FALSE,0.5,"young",51,186,80,"m"
11,"TOTAL ABDOMINAL",2,"TuT",33860,33860,33850,33900,33860,33875,0,-15,33867.5,"TuT",0,-50,FALSE,FALSE,FALSE,0.04,"young",51,186,80,"m"
11,"VERTICAL TRACTION",1,"Con01",1600,1620,1650,4750,1610,3200,0.988,-1590,2405,"Con",-20,-3100,TRUE,FALSE,TRUE,49.69,"young",51,186,80,"m"
11,"VERTICAL TRACTION",1,"Con02",1360,1340,1400,1850,1350,1625,0.204,-275,1487.5,"Con",20,-450,FALSE,FALSE,TRUE,16.92,"young",51,186,80,"m"
11,"VERTICAL TRACTION",1,"Con03",1240,1220,1350,1450,1230,1400,0.138,-170,1315,"Con",20,-100,FALSE,FALSE,FALSE,12.14,"young",51,186,80,"m"
11,"VERTICAL TRACTION",1,"Con04",1180,1200,1250,1400,1190,1325,0.113,-135,1257.5,"Con",-20,-150,FALSE,FALSE,FALSE,10.19,"young",51,186,80,"m"
11,"VERTICAL TRACTION",1,"Con05",1240,1240,1350,1350,1240,1350,0.089,-110,1295,"Con",0,0,FALSE,FALSE,FALSE,8.15,"young",51,186,80,"m"
11,"VERTICAL TRACTION",1,"Con06",1100,1120,1200,1100,1110,1150,0.036,-40,1130,"Con",-20,100,FALSE,FALSE,FALSE,3.48,"young",51,186,80,"m"
11,"VERTICAL TRACTION",1,"Con07",1180,1160,1300,1150,1170,1225,0.047,-55,1197.5,"Con",20,150,FALSE,FALSE,FALSE,4.49,"young",51,186,80,"m"
11,"VERTICAL TRACTION",1,"Con08",1160,1120,1300,1200,1140,1250,0.096,-110,1195,"Con",40,100,FALSE,FALSE,FALSE,8.8,"young",51,186,80,"m"
11,"VERTICAL TRACTION",1,"Con09",1400,1340,1650,1450,1370,1550,0.131,-180,1460,"Con",60,200,FALSE,FALSE,TRUE,11.61,"young",51,186,80,"m"
11,"VERTICAL TRACTION",1,"Con10",1320,1340,1700,1450,1330,1575,0.184,-245,1452.5,"Con",-20,250,FALSE,FALSE,TRUE,15.56,"young",51,186,80,"m"
11,"VERTICAL TRACTION",2,"Con01",1620,1640,1700,1950,1630,1825,0.12,-195,1727.5,"Con",-20,-250,FALSE,FALSE,TRUE,10.68,"young",51,186,80,"m"
11,"VERTICAL TRACTION",2,"Con02",1120,1100,1300,1250,1110,1275,0.149,-165,1192.5,"Con",20,50,FALSE,FALSE,FALSE,12.94,"young",51,186,80,"m"
11,"VERTICAL TRACTION",2,"Con03",1280,1280,1300,1350,1280,1325,0.035,-45,1302.5,"Con",0,-50,FALSE,FALSE,FALSE,3.4,"young",51,186,80,"m"
11,"VERTICAL TRACTION",2,"Con04",1080,1100,1150,1250,1090,1200,0.101,-110,1145,"Con",-20,-100,FALSE,FALSE,FALSE,9.17,"young",51,186,80,"m"
11,"VERTICAL TRACTION",2,"Con05",1160,1180,1200,1300,1170,1250,0.068,-80,1210,"Con",-20,-100,FALSE,FALSE,FALSE,6.4,"young",51,186,80,"m"
11,"VERTICAL TRACTION",2,"Con06",1160,1140,1200,1200,1150,1200,0.043,-50,1175,"Con",20,0,FALSE,FALSE,FALSE,4.17,"young",51,186,80,"m"
11,"VERTICAL TRACTION",2,"Con07",1180,1180,1250,1200,1180,1225,0.038,-45,1202.5,"Con",0,50,FALSE,FALSE,FALSE,3.67,"young",51,186,80,"m"
11,"VERTICAL TRACTION",2,"Con08",1260,1260,1400,1350,1260,1375,0.091,-115,1317.5,"Con",0,50,FALSE,FALSE,FALSE,8.36,"young",51,186,80,"m"
11,"VERTICAL TRACTION",2,"Con09",1160,1120,1350,1250,1140,1300,0.14,-160,1220,"Con",40,100,FALSE,FALSE,FALSE,12.31,"young",51,186,80,"m"
11,"VERTICAL TRACTION",2,"Con10",1260,1260,1500,1400,1260,1450,0.151,-190,1355,"Con",0,100,FALSE,FALSE,FALSE,13.1,"young",51,186,80,"m"
11,"VERTICAL TRACTION",1,"Ecc01",2140,2180,2100,1650,2160,1875,0.132,285,2017.5,"Ecc",-40,450,TRUE,FALSE,TRUE,15.2,"young",51,186,80,"m"
11,"VERTICAL TRACTION",1,"Ecc02",2180,2220,2050,1850,2200,1950,0.114,250,2075,"Ecc",-40,200,FALSE,FALSE,TRUE,12.82,"young",51,186,80,"m"
11,"VERTICAL TRACTION",1,"Ecc03",1980,1940,1900,1750,1960,1825,0.069,135,1892.5,"Ecc",40,150,FALSE,FALSE,FALSE,7.4,"young",51,186,80,"m"
11,"VERTICAL TRACTION",1,"Ecc04",2140,2160,2050,2000,2150,2025,0.058,125,2087.5,"Ecc",-20,50,FALSE,FALSE,FALSE,6.17,"young",51,186,80,"m"
11,"VERTICAL TRACTION",1,"Ecc05",2160,2140,2050,2150,2150,2100,0.023,50,2125,"Ecc",20,-100,FALSE,FALSE,FALSE,2.38,"young",51,186,80,"m"
11,"VERTICAL TRACTION",1,"Ecc06",2020,2020,1950,2050,2020,2000,0.01,20,2010,"Ecc",0,-100,FALSE,FALSE,FALSE,1,"young",51,186,80,"m"
11,"VERTICAL TRACTION",1,"Ecc07",1880,1920,1700,1850,1900,1775,0.066,125,1837.5,"Ecc",-40,-150,FALSE,FALSE,FALSE,7.04,"young",51,186,80,"m"
11,"VERTICAL TRACTION",1,"Ecc08",2080,2100,1850,2000,2090,1925,0.079,165,2007.5,"Ecc",-20,-150,FALSE,FALSE,FALSE,8.57,"young",51,186,80,"m"
11,"VERTICAL TRACTION",1,"Ecc09",2160,2200,1900,2100,2180,2000,0.083,180,2090,"Ecc",-40,-200,FALSE,FALSE,TRUE,9,"young",51,186,80,"m"
11,"VERTICAL TRACTION",1,"Ecc10",2600,2640,2450,2600,2620,2525,0.036,95,2572.5,"Ecc",-40,-150,FALSE,FALSE,FALSE,3.76,"young",51,186,80,"m"
11,"VERTICAL TRACTION",2,"Ecc01",2140,2120,2000,2000,2130,2000,0.061,130,2065,"Ecc",20,0,FALSE,FALSE,FALSE,6.5,"young",51,186,80,"m"
11,"VERTICAL TRACTION",2,"Ecc02",2100,2120,2000,2000,2110,2000,0.052,110,2055,"Ecc",-20,0,FALSE,FALSE,FALSE,5.5,"young",51,186,80,"m"
11,"VERTICAL TRACTION",2,"Ecc03",1960,1940,1950,1850,1950,1900,0.026,50,1925,"Ecc",20,100,FALSE,FALSE,FALSE,2.63,"young",51,186,80,"m"
11,"VERTICAL TRACTION",2,"Ecc04",2080,2060,2000,1900,2070,1950,0.058,120,2010,"Ecc",20,100,FALSE,FALSE,FALSE,6.15,"young",51,186,80,"m"
11,"VERTICAL TRACTION",2,"Ecc05",1840,1860,1800,1750,1850,1775,0.041,75,1812.5,"Ecc",-20,50,FALSE,FALSE,FALSE,4.23,"young",51,186,80,"m"
11,"VERTICAL TRACTION",2,"Ecc06",1800,1800,1750,1800,1800,1775,0.014,25,1787.5,"Ecc",0,-50,FALSE,FALSE,FALSE,1.41,"young",51,186,80,"m"
11,"VERTICAL TRACTION",2,"Ecc07",1860,1860,1750,1800,1860,1775,0.046,85,1817.5,"Ecc",0,-50,FALSE,FALSE,FALSE,4.79,"young",51,186,80,"m"
11,"VERTICAL TRACTION",2,"Ecc08",2060,2080,1850,1900,2070,1875,0.094,195,1972.5,"Ecc",-20,-50,FALSE,FALSE,FALSE,10.4,"young",51,186,80,"m"
11,"VERTICAL TRACTION",2,"Ecc09",1840,1860,1600,1750,1850,1675,0.095,175,1762.5,"Ecc",-20,-150,FALSE,FALSE,FALSE,10.45,"young",51,186,80,"m"
11,"VERTICAL TRACTION",2,"Ecc10",2720,2720,2750,2750,2720,2750,0.011,-30,2735,"Ecc",0,0,FALSE,FALSE,FALSE,1.09,"young",51,186,80,"m"
11,"VERTICAL TRACTION",1,"Rep01",3740,3800,3750,6400,3770,5075,0.346,-1305,4422.5,"Rep",-60,-2650,TRUE,FALSE,TRUE,25.71,"young",51,186,80,"m"
11,"VERTICAL TRACTION",1,"Rep02",3540,3560,3450,3700,3550,3575,0.007,-25,3562.5,"Rep",-20,-250,FALSE,FALSE,TRUE,0.7,"young",51,186,80,"m"
11,"VERTICAL TRACTION",1,"Rep03",3220,3160,3250,3200,3190,3225,0.011,-35,3207.5,"Rep",60,50,FALSE,FALSE,FALSE,1.09,"young",51,186,80,"m"
11,"VERTICAL TRACTION",1,"Rep04",3320,3360,3300,3400,3340,3350,0.003,-10,3345,"Rep",-40,-100,FALSE,FALSE,FALSE,0.3,"young",51,186,80,"m"
11,"VERTICAL TRACTION",1,"Rep05",3400,3380,3400,3500,3390,3450,0.018,-60,3420,"Rep",20,-100,FALSE,FALSE,FALSE,1.74,"young",51,186,80,"m"
11,"VERTICAL TRACTION",1,"Rep06",3120,3140,3150,3150,3130,3150,0.006,-20,3140,"Rep",-20,0,FALSE,FALSE,FALSE,0.63,"young",51,186,80,"m"
11,"VERTICAL TRACTION",1,"Rep07",3060,3080,3000,3000,3070,3000,0.023,70,3035,"Rep",-20,0,FALSE,FALSE,FALSE,2.33,"young",51,186,80,"m"
11,"VERTICAL TRACTION",1,"Rep08",3240,3220,3150,3200,3230,3175,0.017,55,3202.5,"Rep",20,-50,FALSE,FALSE,FALSE,1.73,"young",51,186,80,"m"
11,"VERTICAL TRACTION",1,"Rep09",3560,3540,3550,3550,3550,3550,0,0,3550,"Rep",20,0,FALSE,FALSE,FALSE,0,"young",51,186,80,"m"
11,"VERTICAL TRACTION",1,"Rep10",3920,3980,4150,4050,3950,4100,0.038,-150,4025,"Rep",-60,100,TRUE,FALSE,FALSE,3.66,"young",51,186,80,"m"
11,"VERTICAL TRACTION",2,"Rep01",3760,3760,3700,3950,3760,3825,0.017,-65,3792.5,"Rep",0,-250,FALSE,FALSE,TRUE,1.7,"young",51,186,80,"m"
11,"VERTICAL TRACTION",2,"Rep02",3220,3220,3300,3250,3220,3275,0.017,-55,3247.5,"Rep",0,50,FALSE,FALSE,FALSE,1.68,"young",51,186,80,"m"
11,"VERTICAL TRACTION",2,"Rep03",3240,3220,3250,3200,3230,3225,0.002,5,3227.5,"Rep",20,50,FALSE,FALSE,FALSE,0.16,"young",51,186,80,"m"
11,"VERTICAL TRACTION",2,"Rep04",3160,3160,3150,3150,3160,3150,0.003,10,3155,"Rep",0,0,FALSE,FALSE,FALSE,0.32,"young",51,186,80,"m"
11,"VERTICAL TRACTION",2,"Rep05",3000,3040,3000,3050,3020,3025,0.002,-5,3022.5,"Rep",-40,-50,FALSE,FALSE,FALSE,0.17,"young",51,186,80,"m"
11,"VERTICAL TRACTION",2,"Rep06",2960,2940,2950,3000,2950,2975,0.008,-25,2962.5,"Rep",20,-50,FALSE,FALSE,FALSE,0.84,"young",51,186,80,"m"
11,"VERTICAL TRACTION",2,"Rep07",3040,3040,3000,3000,3040,3000,0.013,40,3020,"Rep",0,0,FALSE,FALSE,FALSE,1.33,"young",51,186,80,"m"
11,"VERTICAL TRACTION",2,"Rep08",3320,3340,3250,3250,3330,3250,0.024,80,3290,"Rep",-20,0,FALSE,FALSE,FALSE,2.46,"young",51,186,80,"m"
11,"VERTICAL TRACTION",2,"Rep09",3000,2980,2950,3000,2990,2975,0.005,15,2982.5,"Rep",20,-50,FALSE,FALSE,FALSE,0.5,"young",51,186,80,"m"
11,"VERTICAL TRACTION",2,"Rep10",3980,3980,4250,4150,3980,4200,0.055,-220,4090,"Rep",0,100,TRUE,FALSE,FALSE,5.24,"young",51,186,80,"m"
11,"VERTICAL TRACTION",1,"TuT",34120,34220,34150,37150,34170,35650,0.043,-1480,34910,"TuT",-100,-3000,FALSE,TRUE,TRUE,4.15,"young",51,186,80,"m"
11,"VERTICAL TRACTION",2,"TuT",32680,32680,32800,33000,32680,32900,0.007,-220,32790,"TuT",0,-200,FALSE,FALSE,FALSE,0.67,"young",51,186,80,"m"
11,"CHEST PRESS",1,"Con01",1260,1260,1400,1450,1260,1425,0.131,-165,1342.5,"Con",0,-50,FALSE,FALSE,FALSE,11.58,"young",51,186,80,"m"
11,"CHEST PRESS",1,"Con02",1140,1100,1150,1550,1120,1350,0.205,-230,1235,"Con",40,-400,FALSE,TRUE,TRUE,17.04,"young",51,186,80,"m"
11,"CHEST PRESS",1,"Con03",1100,1120,2100,2200,1110,2150,0.937,-1040,1630,"Con",-20,-100,TRUE,FALSE,FALSE,48.37,"young",51,186,80,"m"
11,"CHEST PRESS",1,"Con04",1160,1140,2300,2250,1150,2275,0.978,-1125,1712.5,"Con",20,50,TRUE,FALSE,FALSE,49.45,"young",51,186,80,"m"
11,"CHEST PRESS",1,"Con05",1140,1120,2200,2050,1130,2125,0.881,-995,1627.5,"Con",20,150,TRUE,FALSE,FALSE,46.82,"young",51,186,80,"m"
11,"CHEST PRESS",1,"Con06",1120,1160,1500,1500,1140,1500,0.316,-360,1320,"Con",-40,0,TRUE,TRUE,FALSE,24,"young",51,186,80,"m"
11,"CHEST PRESS",1,"Con07",1160,1160,1400,1350,1160,1375,0.185,-215,1267.5,"Con",0,50,FALSE,FALSE,FALSE,15.64,"young",51,186,80,"m"
11,"CHEST PRESS",1,"Con08",1160,1140,1250,1150,1150,1200,0.043,-50,1175,"Con",20,100,FALSE,FALSE,FALSE,4.17,"young",51,186,80,"m"
11,"CHEST PRESS",1,"Con09",1320,1320,1300,1300,1320,1300,0.015,20,1310,"Con",0,0,FALSE,FALSE,FALSE,1.54,"young",51,186,80,"m"
11,"CHEST PRESS",1,"Con10",1420,1380,1450,1300,1400,1375,0.018,25,1387.5,"Con",40,150,FALSE,TRUE,FALSE,1.82,"young",51,186,80,"m"
11,"CHEST PRESS",2,"Con01",1120,1120,1600,1450,1120,1525,0.362,-405,1322.5,"Con",0,150,TRUE,FALSE,FALSE,26.56,"young",51,186,80,"m"
11,"CHEST PRESS",2,"Con02",1320,1360,1900,2550,1340,2225,0.66,-885,1782.5,"Con",-40,-650,TRUE,TRUE,TRUE,39.78,"young",51,186,80,"m"
11,"CHEST PRESS",2,"Con03",1180,1200,2200,2600,1190,2400,1.017,-1210,1795,"Con",-20,-400,TRUE,FALSE,TRUE,50.42,"young",51,186,80,"m"
11,"CHEST PRESS",2,"Con04",1180,1160,1550,2550,1170,2050,0.752,-880,1610,"Con",20,-1000,TRUE,FALSE,TRUE,42.93,"young",51,186,80,"m"
11,"CHEST PRESS",2,"Con05",1200,1160,1450,2600,1180,2025,0.716,-845,1602.5,"Con",40,-1150,TRUE,TRUE,TRUE,41.73,"young",51,186,80,"m"
11,"CHEST PRESS",2,"Con06",1200,1200,1300,2350,1200,1825,0.521,-625,1512.5,"Con",0,-1050,TRUE,FALSE,TRUE,34.25,"young",51,186,80,"m"
11,"CHEST PRESS",2,"Con07",1120,1100,1350,1300,1110,1325,0.194,-215,1217.5,"Con",20,50,FALSE,FALSE,FALSE,16.23,"young",51,186,80,"m"
11,"CHEST PRESS",2,"Con08",1180,1220,2000,1000,1200,1500,0.25,-300,1350,"Con",-40,1000,FALSE,TRUE,TRUE,20,"young",51,186,80,"m"
11,"CHEST PRESS",2,"Con09",1240,1240,1550,950,1240,1250,0.008,-10,1245,"Con",0,600,FALSE,FALSE,TRUE,0.8,"young",51,186,80,"m"
11,"CHEST PRESS",2,"Con10",1380,1380,1550,900,1380,1225,0.112,155,1302.5,"Con",0,650,FALSE,FALSE,TRUE,12.65,"young",51,186,80,"m"
11,"CHEST PRESS",1,"Ecc01",1860,1900,1850,1700,1880,1775,0.056,105,1827.5,"Ecc",-40,150,FALSE,TRUE,FALSE,5.92,"young",51,186,80,"m"
11,"CHEST PRESS",1,"Ecc02",2300,2280,1900,1600,2290,1750,0.236,540,2020,"Ecc",20,300,TRUE,FALSE,TRUE,30.86,"young",51,186,80,"m"
11,"CHEST PRESS",1,"Ecc03",2520,2540,1550,1500,2530,1525,0.397,1005,2027.5,"Ecc",-20,50,TRUE,FALSE,FALSE,65.9,"young",51,186,80,"m"
11,"CHEST PRESS",1,"Ecc04",2720,2740,1450,1600,2730,1525,0.441,1205,2127.5,"Ecc",-20,-150,TRUE,FALSE,FALSE,79.02,"young",51,186,80,"m"
11,"CHEST PRESS",1,"Ecc05",2460,2420,1650,1700,2440,1675,0.314,765,2057.5,"Ecc",40,-50,TRUE,TRUE,FALSE,45.67,"young",51,186,80,"m"
11,"CHEST PRESS",1,"Ecc06",2600,2600,2300,2350,2600,2325,0.106,275,2462.5,"Ecc",0,-50,FALSE,FALSE,FALSE,11.83,"young",51,186,80,"m"
11,"CHEST PRESS",1,"Ecc07",2640,2660,2500,2550,2650,2525,0.047,125,2587.5,"Ecc",-20,-50,FALSE,FALSE,FALSE,4.95,"young",51,186,80,"m"
11,"CHEST PRESS",1,"Ecc08",2540,2560,2550,2600,2550,2575,0.01,-25,2562.5,"Ecc",-20,-50,FALSE,FALSE,FALSE,0.97,"young",51,186,80,"m"
11,"CHEST PRESS",1,"Ecc09",2420,2420,2400,2450,2420,2425,0.002,-5,2422.5,"Ecc",0,-50,FALSE,FALSE,FALSE,0.21,"young",51,186,80,"m"
11,"CHEST PRESS",1,"Ecc10",2000,2000,2650,1300,2000,1975,0.012,25,1987.5,"Ecc",0,1350,FALSE,FALSE,TRUE,1.27,"young",51,186,80,"m"
11,"CHEST PRESS",2,"Ecc01",2320,2280,2000,1750,2300,1875,0.185,425,2087.5,"Ecc",40,250,TRUE,TRUE,TRUE,22.67,"young",51,186,80,"m"
11,"CHEST PRESS",2,"Ecc02",2620,2600,1800,1250,2610,1525,0.416,1085,2067.5,"Ecc",20,550,TRUE,FALSE,TRUE,71.15,"young",51,186,80,"m"
11,"CHEST PRESS",2,"Ecc03",2580,2580,1700,1200,2580,1450,0.438,1130,2015,"Ecc",0,500,TRUE,FALSE,TRUE,77.93,"young",51,186,80,"m"
11,"CHEST PRESS",2,"Ecc04",2460,2520,2150,1200,2490,1675,0.327,815,2082.5,"Ecc",-60,950,TRUE,TRUE,TRUE,48.66,"young",51,186,80,"m"
11,"CHEST PRESS",2,"Ecc05",2740,2760,2550,1400,2750,1975,0.282,775,2362.5,"Ecc",-20,1150,TRUE,FALSE,TRUE,39.24,"young",51,186,80,"m"
11,"CHEST PRESS",2,"Ecc06",2860,2860,2700,1900,2860,2300,0.196,560,2580,"Ecc",0,800,TRUE,FALSE,TRUE,24.35,"young",51,186,80,"m"
11,"CHEST PRESS",2,"Ecc07",2720,2700,2450,2750,2710,2600,0.041,110,2655,"Ecc",20,-300,FALSE,FALSE,TRUE,4.23,"young",51,186,80,"m"
11,"CHEST PRESS",2,"Ecc08",2580,2560,1800,2850,2570,2325,0.095,245,2447.5,"Ecc",20,-1050,FALSE,FALSE,TRUE,10.54,"young",51,186,80,"m"
11,"CHEST PRESS",2,"Ecc09",2520,2520,2250,2900,2520,2575,0.022,-55,2547.5,"Ecc",0,-650,FALSE,FALSE,TRUE,2.14,"young",51,186,80,"m"
11,"CHEST PRESS",2,"Ecc10",2500,2500,2900,3200,2500,3050,0.22,-550,2775,"Ecc",0,-300,TRUE,FALSE,TRUE,18.03,"young",51,186,80,"m"
11,"CHEST PRESS",1,"Rep01",3120,3160,3250,3150,3140,3200,0.019,-60,3170,"Rep",-40,100,FALSE,FALSE,FALSE,1.88,"young",51,186,80,"m"
11,"CHEST PRESS",1,"Rep02",3440,3380,3050,3150,3410,3100,0.091,310,3255,"Rep",60,-100,TRUE,FALSE,FALSE,10,"young",51,186,80,"m"
11,"CHEST PRESS",1,"Rep03",3620,3660,3650,3700,3640,3675,0.01,-35,3657.5,"Rep",-40,-50,FALSE,FALSE,FALSE,0.95,"young",51,186,80,"m"
11,"CHEST PRESS",1,"Rep04",3880,3880,3750,3850,3880,3800,0.021,80,3840,"Rep",0,-100,FALSE,FALSE,FALSE,2.11,"young",51,186,80,"m"
11,"CHEST PRESS",1,"Rep05",3600,3540,3850,3750,3570,3800,0.064,-230,3685,"Rep",60,100,TRUE,FALSE,FALSE,6.05,"young",51,186,80,"m"
11,"CHEST PRESS",1,"Rep06",3720,3760,3800,3850,3740,3825,0.023,-85,3782.5,"Rep",-40,-50,FALSE,FALSE,FALSE,2.22,"young",51,186,80,"m"
11,"CHEST PRESS",1,"Rep07",3800,3820,3900,3900,3810,3900,0.024,-90,3855,"Rep",-20,0,FALSE,FALSE,FALSE,2.31,"young",51,186,80,"m"
11,"CHEST PRESS",1,"Rep08",3700,3700,3800,3750,3700,3775,0.02,-75,3737.5,"Rep",0,50,FALSE,FALSE,FALSE,1.99,"young",51,186,80,"m"
11,"CHEST PRESS",1,"Rep09",3740,3740,3700,3750,3740,3725,0.004,15,3732.5,"Rep",0,-50,FALSE,FALSE,FALSE,0.4,"young",51,186,80,"m"
11,"CHEST PRESS",1,"Rep10",3420,3380,4100,2600,3400,3350,0.015,50,3375,"Rep",40,1500,FALSE,FALSE,TRUE,1.49,"young",51,186,80,"m"
11,"CHEST PRESS",2,"Rep01",3440,3400,3600,3200,3420,3400,0.006,20,3410,"Rep",40,400,FALSE,FALSE,TRUE,0.59,"young",51,186,80,"m"
11,"CHEST PRESS",2,"Rep02",3940,3960,3700,3800,3950,3750,0.051,200,3850,"Rep",-20,-100,TRUE,FALSE,FALSE,5.33,"young",51,186,80,"m"
11,"CHEST PRESS",2,"Rep03",3760,3780,3900,3800,3770,3850,0.021,-80,3810,"Rep",-20,100,FALSE,FALSE,FALSE,2.08,"young",51,186,80,"m"
11,"CHEST PRESS",2,"Rep04",3640,3680,3700,3750,3660,3725,0.018,-65,3692.5,"Rep",-40,-50,FALSE,FALSE,FALSE,1.74,"young",51,186,80,"m"
11,"CHEST PRESS",2,"Rep05",3940,3920,4000,4000,3930,4000,0.018,-70,3965,"Rep",20,0,FALSE,FALSE,FALSE,1.75,"young",51,186,80,"m"
11,"CHEST PRESS",2,"Rep06",4060,4060,4000,4250,4060,4125,0.016,-65,4092.5,"Rep",0,-250,FALSE,FALSE,TRUE,1.58,"young",51,186,80,"m"
11,"CHEST PRESS",2,"Rep07",3840,3800,3800,4050,3820,3925,0.027,-105,3872.5,"Rep",40,-250,FALSE,FALSE,TRUE,2.68,"young",51,186,80,"m"
11,"CHEST PRESS",2,"Rep08",3760,3780,3800,3850,3770,3825,0.015,-55,3797.5,"Rep",-20,-50,FALSE,FALSE,FALSE,1.44,"young",51,186,80,"m"
11,"CHEST PRESS",2,"Rep09",3760,3760,3800,3850,3760,3825,0.017,-65,3792.5,"Rep",0,-50,FALSE,FALSE,FALSE,1.7,"young",51,186,80,"m"
11,"CHEST PRESS",2,"Rep10",3880,3880,4450,4100,3880,4275,0.102,-395,4077.5,"Rep",0,350,TRUE,FALSE,TRUE,9.24,"young",51,186,80,"m"
11,"CHEST PRESS",1,"TuT",36040,36020,36850,35450,36030,36150,0.003,-120,36090,"TuT",20,1400,FALSE,FALSE,TRUE,0.33,"young",51,186,80,"m"
11,"CHEST PRESS",2,"TuT",38020,38020,38750,38650,38020,38700,0.018,-680,38360,"TuT",0,100,FALSE,FALSE,FALSE,1.76,"young",51,186,80,"m"
12,"LEG PRESS",1,"Con01",1600,1620,1750,1750,1610,1750,0.087,-140,1680,"Con",-20,0,FALSE,FALSE,FALSE,8,"young",33,164,105,"f"
12,"LEG PRESS",1,"Con02",1820,1760,1700,1750,1790,1725,0.036,65,1757.5,"Con",60,-50,FALSE,FALSE,FALSE,3.77,"young",33,164,105,"f"
12,"LEG PRESS",1,"Con03",1860,1860,1850,1900,1860,1875,0.008,-15,1867.5,"Con",0,-50,FALSE,FALSE,FALSE,0.8,"young",33,164,105,"f"
12,"LEG PRESS",1,"Con04",1720,1760,1900,1750,1740,1825,0.049,-85,1782.5,"Con",-40,150,FALSE,FALSE,FALSE,4.66,"young",33,164,105,"f"
12,"LEG PRESS",1,"Con05",1960,1940,2150,2100,1950,2125,0.09,-175,2037.5,"Con",20,50,FALSE,FALSE,FALSE,8.24,"young",33,164,105,"f"
12,"LEG PRESS",1,"Con06",1820,1840,2300,2650,1830,2475,0.352,-645,2152.5,"Con",-20,-350,TRUE,FALSE,TRUE,26.06,"young",33,164,105,"f"
12,"LEG PRESS",1,"Con07",1560,1580,2200,2450,1570,2325,0.481,-755,1947.5,"Con",-20,-250,TRUE,FALSE,TRUE,32.47,"young",33,164,105,"f"
12,"LEG PRESS",1,"Con08",1840,1800,2400,2400,1820,2400,0.319,-580,2110,"Con",40,0,TRUE,FALSE,FALSE,24.17,"young",33,164,105,"f"
12,"LEG PRESS",1,"Con09",1860,1800,2450,2400,1830,2425,0.325,-595,2127.5,"Con",60,50,TRUE,FALSE,FALSE,24.54,"young",33,164,105,"f"
12,"LEG PRESS",1,"Con10",1600,1580,2450,2500,1590,2475,0.557,-885,2032.5,"Con",20,-50,TRUE,FALSE,FALSE,35.76,"young",33,164,105,"f"
12,"LEG PRESS",2,"Con01",1620,1620,1750,1700,1620,1725,0.065,-105,1672.5,"Con",0,50,FALSE,FALSE,FALSE,6.09,"young",33,164,105,"f"
12,"LEG PRESS",2,"Con02",1900,1900,2050,1950,1900,2000,0.053,-100,1950,"Con",0,100,FALSE,FALSE,FALSE,5,"young",33,164,105,"f"
12,"LEG PRESS",2,"Con03",1400,1400,2350,1900,1400,2125,0.518,-725,1762.5,"Con",0,450,TRUE,FALSE,TRUE,34.12,"young",33,164,105,"f"
12,"LEG PRESS",2,"Con04",1640,1660,1800,1900,1650,1850,0.121,-200,1750,"Con",-20,-100,FALSE,FALSE,FALSE,10.81,"young",33,164,105,"f"
12,"LEG PRESS",2,"Con05",1580,1560,1450,1450,1570,1450,0.076,120,1510,"Con",20,0,FALSE,FALSE,FALSE,8.28,"young",33,164,105,"f"
12,"LEG PRESS",2,"Con06",1200,1200,1750,1800,1200,1775,0.479,-575,1487.5,"Con",0,-50,TRUE,FALSE,FALSE,32.39,"young",33,164,105,"f"
12,"LEG PRESS",2,"Con07",1340,1320,2100,2150,1330,2125,0.598,-795,1727.5,"Con",20,-50,TRUE,FALSE,FALSE,37.41,"young",33,164,105,"f"
12,"LEG PRESS",2,"Con08",1780,1760,2500,2500,1770,2500,0.412,-730,2135,"Con",20,0,TRUE,FALSE,FALSE,29.2,"young",33,164,105,"f"
12,"LEG PRESS",2,"Con09",1660,1640,2850,2750,1650,2800,0.697,-1150,2225,"Con",20,100,TRUE,FALSE,FALSE,41.07,"young",33,164,105,"f"
12,"LEG PRESS",2,"Con10",1440,1480,2500,2500,1460,2500,0.712,-1040,1980,"Con",-40,0,TRUE,FALSE,FALSE,41.6,"young",33,164,105,"f"
12,"LEG PRESS",1,"Ecc01",3800,3800,3850,3750,3800,3800,0,0,3800,"Ecc",0,100,FALSE,FALSE,FALSE,0,"young",33,164,105,"f"
12,"LEG PRESS",1,"Ecc02",3300,3340,3450,3400,3320,3425,0.032,-105,3372.5,"Ecc",-40,50,FALSE,FALSE,FALSE,3.07,"young",33,164,105,"f"
12,"LEG PRESS",1,"Ecc03",2640,2620,2600,2600,2630,2600,0.011,30,2615,"Ecc",20,0,FALSE,FALSE,FALSE,1.15,"young",33,164,105,"f"
12,"LEG PRESS",1,"Ecc04",2740,2720,2500,2650,2730,2575,0.057,155,2652.5,"Ecc",20,-150,FALSE,FALSE,FALSE,6.02,"young",33,164,105,"f"
12,"LEG PRESS",1,"Ecc05",2800,2800,2550,2550,2800,2550,0.089,250,2675,"Ecc",0,0,FALSE,FALSE,FALSE,9.8,"young",33,164,105,"f"
12,"LEG PRESS",1,"Ecc06",3240,3240,2850,2500,3240,2675,0.174,565,2957.5,"Ecc",0,350,TRUE,FALSE,TRUE,21.12,"young",33,164,105,"f"
12,"LEG PRESS",1,"Ecc07",3320,3300,2650,2400,3310,2525,0.237,785,2917.5,"Ecc",20,250,TRUE,FALSE,TRUE,31.09,"young",33,164,105,"f"
12,"LEG PRESS",1,"Ecc08",2980,3040,2350,2400,3010,2375,0.211,635,2692.5,"Ecc",-60,-50,TRUE,FALSE,FALSE,26.74,"young",33,164,105,"f"
12,"LEG PRESS",1,"Ecc09",2780,2820,2200,2200,2800,2200,0.214,600,2500,"Ecc",-40,0,TRUE,FALSE,FALSE,27.27,"young",33,164,105,"f"
12,"LEG PRESS",1,"Ecc10",3260,3280,2750,2700,3270,2725,0.167,545,2997.5,"Ecc",-20,50,TRUE,FALSE,FALSE,20,"young",33,164,105,"f"
12,"LEG PRESS",2,"Ecc01",3720,3740,3600,3650,3730,3625,0.028,105,3677.5,"Ecc",-20,-50,FALSE,FALSE,FALSE,2.9,"young",33,164,105,"f"
12,"LEG PRESS",2,"Ecc02",2880,2880,2700,2800,2880,2750,0.045,130,2815,"Ecc",0,-100,FALSE,FALSE,FALSE,4.73,"young",33,164,105,"f"
12,"LEG PRESS",2,"Ecc03",2800,2800,1900,2350,2800,2125,0.241,675,2462.5,"Ecc",0,-450,TRUE,FALSE,TRUE,31.76,"young",33,164,105,"f"
12,"LEG PRESS",2,"Ecc04",3620,3600,3450,3350,3610,3400,0.058,210,3505,"Ecc",20,100,FALSE,FALSE,FALSE,6.18,"young",33,164,105,"f"
12,"LEG PRESS",2,"Ecc05",2600,2620,2750,2750,2610,2750,0.054,-140,2680,"Ecc",-20,0,FALSE,FALSE,FALSE,5.09,"young",33,164,105,"f"
12,"LEG PRESS",2,"Ecc06",3000,3000,2400,2300,3000,2350,0.217,650,2675,"Ecc",0,100,TRUE,FALSE,FALSE,27.66,"young",33,164,105,"f"
12,"LEG PRESS",2,"Ecc07",2920,2940,2150,2100,2930,2125,0.275,805,2527.5,"Ecc",-20,50,TRUE,FALSE,FALSE,37.88,"young",33,164,105,"f"
12,"LEG PRESS",2,"Ecc08",2860,2860,2000,2100,2860,2050,0.283,810,2455,"Ecc",0,-100,TRUE,FALSE,FALSE,39.51,"young",33,164,105,"f"
12,"LEG PRESS",2,"Ecc09",3140,3180,1850,1850,3160,1850,0.415,1310,2505,"Ecc",-40,0,TRUE,FALSE,FALSE,70.81,"young",33,164,105,"f"
12,"LEG PRESS",2,"Ecc10",2860,2860,2200,2200,2860,2200,0.231,660,2530,"Ecc",0,0,TRUE,FALSE,FALSE,30,"young",33,164,105,"f"
12,"LEG PRESS",1,"Rep01",5400,5420,5600,5500,5410,5550,0.026,-140,5480,"Rep",-20,100,TRUE,FALSE,TRUE,2.52,"young",33,164,105,"f"
12,"LEG PRESS",1,"Rep02",5120,5100,5150,5150,5110,5150,0.008,-40,5130,"Rep",20,0,FALSE,FALSE,FALSE,0.78,"young",33,164,105,"f"
12,"LEG PRESS",1,"Rep03",4500,4480,4450,4500,4490,4475,0.003,15,4482.5,"Rep",20,-50,FALSE,FALSE,FALSE,0.34,"young",33,164,105,"f"
12,"LEG PRESS",1,"Rep04",4460,4480,4400,4400,4470,4400,0.016,70,4435,"Rep",-20,0,FALSE,FALSE,FALSE,1.59,"young",33,164,105,"f"
12,"LEG PRESS",1,"Rep05",4760,4740,4700,4650,4750,4675,0.016,75,4712.5,"Rep",20,50,FALSE,FALSE,FALSE,1.6,"young",33,164,105,"f"
12,"LEG PRESS",1,"Rep06",5060,5080,5150,5150,5070,5150,0.016,-80,5110,"Rep",-20,0,FALSE,FALSE,FALSE,1.55,"young",33,164,105,"f"
12,"LEG PRESS",1,"Rep07",4880,4880,4850,4850,4880,4850,0.006,30,4865,"Rep",0,0,FALSE,FALSE,FALSE,0.62,"young",33,164,105,"f"
12,"LEG PRESS",1,"Rep08",4820,4840,4750,4800,4830,4775,0.011,55,4802.5,"Rep",-20,-50,FALSE,FALSE,FALSE,1.15,"young",33,164,105,"f"
12,"LEG PRESS",1,"Rep09",4640,4620,4650,4600,4630,4625,0.001,5,4627.5,"Rep",20,50,FALSE,FALSE,FALSE,0.11,"young",33,164,105,"f"
12,"LEG PRESS",1,"Rep10",4860,4860,5200,5200,4860,5200,0.07,-340,5030,"Rep",0,0,TRUE,FALSE,FALSE,6.54,"young",33,164,105,"f"
12,"LEG PRESS",2,"Rep01",5340,5360,5350,5350,5350,5350,0,0,5350,"Rep",-20,0,FALSE,FALSE,FALSE,0,"young",33,164,105,"f"
12,"LEG PRESS",2,"Rep02",4780,4780,4750,4750,4780,4750,0.006,30,4765,"Rep",0,0,FALSE,FALSE,FALSE,0.63,"young",33,164,105,"f"
12,"LEG PRESS",2,"Rep03",4200,4200,4250,4250,4200,4250,0.012,-50,4225,"Rep",0,0,FALSE,FALSE,FALSE,1.18,"young",33,164,105,"f"
12,"LEG PRESS",2,"Rep04",5260,5260,5250,5250,5260,5250,0.002,10,5255,"Rep",0,0,FALSE,FALSE,FALSE,0.19,"young",33,164,105,"f"
12,"LEG PRESS",2,"Rep05",4180,4180,4200,4200,4180,4200,0.005,-20,4190,"Rep",0,0,FALSE,FALSE,FALSE,0.48,"young",33,164,105,"f"
12,"LEG PRESS",2,"Rep06",4200,4200,4150,4100,4200,4125,0.018,75,4162.5,"Rep",0,50,FALSE,FALSE,FALSE,1.82,"young",33,164,105,"f"
12,"LEG PRESS",2,"Rep07",4260,4260,4250,4250,4260,4250,0.002,10,4255,"Rep",0,0,FALSE,FALSE,FALSE,0.24,"young",33,164,105,"f"
12,"LEG PRESS",2,"Rep08",4640,4620,4500,4600,4630,4550,0.017,80,4590,"Rep",20,-100,FALSE,FALSE,TRUE,1.76,"young",33,164,105,"f"
12,"LEG PRESS",2,"Rep09",4800,4820,4700,4600,4810,4650,0.033,160,4730,"Rep",-20,100,TRUE,FALSE,TRUE,3.44,"young",33,164,105,"f"
12,"LEG PRESS",2,"Rep10",4300,4340,4700,4700,4320,4700,0.088,-380,4510,"Rep",-40,0,TRUE,FALSE,FALSE,8.09,"young",33,164,105,"f"
12,"LEG PRESS",1,"TuT",48500,48500,48900,48800,48500,48850,0.007,-350,48675,"TuT",0,100,FALSE,FALSE,FALSE,0.72,"young",33,164,105,"f"
12,"LEG PRESS",2,"TuT",45960,46020,46100,46050,45990,46075,0.002,-85,46032.5,"TuT",-60,50,FALSE,FALSE,FALSE,0.18,"young",33,164,105,"f"
12,"LEG EXTENSION",1,"Con01",1420,1440,1600,1650,1430,1625,0.136,-195,1527.5,"Con",-20,-50,TRUE,FALSE,FALSE,12,"young",33,164,105,"f"
12,"LEG EXTENSION",1,"Con02",1280,1240,1150,1250,1260,1200,0.048,60,1230,"Con",40,-100,FALSE,TRUE,FALSE,5,"young",33,164,105,"f"
12,"LEG EXTENSION",1,"Con03",1180,1200,1200,1150,1190,1175,0.013,15,1182.5,"Con",-20,50,FALSE,FALSE,FALSE,1.28,"young",33,164,105,"f"
12,"LEG EXTENSION",1,"Con04",1280,1260,1200,1150,1270,1175,0.075,95,1222.5,"Con",20,50,FALSE,FALSE,FALSE,8.09,"young",33,164,105,"f"
12,"LEG EXTENSION",1,"Con05",1280,1280,1300,1250,1280,1275,0.004,5,1277.5,"Con",0,50,FALSE,FALSE,FALSE,0.39,"young",33,164,105,"f"
12,"LEG EXTENSION",1,"Con06",1240,1240,1750,1700,1240,1725,0.391,-485,1482.5,"Con",0,50,TRUE,FALSE,FALSE,28.12,"young",33,164,105,"f"
12,"LEG EXTENSION",1,"Con07",1080,1080,1500,1450,1080,1475,0.366,-395,1277.5,"Con",0,50,TRUE,FALSE,FALSE,26.78,"young",33,164,105,"f"
12,"LEG EXTENSION",1,"Con08",1200,1140,1750,1800,1170,1775,0.517,-605,1472.5,"Con",60,-50,TRUE,TRUE,FALSE,34.08,"young",33,164,105,"f"
12,"LEG EXTENSION",1,"Con09",1340,1320,1800,1900,1330,1850,0.391,-520,1590,"Con",20,-100,TRUE,FALSE,FALSE,28.11,"young",33,164,105,"f"
12,"LEG EXTENSION",1,"Con10",1100,1100,1500,1650,1100,1575,0.432,-475,1337.5,"Con",0,-150,TRUE,FALSE,FALSE,30.16,"young",33,164,105,"f"
12,"LEG EXTENSION",2,"Con01",1540,1580,1650,1550,1560,1600,0.026,-40,1580,"Con",-40,100,FALSE,TRUE,FALSE,2.5,"young",33,164,105,"f"
12,"LEG EXTENSION",2,"Con02",1440,1480,1400,1400,1460,1400,0.041,60,1430,"Con",-40,0,FALSE,TRUE,FALSE,4.29,"young",33,164,105,"f"
12,"LEG EXTENSION",2,"Con03",1120,1140,1100,1150,1130,1125,0.004,5,1127.5,"Con",-20,-50,FALSE,FALSE,FALSE,0.44,"young",33,164,105,"f"
12,"LEG EXTENSION",2,"Con04",1080,1080,1100,1100,1080,1100,0.019,-20,1090,"Con",0,0,FALSE,FALSE,FALSE,1.82,"young",33,164,105,"f"
12,"LEG EXTENSION",2,"Con05",1160,1180,1250,1200,1170,1225,0.047,-55,1197.5,"Con",-20,50,FALSE,FALSE,FALSE,4.49,"young",33,164,105,"f"
12,"LEG EXTENSION",2,"Con06",1260,1300,1350,1250,1280,1300,0.016,-20,1290,"Con",-40,100,FALSE,TRUE,FALSE,1.54,"young",33,164,105,"f"
12,"LEG EXTENSION",2,"Con07",1480,1480,1600,1450,1480,1525,0.03,-45,1502.5,"Con",0,150,FALSE,FALSE,FALSE,2.95,"young",33,164,105,"f"
12,"LEG EXTENSION",2,"Con08",1060,1060,1350,1600,1060,1475,0.392,-415,1267.5,"Con",0,-250,TRUE,FALSE,TRUE,28.14,"young",33,164,105,"f"
12,"LEG EXTENSION",2,"Con09",1020,1040,1550,1550,1030,1550,0.505,-520,1290,"Con",-20,0,TRUE,FALSE,FALSE,33.55,"young",33,164,105,"f"
12,"LEG EXTENSION",2,"Con10",1160,1160,1350,1500,1160,1425,0.228,-265,1292.5,"Con",0,-150,TRUE,FALSE,FALSE,18.6,"young",33,164,105,"f"
12,"LEG EXTENSION",1,"Ecc01",2240,2300,2300,2250,2270,2275,0.002,-5,2272.5,"Ecc",-60,50,FALSE,TRUE,FALSE,0.22,"young",33,164,105,"f"
12,"LEG EXTENSION",1,"Ecc02",2480,2460,2500,2500,2470,2500,0.012,-30,2485,"Ecc",20,0,FALSE,FALSE,FALSE,1.2,"young",33,164,105,"f"
12,"LEG EXTENSION",1,"Ecc03",1880,1880,1950,2000,1880,1975,0.051,-95,1927.5,"Ecc",0,-50,FALSE,FALSE,FALSE,4.81,"young",33,164,105,"f"
12,"LEG EXTENSION",1,"Ecc04",2020,2020,2000,2050,2020,2025,0.002,-5,2022.5,"Ecc",0,-50,FALSE,FALSE,FALSE,0.25,"young",33,164,105,"f"
12,"LEG EXTENSION",1,"Ecc05",2360,2360,1900,1950,2360,1925,0.184,435,2142.5,"Ecc",0,-50,TRUE,FALSE,FALSE,22.6,"young",33,164,105,"f"
12,"LEG EXTENSION",1,"Ecc06",2180,2180,1800,1850,2180,1825,0.163,355,2002.5,"Ecc",0,-50,TRUE,FALSE,FALSE,19.45,"young",33,164,105,"f"
12,"LEG EXTENSION",1,"Ecc07",2200,2260,1600,1600,2230,1600,0.283,630,1915,"Ecc",-60,0,TRUE,TRUE,FALSE,39.38,"young",33,164,105,"f"
12,"LEG EXTENSION",1,"Ecc08",2200,2220,1750,1600,2210,1675,0.242,535,1942.5,"Ecc",-20,150,TRUE,FALSE,FALSE,31.94,"young",33,164,105,"f"
12,"LEG EXTENSION",1,"Ecc09",1960,1960,1550,1400,1960,1475,0.247,485,1717.5,"Ecc",0,150,TRUE,FALSE,FALSE,32.88,"young",33,164,105,"f"
12,"LEG EXTENSION",1,"Ecc10",1780,1780,1800,1800,1780,1800,0.011,-20,1790,"Ecc",0,0,FALSE,FALSE,FALSE,1.11,"young",33,164,105,"f"
12,"LEG EXTENSION",2,"Ecc01",1960,1940,2000,2000,1950,2000,0.026,-50,1975,"Ecc",20,0,FALSE,FALSE,FALSE,2.5,"young",33,164,105,"f"
12,"LEG EXTENSION",2,"Ecc02",2360,2320,2350,2350,2340,2350,0.004,-10,2345,"Ecc",40,0,FALSE,TRUE,FALSE,0.43,"young",33,164,105,"f"
12,"LEG EXTENSION",2,"Ecc03",1840,1840,1850,1800,1840,1825,0.008,15,1832.5,"Ecc",0,50,FALSE,FALSE,FALSE,0.82,"young",33,164,105,"f"
12,"LEG EXTENSION",2,"Ecc04",2080,2060,2000,2050,2070,2025,0.022,45,2047.5,"Ecc",20,-50,FALSE,FALSE,FALSE,2.22,"young",33,164,105,"f"
12,"LEG EXTENSION",2,"Ecc05",1560,1540,1500,1600,1550,1550,0,0,1550,"Ecc",20,-100,FALSE,FALSE,FALSE,0,"young",33,164,105,"f"
12,"LEG EXTENSION",2,"Ecc06",1480,1460,1350,1500,1470,1425,0.031,45,1447.5,"Ecc",20,-150,FALSE,FALSE,FALSE,3.16,"young",33,164,105,"f"
12,"LEG EXTENSION",2,"Ecc07",1980,1980,1650,1450,1980,1550,0.217,430,1765,"Ecc",0,200,TRUE,FALSE,TRUE,27.74,"young",33,164,105,"f"
12,"LEG EXTENSION",2,"Ecc08",1940,1920,1450,1400,1930,1425,0.262,505,1677.5,"Ecc",20,50,TRUE,FALSE,FALSE,35.44,"young",33,164,105,"f"
12,"LEG EXTENSION",2,"Ecc09",1820,1820,1600,1500,1820,1550,0.148,270,1685,"Ecc",0,100,TRUE,FALSE,FALSE,17.42,"young",33,164,105,"f"
12,"LEG EXTENSION",2,"Ecc10",1420,1440,1450,1450,1430,1450,0.014,-20,1440,"Ecc",-20,0,FALSE,FALSE,FALSE,1.38,"young",33,164,105,"f"
12,"LEG EXTENSION",1,"Rep01",3660,3740,3900,3900,3700,3900,0.054,-200,3800,"Rep",-80,0,TRUE,TRUE,FALSE,5.13,"young",33,164,105,"f"
12,"LEG EXTENSION",1,"Rep02",3760,3700,3650,3750,3730,3700,0.008,30,3715,"Rep",60,-100,FALSE,FALSE,FALSE,0.81,"young",33,164,105,"f"
12,"LEG EXTENSION",1,"Rep03",3060,3080,3150,3150,3070,3150,0.026,-80,3110,"Rep",-20,0,FALSE,FALSE,FALSE,2.54,"young",33,164,105,"f"
12,"LEG EXTENSION",1,"Rep04",3300,3280,3200,3200,3290,3200,0.027,90,3245,"Rep",20,0,FALSE,FALSE,FALSE,2.81,"young",33,164,105,"f"
12,"LEG EXTENSION",1,"Rep05",3640,3640,3200,3200,3640,3200,0.121,440,3420,"Rep",0,0,TRUE,FALSE,FALSE,13.75,"young",33,164,105,"f"
12,"LEG EXTENSION",1,"Rep06",3420,3420,3550,3550,3420,3550,0.038,-130,3485,"Rep",0,0,TRUE,FALSE,FALSE,3.66,"young",33,164,105,"f"
12,"LEG EXTENSION",1,"Rep07",3280,3340,3100,3050,3310,3075,0.071,235,3192.5,"Rep",-60,50,TRUE,FALSE,FALSE,7.64,"young",33,164,105,"f"
12,"LEG EXTENSION",1,"Rep08",3400,3360,3500,3400,3380,3450,0.021,-70,3415,"Rep",40,100,FALSE,FALSE,FALSE,2.03,"young",33,164,105,"f"
12,"LEG EXTENSION",1,"Rep09",3300,3280,3350,3300,3290,3325,0.011,-35,3307.5,"Rep",20,50,FALSE,FALSE,FALSE,1.05,"young",33,164,105,"f"
12,"LEG EXTENSION",1,"Rep10",2880,2880,3300,3450,2880,3375,0.172,-495,3127.5,"Rep",0,-150,TRUE,FALSE,FALSE,14.67,"young",33,164,105,"f"
12,"LEG EXTENSION",2,"Rep01",3500,3520,3650,3550,3510,3600,0.026,-90,3555,"Rep",-20,100,FALSE,FALSE,FALSE,2.5,"young",33,164,105,"f"
12,"LEG EXTENSION",2,"Rep02",3800,3800,3750,3750,3800,3750,0.013,50,3775,"Rep",0,0,FALSE,FALSE,FALSE,1.33,"young",33,164,105,"f"
12,"LEG EXTENSION",2,"Rep03",2960,2980,2950,2950,2970,2950,0.007,20,2960,"Rep",-20,0,FALSE,FALSE,FALSE,0.68,"young",33,164,105,"f"
12,"LEG EXTENSION",2,"Rep04",3160,3140,3100,3150,3150,3125,0.008,25,3137.5,"Rep",20,-50,FALSE,FALSE,FALSE,0.8,"young",33,164,105,"f"
12,"LEG EXTENSION",2,"Rep05",2720,2720,2750,2800,2720,2775,0.02,-55,2747.5,"Rep",0,-50,FALSE,FALSE,FALSE,1.98,"young",33,164,105,"f"
12,"LEG EXTENSION",2,"Rep06",2740,2760,2700,2750,2750,2725,0.009,25,2737.5,"Rep",-20,-50,FALSE,FALSE,FALSE,0.92,"young",33,164,105,"f"
12,"LEG EXTENSION",2,"Rep07",3460,3460,3250,2900,3460,3075,0.111,385,3267.5,"Rep",0,350,TRUE,FALSE,TRUE,12.52,"young",33,164,105,"f"
12,"LEG EXTENSION",2,"Rep08",3000,2980,2800,3000,2990,2900,0.03,90,2945,"Rep",20,-200,FALSE,FALSE,TRUE,3.1,"young",33,164,105,"f"
12,"LEG EXTENSION",2,"Rep09",2840,2860,3150,3050,2850,3100,0.088,-250,2975,"Rep",-20,100,TRUE,FALSE,FALSE,8.06,"young",33,164,105,"f"
12,"LEG EXTENSION",2,"Rep10",2580,2600,2800,2950,2590,2875,0.11,-285,2732.5,"Rep",-20,-150,TRUE,FALSE,FALSE,9.91,"young",33,164,105,"f"
12,"LEG EXTENSION",1,"TuT",33700,33720,33900,33950,33710,33925,0.006,-215,33817.5,"TuT",-20,-50,TRUE,FALSE,FALSE,0.63,"young",33,164,105,"f"
12,"LEG EXTENSION",2,"TuT",30760,30820,30900,30850,30790,30875,0.003,-85,30832.5,"TuT",-60,50,FALSE,FALSE,FALSE,0.28,"young",33,164,105,"f"
12,"LEG CURL",1,"Con01",2100,2140,2150,2150,2120,2150,0.014,-30,2135,"Con",-40,0,FALSE,FALSE,FALSE,1.4,"young",33,164,105,"f"
12,"LEG CURL",1,"Con02",1780,1800,1850,1850,1790,1850,0.034,-60,1820,"Con",-20,0,FALSE,FALSE,FALSE,3.24,"young",33,164,105,"f"
12,"LEG CURL",1,"Con03",1800,1760,1700,1750,1780,1725,0.031,55,1752.5,"Con",40,-50,FALSE,FALSE,FALSE,3.19,"young",33,164,105,"f"
12,"LEG CURL",1,"Con04",1560,1580,1650,1600,1570,1625,0.035,-55,1597.5,"Con",-20,50,FALSE,FALSE,FALSE,3.38,"young",33,164,105,"f"
12,"LEG CURL",1,"Con05",1820,1820,1650,1550,1820,1600,0.121,220,1710,"Con",0,100,FALSE,FALSE,FALSE,13.75,"young",33,164,105,"f"
12,"LEG CURL",1,"Con06",1320,1360,1500,1550,1340,1525,0.138,-185,1432.5,"Con",-40,-50,FALSE,FALSE,FALSE,12.13,"young",33,164,105,"f"
12,"LEG CURL",1,"Con07",1360,1320,1500,1600,1340,1550,0.157,-210,1445,"Con",40,-100,FALSE,FALSE,FALSE,13.55,"young",33,164,105,"f"
12,"LEG CURL",1,"Con08",1620,1600,1850,1850,1610,1850,0.149,-240,1730,"Con",20,0,TRUE,FALSE,FALSE,12.97,"young",33,164,105,"f"
12,"LEG CURL",1,"Con09",1280,1280,1800,1850,1280,1825,0.426,-545,1552.5,"Con",0,-50,TRUE,FALSE,FALSE,29.86,"young",33,164,105,"f"
12,"LEG CURL",1,"Con10",1580,1540,1850,1850,1560,1850,0.186,-290,1705,"Con",40,0,TRUE,FALSE,FALSE,15.68,"young",33,164,105,"f"
12,"LEG CURL",2,"Con01",1980,1960,2000,2050,1970,2025,0.028,-55,1997.5,"Con",20,-50,FALSE,FALSE,FALSE,2.72,"young",33,164,105,"f"
12,"LEG CURL",2,"Con02",1700,1700,1650,1600,1700,1625,0.044,75,1662.5,"Con",0,50,FALSE,FALSE,FALSE,4.62,"young",33,164,105,"f"
12,"LEG CURL",2,"Con03",1840,1860,1850,1800,1850,1825,0.014,25,1837.5,"Con",-20,50,FALSE,FALSE,FALSE,1.37,"young",33,164,105,"f"
12,"LEG CURL",2,"Con04",1700,1740,1700,1700,1720,1700,0.012,20,1710,"Con",-40,0,FALSE,FALSE,FALSE,1.18,"young",33,164,105,"f"
12,"LEG CURL",2,"Con05",1340,1360,1500,1500,1350,1500,0.111,-150,1425,"Con",-20,0,FALSE,FALSE,FALSE,10,"young",33,164,105,"f"
12,"LEG CURL",2,"Con06",1420,1360,1500,1550,1390,1525,0.097,-135,1457.5,"Con",60,-50,FALSE,FALSE,FALSE,8.85,"young",33,164,105,"f"
12,"LEG CURL",2,"Con07",1480,1480,1600,1550,1480,1575,0.064,-95,1527.5,"Con",0,50,FALSE,FALSE,FALSE,6.03,"young",33,164,105,"f"
12,"LEG CURL",2,"Con08",1340,1340,1650,1650,1340,1650,0.231,-310,1495,"Con",0,0,TRUE,FALSE,FALSE,18.79,"young",33,164,105,"f"
12,"LEG CURL",2,"Con09",1380,1360,1450,1550,1370,1500,0.095,-130,1435,"Con",20,-100,FALSE,FALSE,FALSE,8.67,"young",33,164,105,"f"
12,"LEG CURL",2,"Con10",1340,1320,1550,1650,1330,1600,0.203,-270,1465,"Con",20,-100,TRUE,FALSE,FALSE,16.88,"young",33,164,105,"f"
12,"LEG CURL",1,"Ecc01",3020,3020,2950,2950,3020,2950,0.023,70,2985,"Ecc",0,0,FALSE,FALSE,FALSE,2.37,"young",33,164,105,"f"
12,"LEG CURL",1,"Ecc02",2880,2880,2950,2850,2880,2900,0.007,-20,2890,"Ecc",0,100,FALSE,FALSE,FALSE,0.69,"young",33,164,105,"f"
12,"LEG CURL",1,"Ecc03",2640,2640,2550,2600,2640,2575,0.025,65,2607.5,"Ecc",0,-50,FALSE,FALSE,FALSE,2.52,"young",33,164,105,"f"
12,"LEG CURL",1,"Ecc04",1820,1820,2000,2150,1820,2075,0.14,-255,1947.5,"Ecc",0,-150,TRUE,FALSE,FALSE,12.29,"young",33,164,105,"f"
12,"LEG CURL",1,"Ecc05",2500,2480,2350,2300,2490,2325,0.066,165,2407.5,"Ecc",20,50,FALSE,FALSE,FALSE,7.1,"young",33,164,105,"f"
12,"LEG CURL",1,"Ecc06",2480,2480,2300,2200,2480,2250,0.093,230,2365,"Ecc",0,100,TRUE,FALSE,FALSE,10.22,"young",33,164,105,"f"
12,"LEG CURL",1,"Ecc07",2240,2280,2050,2050,2260,2050,0.093,210,2155,"Ecc",-40,0,FALSE,FALSE,FALSE,10.24,"young",33,164,105,"f"
12,"LEG CURL",1,"Ecc08",2480,2480,1950,1850,2480,1900,0.234,580,2190,"Ecc",0,100,TRUE,FALSE,FALSE,30.53,"young",33,164,105,"f"
12,"LEG CURL",1,"Ecc09",2020,2060,1800,1800,2040,1800,0.118,240,1920,"Ecc",-40,0,TRUE,FALSE,FALSE,13.33,"young",33,164,105,"f"
12,"LEG CURL",1,"Ecc10",3080,3080,3000,3050,3080,3025,0.018,55,3052.5,"Ecc",0,-50,FALSE,FALSE,FALSE,1.82,"young",33,164,105,"f"
12,"LEG CURL",2,"Ecc01",2740,2740,2850,2850,2740,2850,0.04,-110,2795,"Ecc",0,0,FALSE,FALSE,FALSE,3.86,"young",33,164,105,"f"
12,"LEG CURL",2,"Ecc02",2360,2340,2350,2400,2350,2375,0.011,-25,2362.5,"Ecc",20,-50,FALSE,FALSE,FALSE,1.05,"young",33,164,105,"f"
12,"LEG CURL",2,"Ecc03",2240,2220,2250,2250,2230,2250,0.009,-20,2240,"Ecc",20,0,FALSE,FALSE,FALSE,0.89,"young",33,164,105,"f"
12,"LEG CURL",2,"Ecc04",2520,2480,2350,2350,2500,2350,0.06,150,2425,"Ecc",40,0,FALSE,FALSE,FALSE,6.38,"young",33,164,105,"f"
12,"LEG CURL",2,"Ecc05",2240,2280,2150,2100,2260,2125,0.06,135,2192.5,"Ecc",-40,50,FALSE,FALSE,FALSE,6.35,"young",33,164,105,"f"
12,"LEG CURL",2,"Ecc06",2480,2480,2350,2400,2480,2375,0.042,105,2427.5,"Ecc",0,-50,FALSE,FALSE,FALSE,4.42,"young",33,164,105,"f"
12,"LEG CURL",2,"Ecc07",2180,2180,1850,1850,2180,1850,0.151,330,2015,"Ecc",0,0,TRUE,FALSE,FALSE,17.84,"young",33,164,105,"f"
12,"LEG CURL",2,"Ecc08",2080,2100,2000,1950,2090,1975,0.055,115,2032.5,"Ecc",-20,50,FALSE,FALSE,FALSE,5.82,"young",33,164,105,"f"
12,"LEG CURL",2,"Ecc09",2020,2080,1900,1750,2050,1825,0.11,225,1937.5,"Ecc",-60,150,FALSE,FALSE,FALSE,12.33,"young",33,164,105,"f"
12,"LEG CURL",2,"Ecc10",2540,2540,2500,2500,2540,2500,0.016,40,2520,"Ecc",0,0,FALSE,FALSE,FALSE,1.6,"young",33,164,105,"f"
12,"LEG CURL",1,"Rep01",5120,5160,5100,5100,5140,5100,0.008,40,5120,"Rep",-40,0,FALSE,FALSE,FALSE,0.78,"young",33,164,105,"f"
12,"LEG CURL",1,"Rep02",4660,4680,4800,4700,4670,4750,0.017,-80,4710,"Rep",-20,100,FALSE,FALSE,FALSE,1.68,"young",33,164,105,"f"
12,"LEG CURL",1,"Rep03",4440,4400,4250,4350,4420,4300,0.027,120,4360,"Rep",40,-100,FALSE,FALSE,FALSE,2.79,"young",33,164,105,"f"
12,"LEG CURL",1,"Rep04",3380,3400,3650,3750,3390,3700,0.091,-310,3545,"Rep",-20,-100,TRUE,FALSE,FALSE,8.38,"young",33,164,105,"f"
12,"LEG CURL",1,"Rep05",4320,4300,4000,3850,4310,3925,0.089,385,4117.5,"Rep",20,150,TRUE,FALSE,FALSE,9.81,"young",33,164,105,"f"
12,"LEG CURL",1,"Rep06",3800,3840,3800,3750,3820,3775,0.012,45,3797.5,"Rep",-40,50,FALSE,FALSE,FALSE,1.19,"young",33,164,105,"f"
12,"LEG CURL",1,"Rep07",3600,3600,3550,3650,3600,3600,0,0,3600,"Rep",0,-100,FALSE,FALSE,FALSE,0,"young",33,164,105,"f"
12,"LEG CURL",1,"Rep08",4100,4080,3800,3700,4090,3750,0.083,340,3920,"Rep",20,100,TRUE,FALSE,FALSE,9.07,"young",33,164,105,"f"
12,"LEG CURL",1,"Rep09",3300,3340,3600,3650,3320,3625,0.092,-305,3472.5,"Rep",-40,-50,TRUE,FALSE,FALSE,8.41,"young",33,164,105,"f"
12,"LEG CURL",1,"Rep10",4660,4620,4850,4900,4640,4875,0.051,-235,4757.5,"Rep",40,-50,TRUE,FALSE,FALSE,4.82,"young",33,164,105,"f"
12,"LEG CURL",2,"Rep01",4720,4700,4850,4900,4710,4875,0.035,-165,4792.5,"Rep",20,-50,TRUE,FALSE,FALSE,3.38,"young",33,164,105,"f"
12,"LEG CURL",2,"Rep02",4060,4040,4000,4000,4050,4000,0.012,50,4025,"Rep",20,0,FALSE,FALSE,FALSE,1.25,"young",33,164,105,"f"
12,"LEG CURL",2,"Rep03",4080,4080,4100,4050,4080,4075,0.001,5,4077.5,"Rep",0,50,FALSE,FALSE,FALSE,0.12,"young",33,164,105,"f"
12,"LEG CURL",2,"Rep04",4220,4220,4050,4050,4220,4050,0.04,170,4135,"Rep",0,0,TRUE,FALSE,FALSE,4.2,"young",33,164,105,"f"
12,"LEG CURL",2,"Rep05",3580,3640,3650,3600,3610,3625,0.004,-15,3617.5,"Rep",-60,50,FALSE,FALSE,FALSE,0.41,"young",33,164,105,"f"
12,"LEG CURL",2,"Rep06",3900,3840,3850,3950,3870,3900,0.008,-30,3885,"Rep",60,-100,FALSE,FALSE,FALSE,0.77,"young",33,164,105,"f"
12,"LEG CURL",2,"Rep07",3660,3660,3450,3400,3660,3425,0.064,235,3542.5,"Rep",0,50,TRUE,FALSE,FALSE,6.86,"young",33,164,105,"f"
12,"LEG CURL",2,"Rep08",3420,3440,3650,3600,3430,3625,0.057,-195,3527.5,"Rep",-20,50,TRUE,FALSE,FALSE,5.38,"young",33,164,105,"f"
12,"LEG CURL",2,"Rep09",3400,3440,3350,3300,3420,3325,0.028,95,3372.5,"Rep",-40,50,FALSE,FALSE,FALSE,2.86,"young",33,164,105,"f"
12,"LEG CURL",2,"Rep10",3880,3860,4050,4150,3870,4100,0.059,-230,3985,"Rep",20,-100,TRUE,FALSE,FALSE,5.61,"young",33,164,105,"f"
12,"LEG CURL",1,"TuT",41380,41420,41400,41400,41400,41400,0,0,41400,"TuT",-40,0,FALSE,TRUE,FALSE,0,"young",33,164,105,"f"
12,"LEG CURL",2,"TuT",38920,38920,39000,39000,38920,39000,0.002,-80,38960,"TuT",0,0,FALSE,FALSE,FALSE,0.21,"young",33,164,105,"f"
12,"ABDUCTOR",1,"Con01",960,980,1000,1300,970,1150,0.186,-180,1060,"Con",-20,-300,FALSE,FALSE,TRUE,15.65,"young",33,164,105,"f"
12,"ABDUCTOR",1,"Con02",1240,1240,1550,1250,1240,1400,0.129,-160,1320,"Con",0,300,FALSE,FALSE,TRUE,11.43,"young",33,164,105,"f"
12,"ABDUCTOR",1,"Con03",1060,1080,1450,1100,1070,1275,0.192,-205,1172.5,"Con",-20,350,FALSE,FALSE,TRUE,16.08,"young",33,164,105,"f"
12,"ABDUCTOR",1,"Con04",1140,1120,1650,1250,1130,1450,0.283,-320,1290,"Con",20,400,TRUE,FALSE,TRUE,22.07,"young",33,164,105,"f"
12,"ABDUCTOR",1,"Con05",1120,1100,1400,1350,1110,1375,0.239,-265,1242.5,"Con",20,50,FALSE,FALSE,FALSE,19.27,"young",33,164,105,"f"
12,"ABDUCTOR",1,"Con06",1080,1080,1300,1400,1080,1350,0.25,-270,1215,"Con",0,-100,FALSE,FALSE,FALSE,20,"young",33,164,105,"f"
12,"ABDUCTOR",1,"Con07",1320,1300,1350,1550,1310,1450,0.107,-140,1380,"Con",20,-200,FALSE,FALSE,FALSE,9.66,"young",33,164,105,"f"
12,"ABDUCTOR",1,"Con08",1000,1040,1200,1600,1020,1400,0.373,-380,1210,"Con",-40,-400,TRUE,TRUE,TRUE,27.14,"young",33,164,105,"f"
12,"ABDUCTOR",1,"Con09",1140,1120,1250,1550,1130,1400,0.239,-270,1265,"Con",20,-300,FALSE,FALSE,TRUE,19.29,"young",33,164,105,"f"
12,"ABDUCTOR",1,"Con10",1000,1000,1250,1650,1000,1450,0.45,-450,1225,"Con",0,-400,TRUE,FALSE,TRUE,31.03,"young",33,164,105,"f"
12,"ABDUCTOR",2,"Con01",1100,1100,1250,1300,1100,1275,0.159,-175,1187.5,"Con",0,-50,FALSE,FALSE,FALSE,13.73,"young",33,164,105,"f"
12,"ABDUCTOR",2,"Con02",1440,1460,1850,1400,1450,1625,0.121,-175,1537.5,"Con",-20,450,FALSE,FALSE,TRUE,10.77,"young",33,164,105,"f"
12,"ABDUCTOR",2,"Con03",1160,1160,1400,1250,1160,1325,0.142,-165,1242.5,"Con",0,150,FALSE,FALSE,FALSE,12.45,"young",33,164,105,"f"
12,"ABDUCTOR",2,"Con04",1260,1240,1350,1150,1250,1250,0,0,1250,"Con",20,200,FALSE,FALSE,FALSE,0,"young",33,164,105,"f"
12,"ABDUCTOR",2,"Con05",920,960,1200,1150,940,1175,0.25,-235,1057.5,"Con",-40,50,FALSE,TRUE,FALSE,20,"young",33,164,105,"f"
12,"ABDUCTOR",2,"Con06",1100,1060,1250,1250,1080,1250,0.157,-170,1165,"Con",40,0,FALSE,TRUE,FALSE,13.6,"young",33,164,105,"f"
12,"ABDUCTOR",2,"Con07",1000,1020,1150,1200,1010,1175,0.163,-165,1092.5,"Con",-20,-50,FALSE,FALSE,FALSE,14.04,"young",33,164,105,"f"
12,"ABDUCTOR",2,"Con08",1020,1000,1150,1150,1010,1150,0.139,-140,1080,"Con",20,0,FALSE,FALSE,FALSE,12.17,"young",33,164,105,"f"
12,"ABDUCTOR",2,"Con09",980,980,1300,1400,980,1350,0.378,-370,1165,"Con",0,-100,TRUE,FALSE,FALSE,27.41,"young",33,164,105,"f"
12,"ABDUCTOR",2,"Con10",1040,1020,1500,1850,1030,1675,0.626,-645,1352.5,"Con",20,-350,TRUE,FALSE,TRUE,38.51,"young",33,164,105,"f"
12,"ABDUCTOR",1,"Ecc01",2240,2220,2000,2150,2230,2075,0.07,155,2152.5,"Ecc",20,-150,FALSE,FALSE,FALSE,7.47,"young",33,164,105,"f"
12,"ABDUCTOR",1,"Ecc02",2120,2100,1750,2150,2110,1950,0.076,160,2030,"Ecc",20,-400,FALSE,FALSE,TRUE,8.21,"young",33,164,105,"f"
12,"ABDUCTOR",1,"Ecc03",2680,2680,2200,2600,2680,2400,0.104,280,2540,"Ecc",0,-400,FALSE,FALSE,TRUE,11.67,"young",33,164,105,"f"
12,"ABDUCTOR",1,"Ecc04",2680,2700,2350,2450,2690,2400,0.108,290,2545,"Ecc",-20,-100,FALSE,FALSE,FALSE,12.08,"young",33,164,105,"f"
12,"ABDUCTOR",1,"Ecc05",2880,2880,2650,2550,2880,2600,0.097,280,2740,"Ecc",0,100,FALSE,FALSE,FALSE,10.77,"young",33,164,105,"f"
12,"ABDUCTOR",1,"Ecc06",2680,2720,2600,2450,2700,2525,0.065,175,2612.5,"Ecc",-40,150,FALSE,TRUE,FALSE,6.93,"young",33,164,105,"f"
12,"ABDUCTOR",1,"Ecc07",2580,2540,2400,2000,2560,2200,0.141,360,2380,"Ecc",40,400,TRUE,TRUE,TRUE,16.36,"young",33,164,105,"f"
12,"ABDUCTOR",1,"Ecc08",2360,2400,2300,1950,2380,2125,0.107,255,2252.5,"Ecc",-40,350,FALSE,TRUE,TRUE,12,"young",33,164,105,"f"
12,"ABDUCTOR",1,"Ecc09",2580,2560,2350,1950,2570,2150,0.163,420,2360,"Ecc",20,400,TRUE,FALSE,TRUE,19.53,"young",33,164,105,"f"
12,"ABDUCTOR",1,"Ecc10",2600,2600,2500,2500,2600,2500,0.038,100,2550,"Ecc",0,0,FALSE,FALSE,FALSE,4,"young",33,164,105,"f"
12,"ABDUCTOR",2,"Ecc01",2320,2320,1950,2300,2320,2125,0.084,195,2222.5,"Ecc",0,-350,FALSE,FALSE,TRUE,9.18,"young",33,164,105,"f"
12,"ABDUCTOR",2,"Ecc02",2620,2600,2400,2600,2610,2500,0.042,110,2555,"Ecc",20,-200,FALSE,FALSE,FALSE,4.4,"young",33,164,105,"f"
12,"ABDUCTOR",2,"Ecc03",2400,2400,2300,2500,2400,2400,0,0,2400,"Ecc",0,-200,FALSE,FALSE,FALSE,0,"young",33,164,105,"f"
12,"ABDUCTOR",2,"Ecc04",2500,2480,2200,2250,2490,2225,0.106,265,2357.5,"Ecc",20,-50,FALSE,FALSE,FALSE,11.91,"young",33,164,105,"f"
12,"ABDUCTOR",2,"Ecc05",2400,2420,2250,2250,2410,2250,0.066,160,2330,"Ecc",-20,0,FALSE,FALSE,FALSE,7.11,"young",33,164,105,"f"
12,"ABDUCTOR",2,"Ecc06",2420,2460,2300,2250,2440,2275,0.068,165,2357.5,"Ecc",-40,50,FALSE,TRUE,FALSE,7.25,"young",33,164,105,"f"
12,"ABDUCTOR",2,"Ecc07",2040,2020,1900,1900,2030,1900,0.064,130,1965,"Ecc",20,0,FALSE,FALSE,FALSE,6.84,"young",33,164,105,"f"
12,"ABDUCTOR",2,"Ecc08",2140,2140,1850,1750,2140,1800,0.159,340,1970,"Ecc",0,100,TRUE,FALSE,FALSE,18.89,"young",33,164,105,"f"
12,"ABDUCTOR",2,"Ecc09",2260,2260,1750,1450,2260,1600,0.292,660,1930,"Ecc",0,300,TRUE,FALSE,FALSE,41.25,"young",33,164,105,"f"
12,"ABDUCTOR",2,"Ecc10",1800,1800,1800,1750,1800,1775,0.014,25,1787.5,"Ecc",0,50,FALSE,FALSE,FALSE,1.41,"young",33,164,105,"f"
12,"ABDUCTOR",1,"Rep01",3200,3200,3000,3450,3200,3225,0.008,-25,3212.5,"Rep",0,-450,FALSE,FALSE,TRUE,0.78,"young",33,164,105,"f"
12,"ABDUCTOR",1,"Rep02",3360,3340,3300,3400,3350,3350,0,0,3350,"Rep",20,-100,FALSE,FALSE,FALSE,0,"young",33,164,105,"f"
12,"ABDUCTOR",1,"Rep03",3740,3760,3650,3700,3750,3675,0.02,75,3712.5,"Rep",-20,-50,FALSE,FALSE,FALSE,2.04,"young",33,164,105,"f"
12,"ABDUCTOR",1,"Rep04",3820,3820,4000,3700,3820,3850,0.008,-30,3835,"Rep",0,300,FALSE,FALSE,FALSE,0.78,"young",33,164,105,"f"
12,"ABDUCTOR",1,"Rep05",4000,3980,4050,3900,3990,3975,0.004,15,3982.5,"Rep",20,150,FALSE,FALSE,FALSE,0.38,"young",33,164,105,"f"
12,"ABDUCTOR",1,"Rep06",3760,3800,3900,3850,3780,3875,0.025,-95,3827.5,"Rep",-40,50,FALSE,FALSE,FALSE,2.45,"young",33,164,105,"f"
12,"ABDUCTOR",1,"Rep07",3900,3840,3750,3550,3870,3650,0.057,220,3760,"Rep",60,200,FALSE,FALSE,FALSE,6.03,"young",33,164,105,"f"
12,"ABDUCTOR",1,"Rep08",3360,3440,3500,3550,3400,3525,0.037,-125,3462.5,"Rep",-80,-50,FALSE,TRUE,FALSE,3.55,"young",33,164,105,"f"
12,"ABDUCTOR",1,"Rep09",3720,3680,3600,3500,3700,3550,0.041,150,3625,"Rep",40,100,FALSE,FALSE,FALSE,4.23,"young",33,164,105,"f"
12,"ABDUCTOR",1,"Rep10",3600,3600,3750,4150,3600,3950,0.097,-350,3775,"Rep",0,-400,TRUE,FALSE,TRUE,8.86,"young",33,164,105,"f"
12,"ABDUCTOR",2,"Rep01",3420,3420,3200,3600,3420,3400,0.006,20,3410,"Rep",0,-400,FALSE,FALSE,TRUE,0.59,"young",33,164,105,"f"
12,"ABDUCTOR",2,"Rep02",4060,4060,4250,4000,4060,4125,0.016,-65,4092.5,"Rep",0,250,FALSE,FALSE,FALSE,1.58,"young",33,164,105,"f"
12,"ABDUCTOR",2,"Rep03",3560,3560,3700,3750,3560,3725,0.046,-165,3642.5,"Rep",0,-50,FALSE,FALSE,FALSE,4.43,"young",33,164,105,"f"
12,"ABDUCTOR",2,"Rep04",3760,3720,3550,3400,3740,3475,0.071,265,3607.5,"Rep",40,150,FALSE,FALSE,FALSE,7.63,"young",33,164,105,"f"
12,"ABDUCTOR",2,"Rep05",3320,3380,3450,3400,3350,3425,0.022,-75,3387.5,"Rep",-60,50,FALSE,FALSE,FALSE,2.19,"young",33,164,105,"f"
12,"ABDUCTOR",2,"Rep06",3520,3520,3550,3500,3520,3525,0.001,-5,3522.5,"Rep",0,50,FALSE,FALSE,FALSE,0.14,"young",33,164,105,"f"
12,"ABDUCTOR",2,"Rep07",3040,3040,3050,3100,3040,3075,0.012,-35,3057.5,"Rep",0,-50,FALSE,FALSE,FALSE,1.14,"young",33,164,105,"f"
12,"ABDUCTOR",2,"Rep08",3160,3140,3000,2900,3150,2950,0.063,200,3050,"Rep",20,100,FALSE,FALSE,FALSE,6.78,"young",33,164,105,"f"
12,"ABDUCTOR",2,"Rep09",3240,3240,3050,2850,3240,2950,0.09,290,3095,"Rep",0,200,FALSE,FALSE,FALSE,9.83,"young",33,164,105,"f"
12,"ABDUCTOR",2,"Rep10",2840,2820,3300,3600,2830,3450,0.219,-620,3140,"Rep",20,-300,TRUE,FALSE,FALSE,17.97,"young",33,164,105,"f"
12,"ABDUCTOR",1,"TuT",36460,36460,36500,36750,36460,36625,0.005,-165,36542.5,"TuT",0,-250,FALSE,FALSE,FALSE,0.45,"young",33,164,105,"f"
12,"ABDUCTOR",2,"TuT",33920,33900,34100,34100,33910,34100,0.006,-190,34005,"TuT",20,0,FALSE,FALSE,FALSE,0.56,"young",33,164,105,"f"
12,"ADDUCTOR",1,"Con01",1300,1320,3450,3300,1310,3375,1.576,-2065,2342.5,"Con",-20,150,TRUE,FALSE,FALSE,61.19,"young",33,164,105,"f"
12,"ADDUCTOR",1,"Con02",1300,1300,1250,1850,1300,1550,0.192,-250,1425,"Con",0,-600,FALSE,FALSE,TRUE,16.13,"young",33,164,105,"f"
12,"ADDUCTOR",1,"Con03",1360,1340,1150,1450,1350,1300,0.037,50,1325,"Con",20,-300,FALSE,FALSE,FALSE,3.85,"young",33,164,105,"f"
12,"ADDUCTOR",1,"Con04",1420,1360,1250,1100,1390,1175,0.155,215,1282.5,"Con",60,150,FALSE,TRUE,FALSE,18.3,"young",33,164,105,"f"
12,"ADDUCTOR",1,"Con05",1460,1460,1800,1400,1460,1600,0.096,-140,1530,"Con",0,400,FALSE,FALSE,TRUE,8.75,"young",33,164,105,"f"
12,"ADDUCTOR",1,"Con06",1400,1400,2000,1800,1400,1900,0.357,-500,1650,"Con",0,200,FALSE,FALSE,FALSE,26.32,"young",33,164,105,"f"
12,"ADDUCTOR",1,"Con07",1120,1140,1650,1750,1130,1700,0.504,-570,1415,"Con",-20,-100,FALSE,FALSE,FALSE,33.53,"young",33,164,105,"f"
12,"ADDUCTOR",1,"Con08",1460,1460,1950,2000,1460,1975,0.353,-515,1717.5,"Con",0,-50,FALSE,FALSE,FALSE,26.08,"young",33,164,105,"f"
12,"ADDUCTOR",1,"Con09",1520,1520,2050,2100,1520,2075,0.365,-555,1797.5,"Con",0,-50,FALSE,FALSE,FALSE,26.75,"young",33,164,105,"f"
12,"ADDUCTOR",1,"Con10",1200,1180,2600,2600,1190,2600,1.185,-1410,1895,"Con",20,0,TRUE,FALSE,FALSE,54.23,"young",33,164,105,"f"
12,"ADDUCTOR",2,"Con01",1200,1200,1550,1500,1200,1525,0.271,-325,1362.5,"Con",0,50,FALSE,FALSE,FALSE,21.31,"young",33,164,105,"f"
12,"ADDUCTOR",2,"Con02",1540,1520,1850,1600,1530,1725,0.127,-195,1627.5,"Con",20,250,FALSE,FALSE,FALSE,11.3,"young",33,164,105,"f"
12,"ADDUCTOR",2,"Con03",1480,1500,1600,1600,1490,1600,0.074,-110,1545,"Con",-20,0,FALSE,FALSE,FALSE,6.88,"young",33,164,105,"f"
12,"ADDUCTOR",2,"Con04",1300,1240,1200,1150,1270,1175,0.075,95,1222.5,"Con",60,50,FALSE,TRUE,FALSE,8.09,"young",33,164,105,"f"
12,"ADDUCTOR",2,"Con05",1240,1240,1350,1150,1240,1250,0.008,-10,1245,"Con",0,200,FALSE,FALSE,FALSE,0.8,"young",33,164,105,"f"
12,"ADDUCTOR",2,"Con06",1240,1260,1550,1400,1250,1475,0.18,-225,1362.5,"Con",-20,150,FALSE,FALSE,FALSE,15.25,"young",33,164,105,"f"
12,"ADDUCTOR",2,"Con07",1240,1220,1700,1600,1230,1650,0.341,-420,1440,"Con",20,100,FALSE,FALSE,FALSE,25.45,"young",33,164,105,"f"
12,"ADDUCTOR",2,"Con08",1340,1300,1700,1800,1320,1750,0.326,-430,1535,"Con",40,-100,FALSE,TRUE,FALSE,24.57,"young",33,164,105,"f"
12,"ADDUCTOR",2,"Con09",1220,1180,1600,2100,1200,1850,0.542,-650,1525,"Con",40,-500,TRUE,TRUE,TRUE,35.14,"young",33,164,105,"f"
12,"ADDUCTOR",2,"Con10",1400,1420,2000,2700,1410,2350,0.667,-940,1880,"Con",-20,-700,TRUE,FALSE,TRUE,40,"young",33,164,105,"f"
12,"ADDUCTOR",1,"Ecc01",3560,3560,2100,1300,3560,1700,0.522,1860,2630,"Ecc",0,800,TRUE,FALSE,TRUE,109.41,"young",33,164,105,"f"
12,"ADDUCTOR",1,"Ecc02",3000,3020,3200,2650,3010,2925,0.028,85,2967.5,"Ecc",-20,550,FALSE,FALSE,TRUE,2.91,"young",33,164,105,"f"
12,"ADDUCTOR",1,"Ecc03",2960,3020,3200,3200,2990,3200,0.07,-210,3095,"Ecc",-60,0,FALSE,TRUE,FALSE,6.56,"young",33,164,105,"f"
12,"ADDUCTOR",1,"Ecc04",2900,2900,3000,3300,2900,3150,0.086,-250,3025,"Ecc",0,-300,FALSE,FALSE,FALSE,7.94,"young",33,164,105,"f"
12,"ADDUCTOR",1,"Ecc05",3120,3120,2300,2700,3120,2500,0.199,620,2810,"Ecc",0,-400,TRUE,FALSE,TRUE,24.8,"young",33,164,105,"f"
12,"ADDUCTOR",1,"Ecc06",2680,2680,2150,2150,2680,2150,0.198,530,2415,"Ecc",0,0,FALSE,FALSE,FALSE,24.65,"young",33,164,105,"f"
12,"ADDUCTOR",1,"Ecc07",2500,2480,2150,2050,2490,2100,0.157,390,2295,"Ecc",20,100,FALSE,FALSE,FALSE,18.57,"young",33,164,105,"f"
12,"ADDUCTOR",1,"Ecc08",2760,2760,2000,1900,2760,1950,0.293,810,2355,"Ecc",0,100,TRUE,FALSE,FALSE,41.54,"young",33,164,105,"f"
12,"ADDUCTOR",1,"Ecc09",2820,2840,1600,1600,2830,1600,0.435,1230,2215,"Ecc",-20,0,TRUE,FALSE,FALSE,76.88,"young",33,164,105,"f"
12,"ADDUCTOR",1,"Ecc10",3320,3320,1700,2950,3320,2325,0.3,995,2822.5,"Ecc",0,-1250,TRUE,FALSE,TRUE,42.8,"young",33,164,105,"f"
12,"ADDUCTOR",2,"Ecc01",2840,2860,2250,2450,2850,2350,0.175,500,2600,"Ecc",-20,-200,FALSE,FALSE,FALSE,21.28,"young",33,164,105,"f"
12,"ADDUCTOR",2,"Ecc02",2800,2800,2600,2700,2800,2650,0.054,150,2725,"Ecc",0,-100,FALSE,FALSE,FALSE,5.66,"young",33,164,105,"f"
12,"ADDUCTOR",2,"Ecc03",2300,2360,2400,2400,2330,2400,0.03,-70,2365,"Ecc",-60,0,FALSE,TRUE,FALSE,2.92,"young",33,164,105,"f"
12,"ADDUCTOR",2,"Ecc04",2580,2560,2550,2700,2570,2625,0.021,-55,2597.5,"Ecc",20,-150,FALSE,FALSE,FALSE,2.1,"young",33,164,105,"f"
12,"ADDUCTOR",2,"Ecc05",2340,2320,2150,2250,2330,2200,0.056,130,2265,"Ecc",20,-100,FALSE,FALSE,FALSE,5.91,"young",33,164,105,"f"
12,"ADDUCTOR",2,"Ecc06",2340,2360,1850,2100,2350,1975,0.16,375,2162.5,"Ecc",-20,-250,FALSE,FALSE,FALSE,18.99,"young",33,164,105,"f"
12,"ADDUCTOR",2,"Ecc07",2220,2240,1800,1750,2230,1775,0.204,455,2002.5,"Ecc",-20,50,FALSE,FALSE,FALSE,25.63,"young",33,164,105,"f"
12,"ADDUCTOR",2,"Ecc08",2300,2360,2050,1700,2330,1875,0.195,455,2102.5,"Ecc",-60,350,FALSE,TRUE,TRUE,24.27,"young",33,164,105,"f"
12,"ADDUCTOR",2,"Ecc09",2400,2380,1650,900,2390,1275,0.467,1115,1832.5,"Ecc",20,750,TRUE,FALSE,TRUE,87.45,"young",33,164,105,"f"
12,"ADDUCTOR",2,"Ecc10",2320,2320,2200,1100,2320,1650,0.289,670,1985,"Ecc",0,1100,TRUE,FALSE,TRUE,40.61,"young",33,164,105,"f"
12,"ADDUCTOR",1,"Rep01",4860,4880,5550,4600,4870,5075,0.042,-205,4972.5,"Rep",-20,950,FALSE,FALSE,TRUE,4.04,"young",33,164,105,"f"
12,"ADDUCTOR",1,"Rep02",4300,4320,4450,4500,4310,4475,0.038,-165,4392.5,"Rep",-20,-50,FALSE,FALSE,FALSE,3.69,"young",33,164,105,"f"
12,"ADDUCTOR",1,"Rep03",4320,4360,4350,4650,4340,4500,0.037,-160,4420,"Rep",-40,-300,FALSE,FALSE,TRUE,3.56,"young",33,164,105,"f"
12,"ADDUCTOR",1,"Rep04",4320,4260,4250,4400,4290,4325,0.008,-35,4307.5,"Rep",60,-150,FALSE,FALSE,FALSE,0.81,"young",33,164,105,"f"
12,"ADDUCTOR",1,"Rep05",4580,4580,4100,4100,4580,4100,0.105,480,4340,"Rep",0,0,TRUE,FALSE,FALSE,11.71,"young",33,164,105,"f"
12,"ADDUCTOR",1,"Rep06",4080,4080,4150,3950,4080,4050,0.007,30,4065,"Rep",0,200,FALSE,FALSE,FALSE,0.74,"young",33,164,105,"f"
12,"ADDUCTOR",1,"Rep07",3620,3620,3800,3800,3620,3800,0.05,-180,3710,"Rep",0,0,FALSE,FALSE,FALSE,4.74,"young",33,164,105,"f"
12,"ADDUCTOR",1,"Rep08",4220,4220,3950,3900,4220,3925,0.07,295,4072.5,"Rep",0,50,FALSE,FALSE,FALSE,7.52,"young",33,164,105,"f"
12,"ADDUCTOR",1,"Rep09",4340,4360,3650,3700,4350,3675,0.155,675,4012.5,"Rep",-20,-50,TRUE,FALSE,FALSE,18.37,"young",33,164,105,"f"
12,"ADDUCTOR",1,"Rep10",4520,4500,4300,5550,4510,4925,0.092,-415,4717.5,"Rep",20,-1250,TRUE,FALSE,TRUE,8.43,"young",33,164,105,"f"
12,"ADDUCTOR",2,"Rep01",4040,4060,3800,3950,4050,3875,0.043,175,3962.5,"Rep",-20,-150,FALSE,FALSE,FALSE,4.52,"young",33,164,105,"f"
12,"ADDUCTOR",2,"Rep02",4340,4320,4450,4300,4330,4375,0.01,-45,4352.5,"Rep",20,150,FALSE,FALSE,FALSE,1.03,"young",33,164,105,"f"
12,"ADDUCTOR",2,"Rep03",3780,3860,4000,4000,3820,4000,0.047,-180,3910,"Rep",-80,0,FALSE,TRUE,FALSE,4.5,"young",33,164,105,"f"
12,"ADDUCTOR",2,"Rep04",3880,3800,3750,3850,3840,3800,0.01,40,3820,"Rep",80,-100,FALSE,TRUE,FALSE,1.05,"young",33,164,105,"f"
12,"ADDUCTOR",2,"Rep05",3580,3560,3500,3400,3570,3450,0.034,120,3510,"Rep",20,100,FALSE,FALSE,FALSE,3.48,"young",33,164,105,"f"
12,"ADDUCTOR",2,"Rep06",3580,3620,3400,3500,3600,3450,0.042,150,3525,"Rep",-40,-100,FALSE,FALSE,FALSE,4.35,"young",33,164,105,"f"
12,"ADDUCTOR",2,"Rep07",3460,3460,3500,3350,3460,3425,0.01,35,3442.5,"Rep",0,150,FALSE,FALSE,FALSE,1.02,"young",33,164,105,"f"
12,"ADDUCTOR",2,"Rep08",3640,3660,3750,3500,3650,3625,0.007,25,3637.5,"Rep",-20,250,FALSE,FALSE,TRUE,0.69,"young",33,164,105,"f"
12,"ADDUCTOR",2,"Rep09",3620,3560,3250,3000,3590,3125,0.13,465,3357.5,"Rep",60,250,TRUE,FALSE,TRUE,14.88,"young",33,164,105,"f"
12,"ADDUCTOR",2,"Rep10",3720,3740,4200,3800,3730,4000,0.072,-270,3865,"Rep",-20,400,FALSE,FALSE,TRUE,6.75,"young",33,164,105,"f"
12,"ADDUCTOR",1,"TuT",43160,43180,42550,43150,43170,42850,0.007,320,43010,"TuT",-20,-600,FALSE,FALSE,TRUE,0.75,"young",33,164,105,"f"
12,"ADDUCTOR",2,"TuT",37640,37640,37600,36650,37640,37125,0.014,515,37382.5,"TuT",0,950,FALSE,FALSE,TRUE,1.39,"young",33,164,105,"f"
12,"LOWER BACK",1,"Con01",1840,1840,1900,1900,1840,1900,0.033,-60,1870,"Con",0,0,FALSE,FALSE,FALSE,3.16,"young",33,164,105,"f"
12,"LOWER BACK",1,"Con02",1820,1840,2000,2050,1830,2025,0.107,-195,1927.5,"Con",-20,-50,TRUE,FALSE,FALSE,9.63,"young",33,164,105,"f"
12,"LOWER BACK",1,"Con03",1800,1820,1700,1750,1810,1725,0.047,85,1767.5,"Con",-20,-50,FALSE,FALSE,FALSE,4.93,"young",33,164,105,"f"
12,"LOWER BACK",1,"Con04",1820,1840,1750,1800,1830,1775,0.03,55,1802.5,"Con",-20,-50,FALSE,FALSE,FALSE,3.1,"young",33,164,105,"f"
12,"LOWER BACK",1,"Con05",1680,1680,1700,1750,1680,1725,0.027,-45,1702.5,"Con",0,-50,FALSE,FALSE,FALSE,2.61,"young",33,164,105,"f"
12,"LOWER BACK",1,"Con06",1860,1860,2000,1950,1860,1975,0.062,-115,1917.5,"Con",0,50,FALSE,FALSE,FALSE,5.82,"young",33,164,105,"f"
12,"LOWER BACK",1,"Con07",1720,1700,1950,1800,1710,1875,0.096,-165,1792.5,"Con",20,150,FALSE,FALSE,FALSE,8.8,"young",33,164,105,"f"
12,"LOWER BACK",1,"Con08",1580,1620,1900,1900,1600,1900,0.188,-300,1750,"Con",-40,0,TRUE,TRUE,FALSE,15.79,"young",33,164,105,"f"
12,"LOWER BACK",1,"Con09",1640,1660,1850,1850,1650,1850,0.121,-200,1750,"Con",-20,0,TRUE,FALSE,FALSE,10.81,"young",33,164,105,"f"
12,"LOWER BACK",1,"Con10",1740,1740,2050,1950,1740,2000,0.149,-260,1870,"Con",0,100,TRUE,FALSE,FALSE,13,"young",33,164,105,"f"
12,"LOWER BACK",2,"Con01",1440,1440,1700,1550,1440,1625,0.128,-185,1532.5,"Con",0,150,FALSE,FALSE,FALSE,11.38,"young",33,164,105,"f"
12,"LOWER BACK",2,"Con02",1520,1500,1550,1500,1510,1525,0.01,-15,1517.5,"Con",20,50,FALSE,FALSE,FALSE,0.98,"young",33,164,105,"f"
12,"LOWER BACK",2,"Con03",1720,1680,1450,1800,1700,1625,0.044,75,1662.5,"Con",40,-350,FALSE,TRUE,TRUE,4.62,"young",33,164,105,"f"
12,"LOWER BACK",2,"Con04",1320,1380,1350,1500,1350,1425,0.056,-75,1387.5,"Con",-60,-150,FALSE,TRUE,FALSE,5.26,"young",33,164,105,"f"
12,"LOWER BACK",2,"Con05",1620,1600,1900,1850,1610,1875,0.165,-265,1742.5,"Con",20,50,TRUE,FALSE,FALSE,14.13,"young",33,164,105,"f"
12,"LOWER BACK",2,"Con06",1560,1560,1850,1650,1560,1750,0.122,-190,1655,"Con",0,200,TRUE,FALSE,TRUE,10.86,"young",33,164,105,"f"
12,"LOWER BACK",2,"Con07",1620,1600,1900,1650,1610,1775,0.102,-165,1692.5,"Con",20,250,FALSE,FALSE,TRUE,9.3,"young",33,164,105,"f"
12,"LOWER BACK",2,"Con08",1660,1720,1800,1800,1690,1800,0.065,-110,1745,"Con",-60,0,FALSE,TRUE,FALSE,6.11,"young",33,164,105,"f"
12,"LOWER BACK",2,"Con09",1580,1580,1700,1700,1580,1700,0.076,-120,1640,"Con",0,0,FALSE,FALSE,FALSE,7.06,"young",33,164,105,"f"
12,"LOWER BACK",2,"Con10",1700,1680,1950,2200,1690,2075,0.228,-385,1882.5,"Con",20,-250,TRUE,FALSE,TRUE,18.55,"young",33,164,105,"f"
12,"LOWER BACK",1,"Ecc01",3080,3060,3000,2950,3070,2975,0.031,95,3022.5,"Ecc",20,50,FALSE,FALSE,FALSE,3.19,"young",33,164,105,"f"
12,"LOWER BACK",1,"Ecc02",2960,2940,2900,2850,2950,2875,0.025,75,2912.5,"Ecc",20,50,FALSE,FALSE,FALSE,2.61,"young",33,164,105,"f"
12,"LOWER BACK",1,"Ecc03",3080,3060,3150,3150,3070,3150,0.026,-80,3110,"Ecc",20,0,FALSE,FALSE,FALSE,2.54,"young",33,164,105,"f"
12,"LOWER BACK",1,"Ecc04",3040,3040,3100,3000,3040,3050,0.003,-10,3045,"Ecc",0,100,FALSE,FALSE,FALSE,0.33,"young",33,164,105,"f"
12,"LOWER BACK",1,"Ecc05",2900,2880,2800,2750,2890,2775,0.04,115,2832.5,"Ecc",20,50,FALSE,FALSE,FALSE,4.14,"young",33,164,105,"f"
12,"LOWER BACK",1,"Ecc06",2600,2620,2400,2600,2610,2500,0.042,110,2555,"Ecc",-20,-200,FALSE,FALSE,TRUE,4.4,"young",33,164,105,"f"
12,"LOWER BACK",1,"Ecc07",2500,2480,2200,2250,2490,2225,0.106,265,2357.5,"Ecc",20,-50,TRUE,FALSE,FALSE,11.91,"young",33,164,105,"f"
12,"LOWER BACK",1,"Ecc08",2740,2720,2500,2500,2730,2500,0.084,230,2615,"Ecc",20,0,TRUE,FALSE,FALSE,9.2,"young",33,164,105,"f"
12,"LOWER BACK",1,"Ecc09",2860,2860,2600,2650,2860,2625,0.082,235,2742.5,"Ecc",0,-50,TRUE,FALSE,FALSE,8.95,"young",33,164,105,"f"
12,"LOWER BACK",1,"Ecc10",2900,2880,2850,2600,2890,2725,0.057,165,2807.5,"Ecc",20,250,FALSE,FALSE,TRUE,6.06,"young",33,164,105,"f"
12,"LOWER BACK",2,"Ecc01",2900,2920,2950,2950,2910,2950,0.014,-40,2930,"Ecc",-20,0,FALSE,FALSE,FALSE,1.36,"young",33,164,105,"f"
12,"LOWER BACK",2,"Ecc02",2580,2580,2600,2450,2580,2525,0.021,55,2552.5,"Ecc",0,150,FALSE,FALSE,FALSE,2.18,"young",33,164,105,"f"
12,"LOWER BACK",2,"Ecc03",2760,2720,2950,2650,2740,2800,0.022,-60,2770,"Ecc",40,300,FALSE,FALSE,TRUE,2.14,"young",33,164,105,"f"
12,"LOWER BACK",2,"Ecc04",2400,2440,2200,2150,2420,2175,0.101,245,2297.5,"Ecc",-40,50,TRUE,FALSE,FALSE,11.26,"young",33,164,105,"f"
12,"LOWER BACK",2,"Ecc05",2220,2220,1850,2100,2220,1975,0.11,245,2097.5,"Ecc",0,-250,TRUE,FALSE,TRUE,12.41,"young",33,164,105,"f"
12,"LOWER BACK",2,"Ecc06",2780,2780,2550,2750,2780,2650,0.047,130,2715,"Ecc",0,-200,FALSE,FALSE,TRUE,4.91,"young",33,164,105,"f"
12,"LOWER BACK",2,"Ecc07",2740,2700,2500,2600,2720,2550,0.062,170,2635,"Ecc",40,-100,FALSE,FALSE,FALSE,6.67,"young",33,164,105,"f"
12,"LOWER BACK",2,"Ecc08",2820,2820,2750,2700,2820,2725,0.034,95,2772.5,"Ecc",0,50,FALSE,FALSE,FALSE,3.49,"young",33,164,105,"f"
12,"LOWER BACK",2,"Ecc09",2380,2400,2150,1950,2390,2050,0.142,340,2220,"Ecc",-20,200,TRUE,FALSE,TRUE,16.59,"young",33,164,105,"f"
12,"LOWER BACK",2,"Ecc10",3140,3140,3100,3050,3140,3075,0.021,65,3107.5,"Ecc",0,50,FALSE,FALSE,FALSE,2.11,"young",33,164,105,"f"
12,"LOWER BACK",1,"Rep01",4920,4900,4900,4850,4910,4875,0.007,35,4892.5,"Rep",20,50,FALSE,FALSE,FALSE,0.72,"young",33,164,105,"f"
12,"LOWER BACK",1,"Rep02",4780,4780,4900,4900,4780,4900,0.025,-120,4840,"Rep",0,0,TRUE,FALSE,FALSE,2.45,"young",33,164,105,"f"
12,"LOWER BACK",1,"Rep03",4880,4880,4850,4900,4880,4875,0.001,5,4877.5,"Rep",0,-50,FALSE,FALSE,FALSE,0.1,"young",33,164,105,"f"
12,"LOWER BACK",1,"Rep04",4860,4880,4850,4800,4870,4825,0.009,45,4847.5,"Rep",-20,50,FALSE,FALSE,FALSE,0.93,"young",33,164,105,"f"
12,"LOWER BACK",1,"Rep05",4580,4560,4500,4500,4570,4500,0.015,70,4535,"Rep",20,0,FALSE,FALSE,FALSE,1.56,"young",33,164,105,"f"
12,"LOWER BACK",1,"Rep06",4460,4480,4400,4550,4470,4475,0.001,-5,4472.5,"Rep",-20,-150,FALSE,FALSE,FALSE,0.11,"young",33,164,105,"f"
12,"LOWER BACK",1,"Rep07",4220,4180,4150,4050,4200,4100,0.024,100,4150,"Rep",40,100,TRUE,FALSE,FALSE,2.44,"young",33,164,105,"f"
12,"LOWER BACK",1,"Rep08",4320,4340,4400,4400,4330,4400,0.016,-70,4365,"Rep",-20,0,FALSE,FALSE,FALSE,1.59,"young",33,164,105,"f"
12,"LOWER BACK",1,"Rep09",4500,4520,4450,4500,4510,4475,0.008,35,4492.5,"Rep",-20,-50,FALSE,FALSE,FALSE,0.78,"young",33,164,105,"f"
12,"LOWER BACK",1,"Rep10",4640,4620,4900,4550,4630,4725,0.021,-95,4677.5,"Rep",20,350,FALSE,FALSE,TRUE,2.01,"young",33,164,105,"f"
12,"LOWER BACK",2,"Rep01",4340,4360,4650,4500,4350,4575,0.052,-225,4462.5,"Rep",-20,150,TRUE,FALSE,FALSE,4.92,"young",33,164,105,"f"
12,"LOWER BACK",2,"Rep02",4100,4080,4150,3950,4090,4050,0.01,40,4070,"Rep",20,200,FALSE,FALSE,TRUE,0.99,"young",33,164,105,"f"
12,"LOWER BACK",2,"Rep03",4480,4400,4400,4450,4440,4425,0.003,15,4432.5,"Rep",80,-50,FALSE,TRUE,FALSE,0.34,"young",33,164,105,"f"
12,"LOWER BACK",2,"Rep04",3720,3820,3550,3650,3770,3600,0.045,170,3685,"Rep",-100,-100,TRUE,TRUE,FALSE,4.72,"young",33,164,105,"f"
12,"LOWER BACK",2,"Rep05",3840,3820,3750,3950,3830,3850,0.005,-20,3840,"Rep",20,-200,FALSE,FALSE,TRUE,0.52,"young",33,164,105,"f"
12,"LOWER BACK",2,"Rep06",4340,4340,4400,4400,4340,4400,0.014,-60,4370,"Rep",0,0,FALSE,FALSE,FALSE,1.36,"young",33,164,105,"f"
12,"LOWER BACK",2,"Rep07",4360,4300,4400,4250,4330,4325,0.001,5,4327.5,"Rep",60,150,FALSE,FALSE,FALSE,0.12,"young",33,164,105,"f"
12,"LOWER BACK",2,"Rep08",4480,4540,4550,4500,4510,4525,0.003,-15,4517.5,"Rep",-60,50,FALSE,FALSE,FALSE,0.33,"young",33,164,105,"f"
12,"LOWER BACK",2,"Rep09",3960,3980,3850,3650,3970,3750,0.055,220,3860,"Rep",-20,200,TRUE,FALSE,TRUE,5.87,"young",33,164,105,"f"
12,"LOWER BACK",2,"Rep10",4840,4820,5050,5250,4830,5150,0.066,-320,4990,"Rep",20,-200,TRUE,FALSE,TRUE,6.21,"young",33,164,105,"f"
12,"LOWER BACK",1,"TuT",46160,46140,46300,46000,46150,46150,0,0,46150,"TuT",20,300,FALSE,FALSE,TRUE,0,"young",33,164,105,"f"
12,"LOWER BACK",2,"TuT",42460,42460,42750,42550,42460,42650,0.004,-190,42555,"TuT",0,200,FALSE,FALSE,FALSE,0.45,"young",33,164,105,"f"
12,"TOTAL ABDOMINAL",1,"Con01",1440,1460,1400,1350,1450,1375,0.052,75,1412.5,"Con",-20,50,FALSE,FALSE,FALSE,5.45,"young",33,164,105,"f"
12,"TOTAL ABDOMINAL",1,"Con02",1520,1540,1650,1600,1530,1625,0.062,-95,1577.5,"Con",-20,50,FALSE,FALSE,FALSE,5.85,"young",33,164,105,"f"
12,"TOTAL ABDOMINAL",1,"Con03",1640,1660,1700,1800,1650,1750,0.061,-100,1700,"Con",-20,-100,FALSE,FALSE,FALSE,5.71,"young",33,164,105,"f"
12,"TOTAL ABDOMINAL",1,"Con04",1520,1520,1550,1600,1520,1575,0.036,-55,1547.5,"Con",0,-50,FALSE,FALSE,FALSE,3.49,"young",33,164,105,"f"
12,"TOTAL ABDOMINAL",1,"Con05",1500,1540,1550,1600,1520,1575,0.036,-55,1547.5,"Con",-40,-50,FALSE,TRUE,FALSE,3.49,"young",33,164,105,"f"
12,"TOTAL ABDOMINAL",1,"Con06",1560,1560,1550,1600,1560,1575,0.01,-15,1567.5,"Con",0,-50,FALSE,FALSE,FALSE,0.95,"young",33,164,105,"f"
12,"TOTAL ABDOMINAL",1,"Con07",1400,1400,1450,1400,1400,1425,0.018,-25,1412.5,"Con",0,50,FALSE,FALSE,FALSE,1.75,"young",33,164,105,"f"
12,"TOTAL ABDOMINAL",1,"Con08",1340,1320,1550,1400,1330,1475,0.109,-145,1402.5,"Con",20,150,TRUE,FALSE,FALSE,9.83,"young",33,164,105,"f"
12,"TOTAL ABDOMINAL",1,"Con09",1720,1720,1950,1800,1720,1875,0.09,-155,1797.5,"Con",0,150,TRUE,FALSE,FALSE,8.27,"young",33,164,105,"f"
12,"TOTAL ABDOMINAL",1,"Con10",1480,1480,1700,1700,1480,1700,0.149,-220,1590,"Con",0,0,TRUE,FALSE,FALSE,12.94,"young",33,164,105,"f"
12,"TOTAL ABDOMINAL",2,"Con01",1420,1420,1350,1550,1420,1450,0.021,-30,1435,"Con",0,-200,FALSE,FALSE,TRUE,2.07,"young",33,164,105,"f"
12,"TOTAL ABDOMINAL",2,"Con02",1700,1700,2000,1800,1700,1900,0.118,-200,1800,"Con",0,200,TRUE,FALSE,TRUE,10.53,"young",33,164,105,"f"
12,"TOTAL ABDOMINAL",2,"Con03",1820,1780,1900,1850,1800,1875,0.042,-75,1837.5,"Con",40,50,FALSE,TRUE,FALSE,4,"young",33,164,105,"f"
12,"TOTAL ABDOMINAL",2,"Con04",1660,1680,1750,1750,1670,1750,0.048,-80,1710,"Con",-20,0,FALSE,FALSE,FALSE,4.57,"young",33,164,105,"f"
12,"TOTAL ABDOMINAL",2,"Con05",1700,1720,1700,1800,1710,1750,0.023,-40,1730,"Con",-20,-100,FALSE,FALSE,FALSE,2.29,"young",33,164,105,"f"
12,"TOTAL ABDOMINAL",2,"Con06",1560,1580,1550,1700,1570,1625,0.035,-55,1597.5,"Con",-20,-150,FALSE,FALSE,FALSE,3.38,"young",33,164,105,"f"
12,"TOTAL ABDOMINAL",2,"Con07",1620,1580,1650,1700,1600,1675,0.047,-75,1637.5,"Con",40,-50,FALSE,TRUE,FALSE,4.48,"young",33,164,105,"f"
12,"TOTAL ABDOMINAL",2,"Con08",1600,1620,1650,1650,1610,1650,0.025,-40,1630,"Con",-20,0,FALSE,FALSE,FALSE,2.42,"young",33,164,105,"f"
12,"TOTAL ABDOMINAL",2,"Con09",1380,1360,1600,1500,1370,1550,0.131,-180,1460,"Con",20,100,TRUE,FALSE,FALSE,11.61,"young",33,164,105,"f"
12,"TOTAL ABDOMINAL",2,"Con10",1520,1500,1850,1600,1510,1725,0.142,-215,1617.5,"Con",20,250,TRUE,FALSE,TRUE,12.46,"young",33,164,105,"f"
12,"TOTAL ABDOMINAL",1,"Ecc01",2740,2700,2650,2750,2720,2700,0.007,20,2710,"Ecc",40,-100,FALSE,TRUE,FALSE,0.74,"young",33,164,105,"f"
12,"TOTAL ABDOMINAL",1,"Ecc02",2580,2580,2500,2450,2580,2475,0.041,105,2527.5,"Ecc",0,50,FALSE,FALSE,FALSE,4.24,"young",33,164,105,"f"
12,"TOTAL ABDOMINAL",1,"Ecc03",2560,2540,2550,2450,2550,2500,0.02,50,2525,"Ecc",20,100,FALSE,FALSE,FALSE,2,"young",33,164,105,"f"
12,"TOTAL ABDOMINAL",1,"Ecc04",2240,2220,2150,2150,2230,2150,0.036,80,2190,"Ecc",20,0,FALSE,FALSE,FALSE,3.72,"young",33,164,105,"f"
12,"TOTAL ABDOMINAL",1,"Ecc05",2400,2380,2400,2300,2390,2350,0.017,40,2370,"Ecc",20,100,FALSE,FALSE,FALSE,1.7,"young",33,164,105,"f"
12,"TOTAL ABDOMINAL",1,"Ecc06",2260,2280,2250,2250,2270,2250,0.009,20,2260,"Ecc",-20,0,FALSE,FALSE,FALSE,0.89,"young",33,164,105,"f"
12,"TOTAL ABDOMINAL",1,"Ecc07",2040,2020,1850,2000,2030,1925,0.052,105,1977.5,"Ecc",20,-150,FALSE,FALSE,FALSE,5.45,"young",33,164,105,"f"
12,"TOTAL ABDOMINAL",1,"Ecc08",2080,2100,1900,2050,2090,1975,0.055,115,2032.5,"Ecc",-20,-150,FALSE,FALSE,FALSE,5.82,"young",33,164,105,"f"
12,"TOTAL ABDOMINAL",1,"Ecc09",2220,2220,1950,2050,2220,2000,0.099,220,2110,"Ecc",0,-100,TRUE,FALSE,FALSE,11,"young",33,164,105,"f"
12,"TOTAL ABDOMINAL",1,"Ecc10",2480,2480,2450,2250,2480,2350,0.052,130,2415,"Ecc",0,200,FALSE,FALSE,TRUE,5.53,"young",33,164,105,"f"
12,"TOTAL ABDOMINAL",2,"Ecc01",2400,2400,2150,2350,2400,2250,0.062,150,2325,"Ecc",0,-200,TRUE,FALSE,TRUE,6.67,"young",33,164,105,"f"
12,"TOTAL ABDOMINAL",2,"Ecc02",2580,2620,2400,2550,2600,2475,0.048,125,2537.5,"Ecc",-40,-150,FALSE,TRUE,FALSE,5.05,"young",33,164,105,"f"
12,"TOTAL ABDOMINAL",2,"Ecc03",2560,2560,2450,2450,2560,2450,0.043,110,2505,"Ecc",0,0,FALSE,FALSE,FALSE,4.49,"young",33,164,105,"f"
12,"TOTAL ABDOMINAL",2,"Ecc04",2100,2060,2050,2000,2080,2025,0.026,55,2052.5,"Ecc",40,50,FALSE,TRUE,FALSE,2.72,"young",33,164,105,"f"
12,"TOTAL ABDOMINAL",2,"Ecc05",2160,2160,2200,2050,2160,2125,0.016,35,2142.5,"Ecc",0,150,FALSE,FALSE,FALSE,1.65,"young",33,164,105,"f"
12,"TOTAL ABDOMINAL",2,"Ecc06",2480,2500,2450,2350,2490,2400,0.036,90,2445,"Ecc",-20,100,FALSE,FALSE,FALSE,3.75,"young",33,164,105,"f"
12,"TOTAL ABDOMINAL",2,"Ecc07",2380,2380,2350,2350,2380,2350,0.013,30,2365,"Ecc",0,0,FALSE,FALSE,FALSE,1.28,"young",33,164,105,"f"
12,"TOTAL ABDOMINAL",2,"Ecc08",2360,2380,2200,2250,2370,2225,0.061,145,2297.5,"Ecc",-20,-50,TRUE,FALSE,FALSE,6.52,"young",33,164,105,"f"
12,"TOTAL ABDOMINAL",2,"Ecc09",2080,2100,1850,2000,2090,1925,0.079,165,2007.5,"Ecc",-20,-150,TRUE,FALSE,FALSE,8.57,"young",33,164,105,"f"
12,"TOTAL ABDOMINAL",2,"Ecc10",2160,2160,1950,2050,2160,2000,0.074,160,2080,"Ecc",0,-100,TRUE,FALSE,FALSE,8,"young",33,164,105,"f"
12,"TOTAL ABDOMINAL",1,"Rep01",4180,4160,4050,4100,4170,4075,0.023,95,4122.5,"Rep",20,-50,FALSE,FALSE,FALSE,2.33,"young",33,164,105,"f"
12,"TOTAL ABDOMINAL",1,"Rep02",4100,4120,4150,4050,4110,4100,0.002,10,4105,"Rep",-20,100,FALSE,FALSE,FALSE,0.24,"young",33,164,105,"f"
12,"TOTAL ABDOMINAL",1,"Rep03",4200,4200,4250,4250,4200,4250,0.012,-50,4225,"Rep",0,0,FALSE,FALSE,FALSE,1.18,"young",33,164,105,"f"
12,"TOTAL ABDOMINAL",1,"Rep04",3760,3740,3700,3750,3750,3725,0.007,25,3737.5,"Rep",20,-50,FALSE,FALSE,FALSE,0.67,"young",33,164,105,"f"
12,"TOTAL ABDOMINAL",1,"Rep05",3900,3920,3950,3900,3910,3925,0.004,-15,3917.5,"Rep",-20,50,FALSE,FALSE,FALSE,0.38,"young",33,164,105,"f"
12,"TOTAL ABDOMINAL",1,"Rep06",3820,3840,3800,3850,3830,3825,0.001,5,3827.5,"Rep",-20,-50,FALSE,FALSE,FALSE,0.13,"young",33,164,105,"f"
12,"TOTAL ABDOMINAL",1,"Rep07",3440,3420,3300,3400,3430,3350,0.023,80,3390,"Rep",20,-100,FALSE,FALSE,FALSE,2.39,"young",33,164,105,"f"
12,"TOTAL ABDOMINAL",1,"Rep08",3420,3420,3450,3450,3420,3450,0.009,-30,3435,"Rep",0,0,FALSE,FALSE,FALSE,0.87,"young",33,164,105,"f"
12,"TOTAL ABDOMINAL",1,"Rep09",3940,3940,3900,3850,3940,3875,0.016,65,3907.5,"Rep",0,50,FALSE,FALSE,FALSE,1.68,"young",33,164,105,"f"
12,"TOTAL ABDOMINAL",1,"Rep10",3960,3960,4150,3950,3960,4050,0.023,-90,4005,"Rep",0,200,FALSE,FALSE,TRUE,2.22,"young",33,164,105,"f"
12,"TOTAL ABDOMINAL",2,"Rep01",3820,3820,3500,3900,3820,3700,0.031,120,3760,"Rep",0,-400,FALSE,FALSE,TRUE,3.24,"young",33,164,105,"f"
12,"TOTAL ABDOMINAL",2,"Rep02",4280,4320,4400,4350,4300,4375,0.017,-75,4337.5,"Rep",-40,50,FALSE,FALSE,FALSE,1.71,"young",33,164,105,"f"
12,"TOTAL ABDOMINAL",2,"Rep03",4380,4340,4350,4300,4360,4325,0.008,35,4342.5,"Rep",40,50,FALSE,FALSE,FALSE,0.81,"young",33,164,105,"f"
12,"TOTAL ABDOMINAL",2,"Rep04",3760,3740,3800,3750,3750,3775,0.007,-25,3762.5,"Rep",20,50,FALSE,FALSE,FALSE,0.66,"young",33,164,105,"f"
12,"TOTAL ABDOMINAL",2,"Rep05",3860,3880,3900,3850,3870,3875,0.001,-5,3872.5,"Rep",-20,50,FALSE,FALSE,FALSE,0.13,"young",33,164,105,"f"
12,"TOTAL ABDOMINAL",2,"Rep06",4040,4080,4000,4050,4060,4025,0.009,35,4042.5,"Rep",-40,-50,FALSE,FALSE,FALSE,0.87,"young",33,164,105,"f"
12,"TOTAL ABDOMINAL",2,"Rep07",4000,3960,4000,4050,3980,4025,0.011,-45,4002.5,"Rep",40,-50,FALSE,FALSE,FALSE,1.12,"young",33,164,105,"f"
12,"TOTAL ABDOMINAL",2,"Rep08",3960,4000,3850,3900,3980,3875,0.026,105,3927.5,"Rep",-40,-50,FALSE,FALSE,FALSE,2.71,"young",33,164,105,"f"
12,"TOTAL ABDOMINAL",2,"Rep09",3460,3460,3450,3500,3460,3475,0.004,-15,3467.5,"Rep",0,-50,FALSE,FALSE,FALSE,0.43,"young",33,164,105,"f"
12,"TOTAL ABDOMINAL",2,"Rep10",3680,3660,3800,3650,3670,3725,0.015,-55,3697.5,"Rep",20,150,FALSE,FALSE,FALSE,1.48,"young",33,164,105,"f"
12,"TOTAL ABDOMINAL",1,"TuT",38720,38720,38700,38550,38720,38625,0.002,95,38672.5,"TuT",0,150,FALSE,FALSE,FALSE,0.25,"young",33,164,105,"f"
12,"TOTAL ABDOMINAL",2,"TuT",39240,39260,39050,39300,39250,39175,0.002,75,39212.5,"TuT",-20,-250,FALSE,FALSE,FALSE,0.19,"young",33,164,105,"f"
12,"VERTICAL TRACTION",1,"Con01",2560,2580,4050,3950,2570,4000,0.556,-1430,3285,"Con",-20,100,TRUE,FALSE,FALSE,35.75,"young",33,164,105,"f"
12,"VERTICAL TRACTION",1,"Con02",1480,1480,1550,1550,1480,1550,0.047,-70,1515,"Con",0,0,FALSE,FALSE,FALSE,4.52,"young",33,164,105,"f"
12,"VERTICAL TRACTION",1,"Con03",1240,1260,1350,1350,1250,1350,0.08,-100,1300,"Con",-20,0,FALSE,FALSE,FALSE,7.41,"young",33,164,105,"f"
12,"VERTICAL TRACTION",1,"Con04",1600,1540,1700,1650,1570,1675,0.067,-105,1622.5,"Con",60,50,FALSE,FALSE,FALSE,6.27,"young",33,164,105,"f"
12,"VERTICAL TRACTION",1,"Con05",1340,1320,1450,1500,1330,1475,0.109,-145,1402.5,"Con",20,-50,FALSE,FALSE,FALSE,9.83,"young",33,164,105,"f"
12,"VERTICAL TRACTION",1,"Con06",1500,1480,1850,1850,1490,1850,0.242,-360,1670,"Con",20,0,TRUE,FALSE,FALSE,19.46,"young",33,164,105,"f"
12,"VERTICAL TRACTION",1,"Con07",1500,1480,1850,1800,1490,1825,0.225,-335,1657.5,"Con",20,50,TRUE,FALSE,FALSE,18.36,"young",33,164,105,"f"
12,"VERTICAL TRACTION",1,"Con08",1300,1260,1550,1500,1280,1525,0.191,-245,1402.5,"Con",40,50,FALSE,FALSE,FALSE,16.07,"young",33,164,105,"f"
12,"VERTICAL TRACTION",1,"Con09",1280,1260,1550,1500,1270,1525,0.201,-255,1397.5,"Con",20,50,FALSE,FALSE,FALSE,16.72,"young",33,164,105,"f"
12,"VERTICAL TRACTION",1,"Con10",1400,1380,1550,1650,1390,1600,0.151,-210,1495,"Con",20,-100,FALSE,FALSE,FALSE,13.12,"young",33,164,105,"f"
12,"VERTICAL TRACTION",2,"Con01",1960,2000,2250,3550,1980,2900,0.465,-920,2440,"Con",-40,-1300,TRUE,FALSE,TRUE,31.72,"young",33,164,105,"f"
12,"VERTICAL TRACTION",2,"Con02",1580,1580,1850,1450,1580,1650,0.044,-70,1615,"Con",0,400,FALSE,FALSE,TRUE,4.24,"young",33,164,105,"f"
12,"VERTICAL TRACTION",2,"Con03",1580,1560,1900,1650,1570,1775,0.131,-205,1672.5,"Con",20,250,FALSE,FALSE,TRUE,11.55,"young",33,164,105,"f"
12,"VERTICAL TRACTION",2,"Con04",1380,1360,1600,1650,1370,1625,0.186,-255,1497.5,"Con",20,-50,FALSE,FALSE,FALSE,15.69,"young",33,164,105,"f"
12,"VERTICAL TRACTION",2,"Con05",1340,1340,1550,1600,1340,1575,0.175,-235,1457.5,"Con",0,-50,FALSE,FALSE,FALSE,14.92,"young",33,164,105,"f"
12,"VERTICAL TRACTION",2,"Con06",1400,1420,1500,1550,1410,1525,0.082,-115,1467.5,"Con",-20,-50,FALSE,FALSE,FALSE,7.54,"young",33,164,105,"f"
12,"VERTICAL TRACTION",2,"Con07",1520,1520,2000,2050,1520,2025,0.332,-505,1772.5,"Con",0,-50,TRUE,FALSE,FALSE,24.94,"young",33,164,105,"f"
12,"VERTICAL TRACTION",2,"Con08",1620,1620,1800,2150,1620,1975,0.219,-355,1797.5,"Con",0,-350,TRUE,FALSE,TRUE,17.97,"young",33,164,105,"f"
12,"VERTICAL TRACTION",2,"Con09",1480,1480,1500,1700,1480,1600,0.081,-120,1540,"Con",0,-200,FALSE,FALSE,TRUE,7.5,"young",33,164,105,"f"
12,"VERTICAL TRACTION",2,"Con10",1440,1460,1750,1700,1450,1725,0.19,-275,1587.5,"Con",-20,50,FALSE,FALSE,FALSE,15.94,"young",33,164,105,"f"
12,"VERTICAL TRACTION",1,"Ecc01",3040,3040,2950,2850,3040,2900,0.046,140,2970,"Ecc",0,100,FALSE,FALSE,FALSE,4.83,"young",33,164,105,"f"
12,"VERTICAL TRACTION",1,"Ecc02",2840,2820,2800,2800,2830,2800,0.011,30,2815,"Ecc",20,0,FALSE,FALSE,FALSE,1.07,"young",33,164,105,"f"
12,"VERTICAL TRACTION",1,"Ecc03",2560,2600,2450,2500,2580,2475,0.041,105,2527.5,"Ecc",-40,-50,FALSE,FALSE,FALSE,4.24,"young",33,164,105,"f"
12,"VERTICAL TRACTION",1,"Ecc04",2680,2720,2550,2550,2700,2550,0.056,150,2625,"Ecc",-40,0,FALSE,FALSE,FALSE,5.88,"young",33,164,105,"f"
12,"VERTICAL TRACTION",1,"Ecc05",2700,2720,2400,2400,2710,2400,0.114,310,2555,"Ecc",-20,0,TRUE,FALSE,FALSE,12.92,"young",33,164,105,"f"
12,"VERTICAL TRACTION",1,"Ecc06",2820,2840,2500,2550,2830,2525,0.108,305,2677.5,"Ecc",-20,-50,TRUE,FALSE,FALSE,12.08,"young",33,164,105,"f"
12,"VERTICAL TRACTION",1,"Ecc07",2500,2520,2200,2200,2510,2200,0.124,310,2355,"Ecc",-20,0,TRUE,FALSE,FALSE,14.09,"young",33,164,105,"f"
12,"VERTICAL TRACTION",1,"Ecc08",2700,2740,2400,2500,2720,2450,0.099,270,2585,"Ecc",-40,-100,TRUE,FALSE,FALSE,11.02,"young",33,164,105,"f"
12,"VERTICAL TRACTION",1,"Ecc09",2620,2620,2450,2350,2620,2400,0.084,220,2510,"Ecc",0,100,FALSE,FALSE,FALSE,9.17,"young",33,164,105,"f"
12,"VERTICAL TRACTION",1,"Ecc10",2700,2720,2650,2600,2710,2625,0.031,85,2667.5,"Ecc",-20,50,FALSE,FALSE,FALSE,3.24,"young",33,164,105,"f"
12,"VERTICAL TRACTION",2,"Ecc01",2880,2880,2500,2900,2880,2700,0.062,180,2790,"Ecc",0,-400,FALSE,FALSE,TRUE,6.67,"young",33,164,105,"f"
12,"VERTICAL TRACTION",2,"Ecc02",2660,2680,2500,2800,2670,2650,0.007,20,2660,"Ecc",-20,-300,FALSE,FALSE,TRUE,0.75,"young",33,164,105,"f"
12,"VERTICAL TRACTION",2,"Ecc03",3140,3140,2750,2800,3140,2775,0.116,365,2957.5,"Ecc",0,-50,TRUE,FALSE,FALSE,13.15,"young",33,164,105,"f"
12,"VERTICAL TRACTION",2,"Ecc04",2640,2660,2500,2400,2650,2450,0.075,200,2550,"Ecc",-20,100,FALSE,FALSE,FALSE,8.16,"young",33,164,105,"f"
12,"VERTICAL TRACTION",2,"Ecc05",2920,2900,2750,2700,2910,2725,0.064,185,2817.5,"Ecc",20,50,FALSE,FALSE,FALSE,6.79,"young",33,164,105,"f"
12,"VERTICAL TRACTION",2,"Ecc06",2560,2540,2100,2100,2550,2100,0.176,450,2325,"Ecc",20,0,TRUE,FALSE,FALSE,21.43,"young",33,164,105,"f"
12,"VERTICAL TRACTION",2,"Ecc07",2360,2360,2200,1850,2360,2025,0.142,335,2192.5,"Ecc",0,350,TRUE,FALSE,TRUE,16.54,"young",33,164,105,"f"
12,"VERTICAL TRACTION",2,"Ecc08",2700,2720,2600,2400,2710,2500,0.077,210,2605,"Ecc",-20,200,FALSE,FALSE,TRUE,8.4,"young",33,164,105,"f"
12,"VERTICAL TRACTION",2,"Ecc09",2480,2460,2250,2250,2470,2250,0.089,220,2360,"Ecc",20,0,FALSE,FALSE,FALSE,9.78,"young",33,164,105,"f"
12,"VERTICAL TRACTION",2,"Ecc10",2820,2820,2800,2150,2820,2475,0.122,345,2647.5,"Ecc",0,650,TRUE,FALSE,TRUE,13.94,"young",33,164,105,"f"
12,"VERTICAL TRACTION",1,"Rep01",5600,5620,7000,6800,5610,6900,0.23,-1290,6255,"Rep",-20,200,TRUE,FALSE,TRUE,18.7,"young",33,164,105,"f"
12,"VERTICAL TRACTION",1,"Rep02",4320,4300,4350,4350,4310,4350,0.009,-40,4330,"Rep",20,0,FALSE,FALSE,FALSE,0.92,"young",33,164,105,"f"
12,"VERTICAL TRACTION",1,"Rep03",3800,3860,3800,3850,3830,3825,0.001,5,3827.5,"Rep",-60,-50,FALSE,FALSE,FALSE,0.13,"young",33,164,105,"f"
12,"VERTICAL TRACTION",1,"Rep04",4280,4260,4250,4200,4270,4225,0.011,45,4247.5,"Rep",20,50,FALSE,FALSE,FALSE,1.07,"young",33,164,105,"f"
12,"VERTICAL TRACTION",1,"Rep05",4040,4040,3850,3900,4040,3875,0.041,165,3957.5,"Rep",0,-50,TRUE,FALSE,FALSE,4.26,"young",33,164,105,"f"
12,"VERTICAL TRACTION",1,"Rep06",4320,4320,4350,4400,4320,4375,0.013,-55,4347.5,"Rep",0,-50,FALSE,FALSE,FALSE,1.26,"young",33,164,105,"f"
12,"VERTICAL TRACTION",1,"Rep07",4000,4000,4050,4000,4000,4025,0.006,-25,4012.5,"Rep",0,50,FALSE,FALSE,FALSE,0.62,"young",33,164,105,"f"
12,"VERTICAL TRACTION",1,"Rep08",4000,4000,3950,4000,4000,3975,0.006,25,3987.5,"Rep",0,-50,FALSE,FALSE,FALSE,0.63,"young",33,164,105,"f"
12,"VERTICAL TRACTION",1,"Rep09",3900,3880,4000,3850,3890,3925,0.009,-35,3907.5,"Rep",20,150,FALSE,FALSE,FALSE,0.89,"young",33,164,105,"f"
12,"VERTICAL TRACTION",1,"Rep10",4100,4100,4200,4250,4100,4225,0.03,-125,4162.5,"Rep",0,-50,FALSE,FALSE,FALSE,2.96,"young",33,164,105,"f"
12,"VERTICAL TRACTION",2,"Rep01",4840,4880,4750,6450,4860,5600,0.152,-740,5230,"Rep",-40,-1700,TRUE,FALSE,TRUE,13.21,"young",33,164,105,"f"
12,"VERTICAL TRACTION",2,"Rep02",4240,4260,4350,4250,4250,4300,0.012,-50,4275,"Rep",-20,100,FALSE,FALSE,FALSE,1.16,"young",33,164,105,"f"
12,"VERTICAL TRACTION",2,"Rep03",4720,4700,4650,4450,4710,4550,0.034,160,4630,"Rep",20,200,TRUE,FALSE,TRUE,3.52,"young",33,164,105,"f"
12,"VERTICAL TRACTION",2,"Rep04",4020,4020,4100,4050,4020,4075,0.014,-55,4047.5,"Rep",0,50,FALSE,FALSE,FALSE,1.35,"young",33,164,105,"f"
12,"VERTICAL TRACTION",2,"Rep05",4260,4240,4300,4300,4250,4300,0.012,-50,4275,"Rep",20,0,FALSE,FALSE,FALSE,1.16,"young",33,164,105,"f"
12,"VERTICAL TRACTION",2,"Rep06",3960,3960,3600,3650,3960,3625,0.085,335,3792.5,"Rep",0,-50,TRUE,FALSE,FALSE,9.24,"young",33,164,105,"f"
12,"VERTICAL TRACTION",2,"Rep07",3880,3880,4200,3900,3880,4050,0.044,-170,3965,"Rep",0,300,TRUE,FALSE,TRUE,4.2,"young",33,164,105,"f"
12,"VERTICAL TRACTION",2,"Rep08",4320,4340,4400,4550,4330,4475,0.033,-145,4402.5,"Rep",-20,-150,TRUE,FALSE,FALSE,3.24,"young",33,164,105,"f"
12,"VERTICAL TRACTION",2,"Rep09",3960,3940,3750,3950,3950,3850,0.025,100,3900,"Rep",20,-200,FALSE,FALSE,TRUE,2.6,"young",33,164,105,"f"
12,"VERTICAL TRACTION",2,"Rep10",4260,4280,4550,3850,4270,4200,0.016,70,4235,"Rep",-20,700,FALSE,FALSE,TRUE,1.67,"young",33,164,105,"f"
12,"VERTICAL TRACTION",1,"TuT",42360,42380,43800,43600,42370,43700,0.031,-1330,43035,"TuT",-20,200,FALSE,FALSE,FALSE,3.04,"young",33,164,105,"f"
12,"VERTICAL TRACTION",2,"TuT",42460,42500,42650,43400,42480,43025,0.013,-545,42752.5,"TuT",-40,-750,FALSE,FALSE,FALSE,1.27,"young",33,164,105,"f"
12,"CHEST PRESS",1,"Con01",2260,2260,2000,2350,2260,2175,0.038,85,2217.5,"Con",0,-350,FALSE,FALSE,TRUE,3.91,"young",33,164,105,"f"
12,"CHEST PRESS",1,"Con02",1740,1740,1600,1900,1740,1750,0.006,-10,1745,"Con",0,-300,FALSE,FALSE,FALSE,0.57,"young",33,164,105,"f"
12,"CHEST PRESS",1,"Con03",1940,1960,1950,1950,1950,1950,0,0,1950,"Con",-20,0,FALSE,FALSE,FALSE,0,"young",33,164,105,"f"
12,"CHEST PRESS",1,"Con04",1840,1880,1900,1750,1860,1825,0.019,35,1842.5,"Con",-40,150,FALSE,TRUE,FALSE,1.92,"young",33,164,105,"f"
12,"CHEST PRESS",1,"Con05",1660,1680,1850,1600,1670,1725,0.033,-55,1697.5,"Con",-20,250,FALSE,FALSE,FALSE,3.19,"young",33,164,105,"f"
12,"CHEST PRESS",1,"Con06",1620,1560,2000,1650,1590,1825,0.148,-235,1707.5,"Con",60,350,FALSE,TRUE,TRUE,12.88,"young",33,164,105,"f"
12,"CHEST PRESS",1,"Con07",1960,1960,2150,2300,1960,2225,0.135,-265,2092.5,"Con",0,-150,FALSE,FALSE,FALSE,11.91,"young",33,164,105,"f"
12,"CHEST PRESS",1,"Con08",1840,1840,2150,2350,1840,2250,0.223,-410,2045,"Con",0,-200,TRUE,FALSE,FALSE,18.22,"young",33,164,105,"f"
12,"CHEST PRESS",1,"Con09",2360,2340,2650,2750,2350,2700,0.149,-350,2525,"Con",20,-100,TRUE,FALSE,FALSE,12.96,"young",33,164,105,"f"
12,"CHEST PRESS",1,"Con10",1920,1920,2100,2250,1920,2175,0.133,-255,2047.5,"Con",0,-150,FALSE,FALSE,FALSE,11.72,"young",33,164,105,"f"
12,"CHEST PRESS",2,"Con01",2000,2000,1950,2200,2000,2075,0.038,-75,2037.5,"Con",0,-250,FALSE,FALSE,FALSE,3.61,"young",33,164,105,"f"
12,"CHEST PRESS",2,"Con02",1740,1740,1700,2000,1740,1850,0.063,-110,1795,"Con",0,-300,FALSE,FALSE,FALSE,5.95,"young",33,164,105,"f"
12,"CHEST PRESS",2,"Con03",1880,1900,2200,2150,1890,2175,0.151,-285,2032.5,"Con",-20,50,FALSE,FALSE,FALSE,13.1,"young",33,164,105,"f"
12,"CHEST PRESS",2,"Con04",1740,1720,1850,1700,1730,1775,0.026,-45,1752.5,"Con",20,150,FALSE,FALSE,FALSE,2.54,"young",33,164,105,"f"
12,"CHEST PRESS",2,"Con05",2120,2140,2250,2100,2130,2175,0.021,-45,2152.5,"Con",-20,150,FALSE,FALSE,FALSE,2.07,"young",33,164,105,"f"
12,"CHEST PRESS",2,"Con06",2400,2420,2400,2500,2410,2450,0.017,-40,2430,"Con",-20,-100,FALSE,FALSE,FALSE,1.63,"young",33,164,105,"f"
12,"CHEST PRESS",2,"Con07",2040,2040,2000,2100,2040,2050,0.005,-10,2045,"Con",0,-100,FALSE,FALSE,FALSE,0.49,"young",33,164,105,"f"
12,"CHEST PRESS",2,"Con08",2160,2160,2200,2300,2160,2250,0.042,-90,2205,"Con",0,-100,FALSE,FALSE,FALSE,4,"young",33,164,105,"f"
12,"CHEST PRESS",2,"Con09",1780,1780,2050,2000,1780,2025,0.138,-245,1902.5,"Con",0,50,FALSE,FALSE,FALSE,12.1,"young",33,164,105,"f"
12,"CHEST PRESS",2,"Con10",3100,3120,3150,3000,3110,3075,0.011,35,3092.5,"Con",-20,150,FALSE,FALSE,FALSE,1.14,"young",33,164,105,"f"
12,"CHEST PRESS",1,"Ecc01",2520,2520,2650,2400,2520,2525,0.002,-5,2522.5,"Ecc",0,250,FALSE,FALSE,TRUE,0.2,"young",33,164,105,"f"
12,"CHEST PRESS",1,"Ecc02",2840,2840,3050,2750,2840,2900,0.021,-60,2870,"Ecc",0,300,FALSE,FALSE,TRUE,2.07,"young",33,164,105,"f"
12,"CHEST PRESS",1,"Ecc03",2620,2560,2400,2550,2590,2475,0.044,115,2532.5,"Ecc",60,-150,FALSE,TRUE,FALSE,4.65,"young",33,164,105,"f"
12,"CHEST PRESS",1,"Ecc04",3040,3020,3050,3300,3030,3175,0.048,-145,3102.5,"Ecc",20,-250,FALSE,FALSE,TRUE,4.57,"young",33,164,105,"f"
12,"CHEST PRESS",1,"Ecc05",3180,3240,2900,3200,3210,3050,0.05,160,3130,"Ecc",-60,-300,FALSE,TRUE,TRUE,5.25,"young",33,164,105,"f"
12,"CHEST PRESS",1,"Ecc06",3280,3280,3000,3000,3280,3000,0.085,280,3140,"Ecc",0,0,FALSE,FALSE,FALSE,9.33,"young",33,164,105,"f"
12,"CHEST PRESS",1,"Ecc07",2880,2880,2550,2450,2880,2500,0.132,380,2690,"Ecc",0,100,TRUE,FALSE,FALSE,15.2,"young",33,164,105,"f"
12,"CHEST PRESS",1,"Ecc08",3280,3280,2900,2750,3280,2825,0.139,455,3052.5,"Ecc",0,150,TRUE,FALSE,FALSE,16.11,"young",33,164,105,"f"
12,"CHEST PRESS",1,"Ecc09",3120,3140,3000,2800,3130,2900,0.073,230,3015,"Ecc",-20,200,FALSE,FALSE,FALSE,7.93,"young",33,164,105,"f"
12,"CHEST PRESS",1,"Ecc10",4360,4360,4250,4250,4360,4250,0.025,110,4305,"Ecc",0,0,FALSE,FALSE,FALSE,2.59,"young",33,164,105,"f"
12,"CHEST PRESS",2,"Ecc01",3200,3200,3200,2900,3200,3050,0.047,150,3125,"Ecc",0,300,FALSE,FALSE,TRUE,4.92,"young",33,164,105,"f"
12,"CHEST PRESS",2,"Ecc02",3280,3240,3100,3000,3260,3050,0.064,210,3155,"Ecc",40,100,FALSE,TRUE,FALSE,6.89,"young",33,164,105,"f"
12,"CHEST PRESS",2,"Ecc03",2940,2980,2750,2900,2960,2825,0.046,135,2892.5,"Ecc",-40,-150,FALSE,TRUE,FALSE,4.78,"young",33,164,105,"f"
12,"CHEST PRESS",2,"Ecc04",3180,3160,3050,3150,3170,3100,0.022,70,3135,"Ecc",20,-100,FALSE,FALSE,FALSE,2.26,"young",33,164,105,"f"
12,"CHEST PRESS",2,"Ecc05",3220,3220,3150,3200,3220,3175,0.014,45,3197.5,"Ecc",0,-50,FALSE,FALSE,FALSE,1.42,"young",33,164,105,"f"
12,"CHEST PRESS",2,"Ecc06",2540,2520,2600,2500,2530,2550,0.008,-20,2540,"Ecc",20,100,FALSE,FALSE,FALSE,0.78,"young",33,164,105,"f"
12,"CHEST PRESS",2,"Ecc07",2780,2800,2800,2700,2790,2750,0.014,40,2770,"Ecc",-20,100,FALSE,FALSE,FALSE,1.45,"young",33,164,105,"f"
12,"CHEST PRESS",2,"Ecc08",3020,2980,2800,2800,3000,2800,0.067,200,2900,"Ecc",40,0,FALSE,TRUE,FALSE,7.14,"young",33,164,105,"f"
12,"CHEST PRESS",2,"Ecc09",3060,3080,2950,3000,3070,2975,0.031,95,3022.5,"Ecc",-20,-50,FALSE,FALSE,FALSE,3.19,"young",33,164,105,"f"
12,"CHEST PRESS",2,"Ecc10",4280,4280,4250,4400,4280,4325,0.011,-45,4302.5,"Ecc",0,-150,FALSE,FALSE,FALSE,1.04,"young",33,164,105,"f"
12,"CHEST PRESS",1,"Rep01",4780,4780,4650,4750,4780,4700,0.017,80,4740,"Rep",0,-100,FALSE,FALSE,FALSE,1.7,"young",33,164,105,"f"
12,"CHEST PRESS",1,"Rep02",4580,4580,4650,4650,4580,4650,0.015,-70,4615,"Rep",0,0,FALSE,FALSE,FALSE,1.51,"young",33,164,105,"f"
12,"CHEST PRESS",1,"Rep03",4560,4520,4350,4500,4540,4425,0.025,115,4482.5,"Rep",40,-150,FALSE,FALSE,FALSE,2.6,"young",33,164,105,"f"
12,"CHEST PRESS",1,"Rep04",4880,4900,4950,5050,4890,5000,0.022,-110,4945,"Rep",-20,-100,FALSE,FALSE,FALSE,2.2,"young",33,164,105,"f"
12,"CHEST PRESS",1,"Rep05",4840,4920,4750,4800,4880,4775,0.022,105,4827.5,"Rep",-80,-50,FALSE,TRUE,FALSE,2.2,"young",33,164,105,"f"
12,"CHEST PRESS",1,"Rep06",4900,4840,5000,4650,4870,4825,0.009,45,4847.5,"Rep",60,350,FALSE,FALSE,TRUE,0.93,"young",33,164,105,"f"
12,"CHEST PRESS",1,"Rep07",4840,4840,4700,4750,4840,4725,0.024,115,4782.5,"Rep",0,-50,FALSE,FALSE,FALSE,2.43,"young",33,164,105,"f"
12,"CHEST PRESS",1,"Rep08",5120,5120,5050,5100,5120,5075,0.009,45,5097.5,"Rep",0,-50,FALSE,FALSE,FALSE,0.89,"young",33,164,105,"f"
12,"CHEST PRESS",1,"Rep09",5480,5480,5650,5550,5480,5600,0.022,-120,5540,"Rep",0,100,FALSE,FALSE,FALSE,2.14,"young",33,164,105,"f"
12,"CHEST PRESS",1,"Rep10",6280,6280,6350,6500,6280,6425,0.023,-145,6352.5,"Rep",0,-150,TRUE,FALSE,FALSE,2.26,"young",33,164,105,"f"
12,"CHEST PRESS",2,"Rep01",5200,5200,5150,5100,5200,5125,0.014,75,5162.5,"Rep",0,50,FALSE,FALSE,FALSE,1.46,"young",33,164,105,"f"
12,"CHEST PRESS",2,"Rep02",5020,4980,4800,5000,5000,4900,0.02,100,4950,"Rep",40,-200,FALSE,FALSE,TRUE,2.04,"young",33,164,105,"f"
12,"CHEST PRESS",2,"Rep03",4820,4880,4950,5050,4850,5000,0.031,-150,4925,"Rep",-60,-100,TRUE,FALSE,FALSE,3,"young",33,164,105,"f"
12,"CHEST PRESS",2,"Rep04",4920,4880,4900,4850,4900,4875,0.005,25,4887.5,"Rep",40,50,FALSE,FALSE,FALSE,0.51,"young",33,164,105,"f"
12,"CHEST PRESS",2,"Rep05",5340,5360,5400,5300,5350,5350,0,0,5350,"Rep",-20,100,FALSE,FALSE,FALSE,0,"young",33,164,105,"f"
12,"CHEST PRESS",2,"Rep06",4940,4940,5000,5000,4940,5000,0.012,-60,4970,"Rep",0,0,FALSE,FALSE,FALSE,1.2,"young",33,164,105,"f"
12,"CHEST PRESS",2,"Rep07",4820,4840,4800,4800,4830,4800,0.006,30,4815,"Rep",-20,0,FALSE,FALSE,FALSE,0.62,"young",33,164,105,"f"
12,"CHEST PRESS",2,"Rep08",5180,5140,5000,5100,5160,5050,0.021,110,5105,"Rep",40,-100,FALSE,FALSE,FALSE,2.18,"young",33,164,105,"f"
12,"CHEST PRESS",2,"Rep09",4840,4860,5000,5000,4850,5000,0.031,-150,4925,"Rep",-20,0,TRUE,FALSE,FALSE,3,"young",33,164,105,"f"
12,"CHEST PRESS",2,"Rep10",7380,7400,7400,7400,7390,7400,0.001,-10,7395,"Rep",-20,0,FALSE,FALSE,FALSE,0.14,"young",33,164,105,"f"
12,"CHEST PRESS",1,"TuT",50260,50260,50100,50300,50260,50200,0.001,60,50230,"TuT",0,-200,FALSE,FALSE,FALSE,0.12,"young",33,164,105,"f"
12,"CHEST PRESS",2,"TuT",52460,52480,52400,52600,52470,52500,0.001,-30,52485,"TuT",-20,-200,FALSE,FALSE,FALSE,0.06,"young",33,164,105,"f"
13,"LEG PRESS",1,"Con01",1080,1040,1250,1100,1060,1175,0.108,-115,1117.5,"Con",40,150,FALSE,FALSE,FALSE,9.79,"young",50,179,73,"m"
13,"LEG PRESS",1,"Con02",860,860,900,900,860,900,0.047,-40,880,"Con",0,0,FALSE,FALSE,FALSE,4.44,"young",50,179,73,"m"
13,"LEG PRESS",1,"Con03",820,800,850,850,810,850,0.049,-40,830,"Con",20,0,FALSE,FALSE,FALSE,4.71,"young",50,179,73,"m"
13,"LEG PRESS",1,"Con04",760,760,800,800,760,800,0.053,-40,780,"Con",0,0,FALSE,FALSE,FALSE,5,"young",50,179,73,"m"
13,"LEG PRESS",1,"Con05",780,780,800,800,780,800,0.026,-20,790,"Con",0,0,FALSE,FALSE,FALSE,2.5,"young",50,179,73,"m"
13,"LEG PRESS",1,"Con06",800,800,800,800,800,800,0,0,800,"Con",0,0,FALSE,FALSE,FALSE,0,"young",50,179,73,"m"
13,"LEG PRESS",1,"Con07",800,780,850,850,790,850,0.076,-60,820,"Con",20,0,FALSE,FALSE,FALSE,7.06,"young",50,179,73,"m"
13,"LEG PRESS",1,"Con08",780,780,850,850,780,850,0.09,-70,815,"Con",0,0,FALSE,FALSE,FALSE,8.24,"young",50,179,73,"m"
13,"LEG PRESS",1,"Con09",840,820,900,900,830,900,0.084,-70,865,"Con",20,0,FALSE,FALSE,FALSE,7.78,"young",50,179,73,"m"
13,"LEG PRESS",1,"Con10",820,820,900,900,820,900,0.098,-80,860,"Con",0,0,FALSE,FALSE,FALSE,8.89,"young",50,179,73,"m"
13,"LEG PRESS",2,"Con01",1080,1080,1100,1150,1080,1125,0.042,-45,1102.5,"Con",0,-50,FALSE,FALSE,FALSE,4,"young",50,179,73,"m"
13,"LEG PRESS",2,"Con02",840,840,850,850,840,850,0.012,-10,845,"Con",0,0,FALSE,FALSE,FALSE,1.18,"young",50,179,73,"m"
13,"LEG PRESS",2,"Con03",820,820,900,850,820,875,0.067,-55,847.5,"Con",0,50,FALSE,FALSE,FALSE,6.29,"young",50,179,73,"m"
13,"LEG PRESS",2,"Con04",840,840,850,850,840,850,0.012,-10,845,"Con",0,0,FALSE,FALSE,FALSE,1.18,"young",50,179,73,"m"
13,"LEG PRESS",2,"Con05",840,820,850,850,830,850,0.024,-20,840,"Con",20,0,FALSE,FALSE,FALSE,2.35,"young",50,179,73,"m"
13,"LEG PRESS",2,"Con06",800,800,850,850,800,850,0.062,-50,825,"Con",0,0,FALSE,FALSE,FALSE,5.88,"young",50,179,73,"m"
13,"LEG PRESS",2,"Con07",800,800,750,850,800,800,0,0,800,"Con",0,-100,FALSE,FALSE,FALSE,0,"young",50,179,73,"m"
13,"LEG PRESS",2,"Con08",800,780,800,800,790,800,0.013,-10,795,"Con",20,0,FALSE,FALSE,FALSE,1.25,"young",50,179,73,"m"
13,"LEG PRESS",2,"Con09",860,860,900,900,860,900,0.047,-40,880,"Con",0,0,FALSE,FALSE,FALSE,4.44,"young",50,179,73,"m"
13,"LEG PRESS",2,"Con10",940,940,1000,1050,940,1025,0.09,-85,982.5,"Con",0,-50,FALSE,FALSE,FALSE,8.29,"young",50,179,73,"m"
13,"LEG PRESS",1,"Ecc01",1060,1060,1050,1050,1060,1050,0.009,10,1055,"Ecc",0,0,FALSE,FALSE,FALSE,0.95,"young",50,179,73,"m"
13,"LEG PRESS",1,"Ecc02",980,1000,950,950,990,950,0.04,40,970,"Ecc",-20,0,FALSE,FALSE,FALSE,4.21,"young",50,179,73,"m"
13,"LEG PRESS",1,"Ecc03",880,880,850,850,880,850,0.034,30,865,"Ecc",0,0,FALSE,FALSE,FALSE,3.53,"young",50,179,73,"m"
13,"LEG PRESS",1,"Ecc04",880,880,850,850,880,850,0.034,30,865,"Ecc",0,0,FALSE,FALSE,FALSE,3.53,"young",50,179,73,"m"
13,"LEG PRESS",1,"Ecc05",860,860,850,850,860,850,0.012,10,855,"Ecc",0,0,FALSE,FALSE,FALSE,1.18,"young",50,179,73,"m"
13,"LEG PRESS",1,"Ecc06",900,920,850,850,910,850,0.066,60,880,"Ecc",-20,0,FALSE,FALSE,FALSE,7.06,"young",50,179,73,"m"
13,"LEG PRESS",1,"Ecc07",880,880,850,850,880,850,0.034,30,865,"Ecc",0,0,FALSE,FALSE,FALSE,3.53,"young",50,179,73,"m"
13,"LEG PRESS",1,"Ecc08",940,940,850,850,940,850,0.096,90,895,"Ecc",0,0,FALSE,FALSE,FALSE,10.59,"young",50,179,73,"m"
13,"LEG PRESS",1,"Ecc09",960,980,900,900,970,900,0.072,70,935,"Ecc",-20,0,FALSE,FALSE,FALSE,7.78,"young",50,179,73,"m"
13,"LEG PRESS",1,"Ecc10",1840,1820,2450,2700,1830,2575,0.407,-745,2202.5,"Ecc",20,-250,TRUE,FALSE,TRUE,28.93,"young",50,179,73,"m"
13,"LEG PRESS",2,"Ecc01",920,900,900,900,910,900,0.011,10,905,"Ecc",20,0,FALSE,FALSE,FALSE,1.11,"young",50,179,73,"m"
13,"LEG PRESS",2,"Ecc02",980,980,900,950,980,925,0.056,55,952.5,"Ecc",0,-50,FALSE,FALSE,FALSE,5.95,"young",50,179,73,"m"
13,"LEG PRESS",2,"Ecc03",920,920,900,900,920,900,0.022,20,910,"Ecc",0,0,FALSE,FALSE,FALSE,2.22,"young",50,179,73,"m"
13,"LEG PRESS",2,"Ecc04",900,900,900,900,900,900,0,0,900,"Ecc",0,0,FALSE,FALSE,FALSE,0,"young",50,179,73,"m"
13,"LEG PRESS",2,"Ecc05",920,940,900,900,930,900,0.032,30,915,"Ecc",-20,0,FALSE,FALSE,FALSE,3.33,"young",50,179,73,"m"
13,"LEG PRESS",2,"Ecc06",900,900,900,850,900,875,0.028,25,887.5,"Ecc",0,50,FALSE,FALSE,FALSE,2.86,"young",50,179,73,"m"
13,"LEG PRESS",2,"Ecc07",840,860,850,800,850,825,0.029,25,837.5,"Ecc",-20,50,FALSE,FALSE,FALSE,3.03,"young",50,179,73,"m"
13,"LEG PRESS",2,"Ecc08",900,900,900,900,900,900,0,0,900,"Ecc",0,0,FALSE,FALSE,FALSE,0,"young",50,179,73,"m"
13,"LEG PRESS",2,"Ecc09",1000,1000,950,900,1000,925,0.075,75,962.5,"Ecc",0,50,FALSE,FALSE,FALSE,8.11,"young",50,179,73,"m"
13,"LEG PRESS",2,"Ecc10",1820,1820,1850,1850,1820,1850,0.016,-30,1835,"Ecc",0,0,FALSE,FALSE,FALSE,1.62,"young",50,179,73,"m"
13,"LEG PRESS",1,"Rep01",2140,2100,2300,2150,2120,2225,0.05,-105,2172.5,"Rep",40,150,FALSE,FALSE,TRUE,4.72,"young",50,179,73,"m"
13,"LEG PRESS",1,"Rep02",1840,1860,1850,1850,1850,1850,0,0,1850,"Rep",-20,0,FALSE,FALSE,FALSE,0,"young",50,179,73,"m"
13,"LEG PRESS",1,"Rep03",1700,1680,1700,1700,1690,1700,0.006,-10,1695,"Rep",20,0,FALSE,FALSE,FALSE,0.59,"young",50,179,73,"m"
13,"LEG PRESS",1,"Rep04",1640,1640,1650,1650,1640,1650,0.006,-10,1645,"Rep",0,0,FALSE,FALSE,FALSE,0.61,"young",50,179,73,"m"
13,"LEG PRESS",1,"Rep05",1640,1640,1650,1650,1640,1650,0.006,-10,1645,"Rep",0,0,FALSE,FALSE,FALSE,0.61,"young",50,179,73,"m"
13,"LEG PRESS",1,"Rep06",1700,1720,1650,1650,1710,1650,0.035,60,1680,"Rep",-20,0,FALSE,FALSE,FALSE,3.64,"young",50,179,73,"m"
13,"LEG PRESS",1,"Rep07",1680,1660,1700,1700,1670,1700,0.018,-30,1685,"Rep",20,0,FALSE,FALSE,FALSE,1.76,"young",50,179,73,"m"
13,"LEG PRESS",1,"Rep08",1720,1720,1700,1700,1720,1700,0.012,20,1710,"Rep",0,0,FALSE,FALSE,FALSE,1.18,"young",50,179,73,"m"
13,"LEG PRESS",1,"Rep09",1800,1800,1800,1800,1800,1800,0,0,1800,"Rep",0,0,FALSE,FALSE,FALSE,0,"young",50,179,73,"m"
13,"LEG PRESS",1,"Rep10",2660,2640,3350,3600,2650,3475,0.311,-825,3062.5,"Rep",20,-250,TRUE,FALSE,TRUE,23.74,"young",50,179,73,"m"
13,"LEG PRESS",2,"Rep01",2000,1980,2000,2050,1990,2025,0.018,-35,2007.5,"Rep",20,-50,FALSE,FALSE,FALSE,1.73,"young",50,179,73,"m"
13,"LEG PRESS",2,"Rep02",1820,1820,1750,1800,1820,1775,0.025,45,1797.5,"Rep",0,-50,FALSE,FALSE,FALSE,2.54,"young",50,179,73,"m"
13,"LEG PRESS",2,"Rep03",1740,1740,1800,1750,1740,1775,0.02,-35,1757.5,"Rep",0,50,FALSE,FALSE,FALSE,1.97,"young",50,179,73,"m"
13,"LEG PRESS",2,"Rep04",1740,1740,1750,1750,1740,1750,0.006,-10,1745,"Rep",0,0,FALSE,FALSE,FALSE,0.57,"young",50,179,73,"m"
13,"LEG PRESS",2,"Rep05",1760,1760,1750,1750,1760,1750,0.006,10,1755,"Rep",0,0,FALSE,FALSE,FALSE,0.57,"young",50,179,73,"m"
13,"LEG PRESS",2,"Rep06",1700,1700,1750,1700,1700,1725,0.015,-25,1712.5,"Rep",0,50,FALSE,FALSE,FALSE,1.45,"young",50,179,73,"m"
13,"LEG PRESS",2,"Rep07",1640,1660,1600,1650,1650,1625,0.015,25,1637.5,"Rep",-20,-50,FALSE,FALSE,FALSE,1.54,"young",50,179,73,"m"
13,"LEG PRESS",2,"Rep08",1700,1680,1700,1700,1690,1700,0.006,-10,1695,"Rep",20,0,FALSE,FALSE,FALSE,0.59,"young",50,179,73,"m"
13,"LEG PRESS",2,"Rep09",1860,1860,1850,1800,1860,1825,0.019,35,1842.5,"Rep",0,50,FALSE,FALSE,FALSE,1.92,"young",50,179,73,"m"
13,"LEG PRESS",2,"Rep10",2760,2760,2850,2900,2760,2875,0.042,-115,2817.5,"Rep",0,-50,TRUE,FALSE,FALSE,4,"young",50,179,73,"m"
13,"LEG PRESS",1,"TuT",18520,18460,19350,19450,18490,19400,0.049,-910,18945,"TuT",60,-100,TRUE,FALSE,FALSE,4.69,"young",50,179,73,"m"
13,"LEG PRESS",2,"TuT",18720,18700,18800,18850,18710,18825,0.006,-115,18767.5,"TuT",20,-50,FALSE,FALSE,FALSE,0.61,"young",50,179,73,"m"
13,"LEG EXTENSION",1,"Con01",1260,1260,1350,1250,1260,1300,0.032,-40,1280,"Con",0,100,FALSE,FALSE,FALSE,3.08,"young",50,179,73,"m"
13,"LEG EXTENSION",1,"Con02",960,980,900,950,970,925,0.046,45,947.5,"Con",-20,-50,FALSE,FALSE,FALSE,4.86,"young",50,179,73,"m"
13,"LEG EXTENSION",1,"Con03",940,940,950,950,940,950,0.011,-10,945,"Con",0,0,FALSE,FALSE,FALSE,1.05,"young",50,179,73,"m"
13,"LEG EXTENSION",1,"Con04",940,940,1000,1000,940,1000,0.064,-60,970,"Con",0,0,FALSE,FALSE,FALSE,6,"young",50,179,73,"m"
13,"LEG EXTENSION",1,"Con05",900,900,950,950,900,950,0.056,-50,925,"Con",0,0,FALSE,FALSE,FALSE,5.26,"young",50,179,73,"m"
13,"LEG EXTENSION",1,"Con06",880,860,900,850,870,875,0.006,-5,872.5,"Con",20,50,FALSE,FALSE,FALSE,0.57,"young",50,179,73,"m"
13,"LEG EXTENSION",1,"Con07",940,920,1000,950,930,975,0.048,-45,952.5,"Con",20,50,FALSE,FALSE,FALSE,4.62,"young",50,179,73,"m"
13,"LEG EXTENSION",1,"Con08",900,900,1000,950,900,975,0.083,-75,937.5,"Con",0,50,FALSE,FALSE,FALSE,7.69,"young",50,179,73,"m"
13,"LEG EXTENSION",1,"Con09",900,900,950,950,900,950,0.056,-50,925,"Con",0,0,FALSE,FALSE,FALSE,5.26,"young",50,179,73,"m"
13,"LEG EXTENSION",1,"Con10",900,880,950,950,890,950,0.067,-60,920,"Con",20,0,FALSE,FALSE,FALSE,6.32,"young",50,179,73,"m"
13,"LEG EXTENSION",2,"Con01",1180,1200,1300,1250,1190,1275,0.071,-85,1232.5,"Con",-20,50,FALSE,FALSE,FALSE,6.67,"young",50,179,73,"m"
13,"LEG EXTENSION",2,"Con02",880,900,850,850,890,850,0.045,40,870,"Con",-20,0,FALSE,FALSE,FALSE,4.71,"young",50,179,73,"m"
13,"LEG EXTENSION",2,"Con03",960,960,900,900,960,900,0.062,60,930,"Con",0,0,FALSE,FALSE,FALSE,6.67,"young",50,179,73,"m"
13,"LEG EXTENSION",2,"Con04",920,920,950,950,920,950,0.033,-30,935,"Con",0,0,FALSE,FALSE,FALSE,3.16,"young",50,179,73,"m"
13,"LEG EXTENSION",2,"Con05",900,900,950,950,900,950,0.056,-50,925,"Con",0,0,FALSE,FALSE,FALSE,5.26,"young",50,179,73,"m"
13,"LEG EXTENSION",2,"Con06",880,880,950,900,880,925,0.051,-45,902.5,"Con",0,50,FALSE,FALSE,FALSE,4.86,"young",50,179,73,"m"
13,"LEG EXTENSION",2,"Con07",860,860,900,900,860,900,0.047,-40,880,"Con",0,0,FALSE,FALSE,FALSE,4.44,"young",50,179,73,"m"
13,"LEG EXTENSION",2,"Con08",820,820,850,850,820,850,0.037,-30,835,"Con",0,0,FALSE,FALSE,FALSE,3.53,"young",50,179,73,"m"
13,"LEG EXTENSION",2,"Con09",840,840,850,850,840,850,0.012,-10,845,"Con",0,0,FALSE,FALSE,FALSE,1.18,"young",50,179,73,"m"
13,"LEG EXTENSION",2,"Con10",860,860,850,900,860,875,0.017,-15,867.5,"Con",0,-50,FALSE,FALSE,FALSE,1.71,"young",50,179,73,"m"
13,"LEG EXTENSION",1,"Ecc01",1140,1140,1200,1200,1140,1200,0.053,-60,1170,"Ecc",0,0,FALSE,FALSE,FALSE,5,"young",50,179,73,"m"
13,"LEG EXTENSION",1,"Ecc02",1080,1060,1100,1050,1070,1075,0.005,-5,1072.5,"Ecc",20,50,FALSE,FALSE,FALSE,0.47,"young",50,179,73,"m"
13,"LEG EXTENSION",1,"Ecc03",1200,1200,1150,1150,1200,1150,0.042,50,1175,"Ecc",0,0,FALSE,FALSE,FALSE,4.35,"young",50,179,73,"m"
13,"LEG EXTENSION",1,"Ecc04",1060,1060,1000,1000,1060,1000,0.057,60,1030,"Ecc",0,0,FALSE,FALSE,FALSE,6,"young",50,179,73,"m"
13,"LEG EXTENSION",1,"Ecc05",920,940,900,950,930,925,0.005,5,927.5,"Ecc",-20,-50,FALSE,FALSE,FALSE,0.54,"young",50,179,73,"m"
13,"LEG EXTENSION",1,"Ecc06",920,920,900,900,920,900,0.022,20,910,"Ecc",0,0,FALSE,FALSE,FALSE,2.22,"young",50,179,73,"m"
13,"LEG EXTENSION",1,"Ecc07",940,960,850,900,950,875,0.079,75,912.5,"Ecc",-20,-50,FALSE,FALSE,FALSE,8.57,"young",50,179,73,"m"
13,"LEG EXTENSION",1,"Ecc08",940,940,850,900,940,875,0.069,65,907.5,"Ecc",0,-50,FALSE,FALSE,FALSE,7.43,"young",50,179,73,"m"
13,"LEG EXTENSION",1,"Ecc09",920,940,900,900,930,900,0.032,30,915,"Ecc",-20,0,FALSE,FALSE,FALSE,3.33,"young",50,179,73,"m"
13,"LEG EXTENSION",1,"Ecc10",2440,2460,2450,2450,2450,2450,0,0,2450,"Ecc",-20,0,FALSE,FALSE,FALSE,0,"young",50,179,73,"m"
13,"LEG EXTENSION",2,"Ecc01",940,920,950,1000,930,975,0.048,-45,952.5,"Ecc",20,-50,FALSE,FALSE,FALSE,4.62,"young",50,179,73,"m"
13,"LEG EXTENSION",2,"Ecc02",900,900,950,950,900,950,0.056,-50,925,"Ecc",0,0,FALSE,FALSE,FALSE,5.26,"young",50,179,73,"m"
13,"LEG EXTENSION",2,"Ecc03",1000,1000,1000,1000,1000,1000,0,0,1000,"Ecc",0,0,FALSE,FALSE,FALSE,0,"young",50,179,73,"m"
13,"LEG EXTENSION",2,"Ecc04",1000,1000,950,950,1000,950,0.05,50,975,"Ecc",0,0,FALSE,FALSE,FALSE,5.26,"young",50,179,73,"m"
13,"LEG EXTENSION",2,"Ecc05",960,960,900,900,960,900,0.062,60,930,"Ecc",0,0,FALSE,FALSE,FALSE,6.67,"young",50,179,73,"m"
13,"LEG EXTENSION",2,"Ecc06",920,920,900,900,920,900,0.022,20,910,"Ecc",0,0,FALSE,FALSE,FALSE,2.22,"young",50,179,73,"m"
13,"LEG EXTENSION",2,"Ecc07",920,920,850,900,920,875,0.049,45,897.5,"Ecc",0,-50,FALSE,FALSE,FALSE,5.14,"young",50,179,73,"m"
13,"LEG EXTENSION",2,"Ecc08",860,860,850,850,860,850,0.012,10,855,"Ecc",0,0,FALSE,FALSE,FALSE,1.18,"young",50,179,73,"m"
13,"LEG EXTENSION",2,"Ecc09",820,820,850,800,820,825,0.006,-5,822.5,"Ecc",0,50,FALSE,FALSE,FALSE,0.61,"young",50,179,73,"m"
13,"LEG EXTENSION",2,"Ecc10",1560,1580,1600,1600,1570,1600,0.019,-30,1585,"Ecc",-20,0,FALSE,FALSE,FALSE,1.88,"young",50,179,73,"m"
13,"LEG EXTENSION",1,"Rep01",2400,2400,2550,2450,2400,2500,0.042,-100,2450,"Rep",0,100,FALSE,FALSE,FALSE,4,"young",50,179,73,"m"
13,"LEG EXTENSION",1,"Rep02",2040,2040,2000,2000,2040,2000,0.02,40,2020,"Rep",0,0,FALSE,FALSE,FALSE,2,"young",50,179,73,"m"
13,"LEG EXTENSION",1,"Rep03",2140,2140,2100,2100,2140,2100,0.019,40,2120,"Rep",0,0,FALSE,FALSE,FALSE,1.9,"young",50,179,73,"m"
13,"LEG EXTENSION",1,"Rep04",2000,2000,2000,2000,2000,2000,0,0,2000,"Rep",0,0,FALSE,FALSE,FALSE,0,"young",50,179,73,"m"
13,"LEG EXTENSION",1,"Rep05",1820,1840,1850,1900,1830,1875,0.025,-45,1852.5,"Rep",-20,-50,FALSE,FALSE,FALSE,2.4,"young",50,179,73,"m"
13,"LEG EXTENSION",1,"Rep06",1800,1780,1800,1750,1790,1775,0.008,15,1782.5,"Rep",20,50,FALSE,FALSE,FALSE,0.85,"young",50,179,73,"m"
13,"LEG EXTENSION",1,"Rep07",1880,1880,1850,1850,1880,1850,0.016,30,1865,"Rep",0,0,FALSE,FALSE,FALSE,1.62,"young",50,179,73,"m"
13,"LEG EXTENSION",1,"Rep08",1840,1840,1850,1850,1840,1850,0.005,-10,1845,"Rep",0,0,FALSE,FALSE,FALSE,0.54,"young",50,179,73,"m"
13,"LEG EXTENSION",1,"Rep09",1820,1840,1850,1850,1830,1850,0.011,-20,1840,"Rep",-20,0,FALSE,FALSE,FALSE,1.08,"young",50,179,73,"m"
13,"LEG EXTENSION",1,"Rep10",3340,3340,3400,3400,3340,3400,0.018,-60,3370,"Rep",0,0,FALSE,FALSE,FALSE,1.76,"young",50,179,73,"m"
13,"LEG EXTENSION",2,"Rep01",2120,2120,2250,2250,2120,2250,0.061,-130,2185,"Rep",0,0,TRUE,FALSE,FALSE,5.78,"young",50,179,73,"m"
13,"LEG EXTENSION",2,"Rep02",1780,1800,1800,1800,1790,1800,0.006,-10,1795,"Rep",-20,0,FALSE,FALSE,FALSE,0.56,"young",50,179,73,"m"
13,"LEG EXTENSION",2,"Rep03",1960,1960,1900,1900,1960,1900,0.031,60,1930,"Rep",0,0,FALSE,FALSE,FALSE,3.16,"young",50,179,73,"m"
13,"LEG EXTENSION",2,"Rep04",1920,1920,1900,1900,1920,1900,0.01,20,1910,"Rep",0,0,FALSE,FALSE,FALSE,1.05,"young",50,179,73,"m"
13,"LEG EXTENSION",2,"Rep05",1860,1860,1850,1850,1860,1850,0.005,10,1855,"Rep",0,0,FALSE,FALSE,FALSE,0.54,"young",50,179,73,"m"
13,"LEG EXTENSION",2,"Rep06",1800,1800,1850,1800,1800,1825,0.014,-25,1812.5,"Rep",0,50,FALSE,FALSE,FALSE,1.37,"young",50,179,73,"m"
13,"LEG EXTENSION",2,"Rep07",1780,1780,1750,1800,1780,1775,0.003,5,1777.5,"Rep",0,-50,FALSE,FALSE,FALSE,0.28,"young",50,179,73,"m"
13,"LEG EXTENSION",2,"Rep08",1680,1680,1700,1700,1680,1700,0.012,-20,1690,"Rep",0,0,FALSE,FALSE,FALSE,1.18,"young",50,179,73,"m"
13,"LEG EXTENSION",2,"Rep09",1660,1660,1700,1650,1660,1675,0.009,-15,1667.5,"Rep",0,50,FALSE,FALSE,FALSE,0.9,"young",50,179,73,"m"
13,"LEG EXTENSION",2,"Rep10",2420,2440,2450,2500,2430,2475,0.019,-45,2452.5,"Rep",-20,-50,FALSE,FALSE,FALSE,1.82,"young",50,179,73,"m"
13,"LEG EXTENSION",1,"TuT",21080,21100,21250,21150,21090,21200,0.005,-110,21145,"TuT",-20,100,FALSE,FALSE,FALSE,0.52,"young",50,179,73,"m"
13,"LEG EXTENSION",2,"TuT",18980,19020,19150,19150,19000,19150,0.008,-150,19075,"TuT",-40,0,FALSE,FALSE,FALSE,0.78,"young",50,179,73,"m"
13,"LEG CURL",1,"Con01",2620,2640,1600,1600,2630,1600,0.392,1030,2115,"Con",-20,0,TRUE,FALSE,FALSE,64.38,"young",50,179,73,"m"
13,"LEG CURL",1,"Con02",1620,1640,1350,1350,1630,1350,0.172,280,1490,"Con",-20,0,TRUE,FALSE,FALSE,20.74,"young",50,179,73,"m"
13,"LEG CURL",1,"Con03",1340,1360,1250,1350,1350,1300,0.037,50,1325,"Con",-20,-100,FALSE,FALSE,FALSE,3.85,"young",50,179,73,"m"
13,"LEG CURL",1,"Con04",1260,1280,1150,1150,1270,1150,0.094,120,1210,"Con",-20,0,FALSE,FALSE,FALSE,10.43,"young",50,179,73,"m"
13,"LEG CURL",1,"Con05",1100,1100,1200,1150,1100,1175,0.068,-75,1137.5,"Con",0,50,FALSE,FALSE,FALSE,6.38,"young",50,179,73,"m"
13,"LEG CURL",1,"Con06",1120,1120,1300,1300,1120,1300,0.161,-180,1210,"Con",0,0,FALSE,FALSE,FALSE,13.85,"young",50,179,73,"m"
13,"LEG CURL",1,"Con07",1240,1240,1250,1200,1240,1225,0.012,15,1232.5,"Con",0,50,FALSE,FALSE,FALSE,1.22,"young",50,179,73,"m"
13,"LEG CURL",1,"Con08",1160,1160,1200,1150,1160,1175,0.013,-15,1167.5,"Con",0,50,FALSE,FALSE,FALSE,1.28,"young",50,179,73,"m"
13,"LEG CURL",1,"Con09",1120,1120,1300,1250,1120,1275,0.138,-155,1197.5,"Con",0,50,FALSE,FALSE,FALSE,12.16,"young",50,179,73,"m"
13,"LEG CURL",1,"Con10",1180,1160,0,0,1170,0,1,1170,585,"Con",20,0,TRUE,FALSE,FALSE,NA,"young",50,179,73,"m"
13,"LEG CURL",2,"Con01",1440,1440,1400,1400,1440,1400,0.028,40,1420,"Con",0,0,FALSE,FALSE,FALSE,2.86,"young",50,179,73,"m"
13,"LEG CURL",2,"Con02",1000,1000,1000,950,1000,975,0.025,25,987.5,"Con",0,50,FALSE,FALSE,FALSE,2.56,"young",50,179,73,"m"
13,"LEG CURL",2,"Con03",960,960,950,950,960,950,0.01,10,955,"Con",0,0,FALSE,FALSE,FALSE,1.05,"young",50,179,73,"m"
13,"LEG CURL",2,"Con04",940,940,950,1000,940,975,0.037,-35,957.5,"Con",0,-50,FALSE,FALSE,FALSE,3.59,"young",50,179,73,"m"
13,"LEG CURL",2,"Con05",920,940,950,950,930,950,0.022,-20,940,"Con",-20,0,FALSE,FALSE,FALSE,2.11,"young",50,179,73,"m"
13,"LEG CURL",2,"Con06",940,940,1000,1000,940,1000,0.064,-60,970,"Con",0,0,FALSE,FALSE,FALSE,6,"young",50,179,73,"m"
13,"LEG CURL",2,"Con07",960,980,1000,1050,970,1025,0.057,-55,997.5,"Con",-20,-50,FALSE,FALSE,FALSE,5.37,"young",50,179,73,"m"
13,"LEG CURL",2,"Con08",940,960,950,950,950,950,0,0,950,"Con",-20,0,FALSE,FALSE,FALSE,0,"young",50,179,73,"m"
13,"LEG CURL",2,"Con09",960,960,1000,1000,960,1000,0.042,-40,980,"Con",0,0,FALSE,FALSE,FALSE,4,"young",50,179,73,"m"
13,"LEG CURL",2,"Con10",980,980,1100,1050,980,1075,0.097,-95,1027.5,"Con",0,50,FALSE,FALSE,FALSE,8.84,"young",50,179,73,"m"
13,"LEG CURL",1,"Ecc01",1920,1920,1950,1950,1920,1950,0.016,-30,1935,"Ecc",0,0,FALSE,FALSE,FALSE,1.54,"young",50,179,73,"m"
13,"LEG CURL",1,"Ecc02",1980,1940,1700,1650,1960,1675,0.145,285,1817.5,"Ecc",40,50,TRUE,FALSE,FALSE,17.01,"young",50,179,73,"m"
13,"LEG CURL",1,"Ecc03",1700,1680,1550,1500,1690,1525,0.098,165,1607.5,"Ecc",20,50,FALSE,FALSE,FALSE,10.82,"young",50,179,73,"m"
13,"LEG CURL",1,"Ecc04",1580,1580,1600,1600,1580,1600,0.013,-20,1590,"Ecc",0,0,FALSE,FALSE,FALSE,1.25,"young",50,179,73,"m"
13,"LEG CURL",1,"Ecc05",1660,1660,1350,1400,1660,1375,0.172,285,1517.5,"Ecc",0,-50,TRUE,FALSE,FALSE,20.73,"young",50,179,73,"m"
13,"LEG CURL",1,"Ecc06",1420,1420,1300,1350,1420,1325,0.067,95,1372.5,"Ecc",0,-50,FALSE,FALSE,FALSE,7.17,"young",50,179,73,"m"
13,"LEG CURL",1,"Ecc07",1360,1360,1250,1300,1360,1275,0.062,85,1317.5,"Ecc",0,-50,FALSE,FALSE,FALSE,6.67,"young",50,179,73,"m"
13,"LEG CURL",1,"Ecc08",1320,1320,1250,1300,1320,1275,0.034,45,1297.5,"Ecc",0,-50,FALSE,FALSE,FALSE,3.53,"young",50,179,73,"m"
13,"LEG CURL",1,"Ecc09",1360,1380,1950,2000,1370,1975,0.442,-605,1672.5,"Ecc",-20,-50,TRUE,FALSE,FALSE,30.63,"young",50,179,73,"m"
13,"LEG CURL",1,"Ecc10",3300,3300,0,0,3300,0,1,3300,1650,"Ecc",0,0,TRUE,FALSE,FALSE,NA,"young",50,179,73,"m"
13,"LEG CURL",2,"Ecc01",1140,1140,1150,1150,1140,1150,0.009,-10,1145,"Ecc",0,0,FALSE,FALSE,FALSE,0.87,"young",50,179,73,"m"
13,"LEG CURL",2,"Ecc02",1160,1160,1150,1200,1160,1175,0.013,-15,1167.5,"Ecc",0,-50,FALSE,FALSE,FALSE,1.28,"young",50,179,73,"m"
13,"LEG CURL",2,"Ecc03",1140,1140,1150,1100,1140,1125,0.013,15,1132.5,"Ecc",0,50,FALSE,FALSE,FALSE,1.33,"young",50,179,73,"m"
13,"LEG CURL",2,"Ecc04",1140,1120,1100,1100,1130,1100,0.027,30,1115,"Ecc",20,0,FALSE,FALSE,FALSE,2.73,"young",50,179,73,"m"
13,"LEG CURL",2,"Ecc05",1080,1080,1050,1050,1080,1050,0.028,30,1065,"Ecc",0,0,FALSE,FALSE,FALSE,2.86,"young",50,179,73,"m"
13,"LEG CURL",2,"Ecc06",1180,1160,1150,1100,1170,1125,0.038,45,1147.5,"Ecc",20,50,FALSE,FALSE,FALSE,4,"young",50,179,73,"m"
13,"LEG CURL",2,"Ecc07",1080,1080,1050,1050,1080,1050,0.028,30,1065,"Ecc",0,0,FALSE,FALSE,FALSE,2.86,"young",50,179,73,"m"
13,"LEG CURL",2,"Ecc08",1100,1080,1050,1050,1090,1050,0.037,40,1070,"Ecc",20,0,FALSE,FALSE,FALSE,3.81,"young",50,179,73,"m"
13,"LEG CURL",2,"Ecc09",1160,1160,1100,1100,1160,1100,0.052,60,1130,"Ecc",0,0,FALSE,FALSE,FALSE,5.45,"young",50,179,73,"m"
13,"LEG CURL",2,"Ecc10",3080,3080,3100,3100,3080,3100,0.006,-20,3090,"Ecc",0,0,FALSE,FALSE,FALSE,0.65,"young",50,179,73,"m"
13,"LEG CURL",1,"Rep01",4540,4560,3550,3550,4550,3550,0.22,1000,4050,"Rep",-20,0,TRUE,FALSE,FALSE,28.17,"young",50,179,73,"m"
13,"LEG CURL",1,"Rep02",3600,3580,3050,3000,3590,3025,0.157,565,3307.5,"Rep",20,50,TRUE,FALSE,FALSE,18.68,"young",50,179,73,"m"
13,"LEG CURL",1,"Rep03",3040,3040,2800,2850,3040,2825,0.071,215,2932.5,"Rep",0,-50,TRUE,FALSE,FALSE,7.61,"young",50,179,73,"m"
13,"LEG CURL",1,"Rep04",2840,2860,2750,2750,2850,2750,0.035,100,2800,"Rep",-20,0,FALSE,FALSE,FALSE,3.64,"young",50,179,73,"m"
13,"LEG CURL",1,"Rep05",2760,2760,2550,2550,2760,2550,0.076,210,2655,"Rep",0,0,TRUE,FALSE,FALSE,8.24,"young",50,179,73,"m"
13,"LEG CURL",1,"Rep06",2540,2540,2600,2650,2540,2625,0.033,-85,2582.5,"Rep",0,-50,FALSE,FALSE,FALSE,3.24,"young",50,179,73,"m"
13,"LEG CURL",1,"Rep07",2600,2600,2500,2500,2600,2500,0.038,100,2550,"Rep",0,0,FALSE,FALSE,FALSE,4,"young",50,179,73,"m"
13,"LEG CURL",1,"Rep08",2480,2480,2450,2450,2480,2450,0.012,30,2465,"Rep",0,0,FALSE,FALSE,FALSE,1.22,"young",50,179,73,"m"
13,"LEG CURL",1,"Rep09",2480,2500,3250,3250,2490,3250,0.305,-760,2870,"Rep",-20,0,TRUE,FALSE,FALSE,23.38,"young",50,179,73,"m"
13,"LEG CURL",1,"Rep10",4480,4460,0,0,4470,0,1,4470,2235,"Rep",20,0,TRUE,FALSE,FALSE,NA,"young",50,179,73,"m"
13,"LEG CURL",2,"Rep01",2580,2580,2550,2550,2580,2550,0.012,30,2565,"Rep",0,0,FALSE,FALSE,FALSE,1.18,"young",50,179,73,"m"
13,"LEG CURL",2,"Rep02",2160,2160,2150,2150,2160,2150,0.005,10,2155,"Rep",0,0,FALSE,FALSE,FALSE,0.47,"young",50,179,73,"m"
13,"LEG CURL",2,"Rep03",2100,2100,2100,2050,2100,2075,0.012,25,2087.5,"Rep",0,50,FALSE,FALSE,FALSE,1.2,"young",50,179,73,"m"
13,"LEG CURL",2,"Rep04",2080,2060,2050,2100,2070,2075,0.002,-5,2072.5,"Rep",20,-50,FALSE,FALSE,FALSE,0.24,"young",50,179,73,"m"
13,"LEG CURL",2,"Rep05",2000,2020,2000,2000,2010,2000,0.005,10,2005,"Rep",-20,0,FALSE,FALSE,FALSE,0.5,"young",50,179,73,"m"
13,"LEG CURL",2,"Rep06",2120,2100,2150,2100,2110,2125,0.007,-15,2117.5,"Rep",20,50,FALSE,FALSE,FALSE,0.71,"young",50,179,73,"m"
13,"LEG CURL",2,"Rep07",2040,2060,2050,2100,2050,2075,0.012,-25,2062.5,"Rep",-20,-50,FALSE,FALSE,FALSE,1.2,"young",50,179,73,"m"
13,"LEG CURL",2,"Rep08",2040,2040,2000,2000,2040,2000,0.02,40,2020,"Rep",0,0,FALSE,FALSE,FALSE,2,"young",50,179,73,"m"
13,"LEG CURL",2,"Rep09",2120,2120,2100,2100,2120,2100,0.009,20,2110,"Rep",0,0,FALSE,FALSE,FALSE,0.95,"young",50,179,73,"m"
13,"LEG CURL",2,"Rep10",4060,4060,4200,4150,4060,4175,0.028,-115,4117.5,"Rep",0,50,FALSE,FALSE,FALSE,2.75,"young",50,179,73,"m"
13,"LEG CURL",1,"TuT",31360,31380,25500,25550,31370,25525,0.186,5845,28447.5,"TuT",-20,-50,TRUE,FALSE,FALSE,22.9,"young",50,179,73,"m"
13,"LEG CURL",2,"TuT",23300,23300,23350,23300,23300,23325,0.001,-25,23312.5,"TuT",0,50,FALSE,FALSE,FALSE,0.11,"young",50,179,73,"m"
13,"ABDUCTOR",1,"Con01",900,860,1300,1300,880,1300,0.477,-420,1090,"Con",40,0,TRUE,TRUE,FALSE,32.31,"young",50,179,73,"m"
13,"ABDUCTOR",1,"Con02",620,640,800,750,630,775,0.23,-145,702.5,"Con",-20,50,FALSE,FALSE,FALSE,18.71,"young",50,179,73,"m"
13,"ABDUCTOR",1,"Con03",700,720,800,800,710,800,0.127,-90,755,"Con",-20,0,FALSE,FALSE,FALSE,11.25,"young",50,179,73,"m"
13,"ABDUCTOR",1,"Con04",660,660,700,700,660,700,0.061,-40,680,"Con",0,0,FALSE,FALSE,FALSE,5.71,"young",50,179,73,"m"
13,"ABDUCTOR",1,"Con05",720,740,750,750,730,750,0.027,-20,740,"Con",-20,0,FALSE,FALSE,FALSE,2.67,"young",50,179,73,"m"
13,"ABDUCTOR",1,"Con06",640,660,800,750,650,775,0.192,-125,712.5,"Con",-20,50,FALSE,FALSE,FALSE,16.13,"young",50,179,73,"m"
13,"ABDUCTOR",1,"Con07",700,740,850,800,720,825,0.146,-105,772.5,"Con",-40,50,FALSE,TRUE,FALSE,12.73,"young",50,179,73,"m"
13,"ABDUCTOR",1,"Con08",660,680,850,850,670,850,0.269,-180,760,"Con",-20,0,FALSE,FALSE,FALSE,21.18,"young",50,179,73,"m"
13,"ABDUCTOR",1,"Con09",660,660,900,850,660,875,0.326,-215,767.5,"Con",0,50,FALSE,FALSE,FALSE,24.57,"young",50,179,73,"m"
13,"ABDUCTOR",1,"Con10",660,700,850,800,680,825,0.213,-145,752.5,"Con",-40,50,FALSE,TRUE,FALSE,17.58,"young",50,179,73,"m"
13,"ABDUCTOR",2,"Con01",1080,1040,1950,1900,1060,1925,0.816,-865,1492.5,"Con",40,50,TRUE,TRUE,FALSE,44.94,"young",50,179,73,"m"
13,"ABDUCTOR",2,"Con02",700,720,800,800,710,800,0.127,-90,755,"Con",-20,0,FALSE,FALSE,FALSE,11.25,"young",50,179,73,"m"
13,"ABDUCTOR",2,"Con03",800,800,800,800,800,800,0,0,800,"Con",0,0,FALSE,FALSE,FALSE,0,"young",50,179,73,"m"
13,"ABDUCTOR",2,"Con04",680,720,750,800,700,775,0.107,-75,737.5,"Con",-40,-50,FALSE,TRUE,FALSE,9.68,"young",50,179,73,"m"
13,"ABDUCTOR",2,"Con05",700,700,700,750,700,725,0.036,-25,712.5,"Con",0,-50,FALSE,FALSE,FALSE,3.45,"young",50,179,73,"m"
13,"ABDUCTOR",2,"Con06",680,720,800,800,700,800,0.143,-100,750,"Con",-40,0,FALSE,TRUE,FALSE,12.5,"young",50,179,73,"m"
13,"ABDUCTOR",2,"Con07",680,700,850,850,690,850,0.232,-160,770,"Con",-20,0,FALSE,FALSE,FALSE,18.82,"young",50,179,73,"m"
13,"ABDUCTOR",2,"Con08",660,680,850,850,670,850,0.269,-180,760,"Con",-20,0,FALSE,FALSE,FALSE,21.18,"young",50,179,73,"m"
13,"ABDUCTOR",2,"Con09",640,620,800,800,630,800,0.27,-170,715,"Con",20,0,FALSE,FALSE,FALSE,21.25,"young",50,179,73,"m"
13,"ABDUCTOR",2,"Con10",740,740,850,800,740,825,0.115,-85,782.5,"Con",0,50,FALSE,FALSE,FALSE,10.3,"young",50,179,73,"m"
13,"ABDUCTOR",1,"Ecc01",1060,1060,950,1000,1060,975,0.08,85,1017.5,"Ecc",0,-50,FALSE,FALSE,FALSE,8.72,"young",50,179,73,"m"
13,"ABDUCTOR",1,"Ecc02",1240,1200,1100,1100,1220,1100,0.098,120,1160,"Ecc",40,0,FALSE,TRUE,FALSE,10.91,"young",50,179,73,"m"
13,"ABDUCTOR",1,"Ecc03",1100,1100,1050,1050,1100,1050,0.045,50,1075,"Ecc",0,0,FALSE,FALSE,FALSE,4.76,"young",50,179,73,"m"
13,"ABDUCTOR",1,"Ecc04",960,940,950,950,950,950,0,0,950,"Ecc",20,0,FALSE,FALSE,FALSE,0,"young",50,179,73,"m"
13,"ABDUCTOR",1,"Ecc05",1120,1100,1000,1050,1110,1025,0.077,85,1067.5,"Ecc",20,-50,FALSE,FALSE,FALSE,8.29,"young",50,179,73,"m"
13,"ABDUCTOR",1,"Ecc06",1040,1020,900,950,1030,925,0.102,105,977.5,"Ecc",20,-50,FALSE,FALSE,FALSE,11.35,"young",50,179,73,"m"
13,"ABDUCTOR",1,"Ecc07",1100,1080,900,900,1090,900,0.174,190,995,"Ecc",20,0,FALSE,FALSE,FALSE,21.11,"young",50,179,73,"m"
13,"ABDUCTOR",1,"Ecc08",1040,1020,800,850,1030,825,0.199,205,927.5,"Ecc",20,-50,FALSE,FALSE,FALSE,24.85,"young",50,179,73,"m"
13,"ABDUCTOR",1,"Ecc09",1040,1020,850,900,1030,875,0.15,155,952.5,"Ecc",20,-50,FALSE,FALSE,FALSE,17.71,"young",50,179,73,"m"
13,"ABDUCTOR",1,"Ecc10",1760,1740,1550,1750,1750,1650,0.057,100,1700,"Ecc",20,-200,FALSE,FALSE,FALSE,6.06,"young",50,179,73,"m"
13,"ABDUCTOR",2,"Ecc01",1120,1120,1000,950,1120,975,0.129,145,1047.5,"Ecc",0,50,FALSE,FALSE,FALSE,14.87,"young",50,179,73,"m"
13,"ABDUCTOR",2,"Ecc02",1020,1020,1000,1000,1020,1000,0.02,20,1010,"Ecc",0,0,FALSE,FALSE,FALSE,2,"young",50,179,73,"m"
13,"ABDUCTOR",2,"Ecc03",1180,1140,1100,1100,1160,1100,0.052,60,1130,"Ecc",40,0,FALSE,TRUE,FALSE,5.45,"young",50,179,73,"m"
13,"ABDUCTOR",2,"Ecc04",1060,1040,1050,1000,1050,1025,0.024,25,1037.5,"Ecc",20,50,FALSE,FALSE,FALSE,2.44,"young",50,179,73,"m"
13,"ABDUCTOR",2,"Ecc05",1020,1020,1000,950,1020,975,0.044,45,997.5,"Ecc",0,50,FALSE,FALSE,FALSE,4.62,"young",50,179,73,"m"
13,"ABDUCTOR",2,"Ecc06",1100,1060,900,900,1080,900,0.167,180,990,"Ecc",40,0,FALSE,TRUE,FALSE,20,"young",50,179,73,"m"
13,"ABDUCTOR",2,"Ecc07",1100,1080,900,900,1090,900,0.174,190,995,"Ecc",20,0,FALSE,FALSE,FALSE,21.11,"young",50,179,73,"m"
13,"ABDUCTOR",2,"Ecc08",1120,1100,950,950,1110,950,0.144,160,1030,"Ecc",20,0,FALSE,FALSE,FALSE,16.84,"young",50,179,73,"m"
13,"ABDUCTOR",2,"Ecc09",1020,1040,900,950,1030,925,0.102,105,977.5,"Ecc",-20,-50,FALSE,FALSE,FALSE,11.35,"young",50,179,73,"m"
13,"ABDUCTOR",2,"Ecc10",1720,1660,1750,1600,1690,1675,0.009,15,1682.5,"Ecc",60,150,FALSE,TRUE,FALSE,0.9,"young",50,179,73,"m"
13,"ABDUCTOR",1,"Rep01",1960,1920,2250,2300,1940,2275,0.173,-335,2107.5,"Rep",40,-50,TRUE,FALSE,FALSE,14.73,"young",50,179,73,"m"
13,"ABDUCTOR",1,"Rep02",1860,1840,1900,1850,1850,1875,0.014,-25,1862.5,"Rep",20,50,FALSE,FALSE,FALSE,1.33,"young",50,179,73,"m"
13,"ABDUCTOR",1,"Rep03",1800,1820,1850,1850,1810,1850,0.022,-40,1830,"Rep",-20,0,FALSE,FALSE,FALSE,2.16,"young",50,179,73,"m"
13,"ABDUCTOR",1,"Rep04",1620,1600,1650,1650,1610,1650,0.025,-40,1630,"Rep",20,0,FALSE,FALSE,FALSE,2.42,"young",50,179,73,"m"
13,"ABDUCTOR",1,"Rep05",1840,1840,1750,1800,1840,1775,0.035,65,1807.5,"Rep",0,-50,FALSE,FALSE,FALSE,3.66,"young",50,179,73,"m"
13,"ABDUCTOR",1,"Rep06",1680,1680,1700,1700,1680,1700,0.012,-20,1690,"Rep",0,0,FALSE,FALSE,FALSE,1.18,"young",50,179,73,"m"
13,"ABDUCTOR",1,"Rep07",1800,1820,1750,1700,1810,1725,0.047,85,1767.5,"Rep",-20,50,FALSE,FALSE,FALSE,4.93,"young",50,179,73,"m"
13,"ABDUCTOR",1,"Rep08",1700,1700,1650,1700,1700,1675,0.015,25,1687.5,"Rep",0,-50,FALSE,FALSE,FALSE,1.49,"young",50,179,73,"m"
13,"ABDUCTOR",1,"Rep09",1700,1680,1750,1750,1690,1750,0.036,-60,1720,"Rep",20,0,FALSE,FALSE,FALSE,3.43,"young",50,179,73,"m"
13,"ABDUCTOR",1,"Rep10",2420,2440,2400,2550,2430,2475,0.019,-45,2452.5,"Rep",-20,-150,FALSE,FALSE,FALSE,1.82,"young",50,179,73,"m"
13,"ABDUCTOR",2,"Rep01",2200,2160,2950,2850,2180,2900,0.33,-720,2540,"Rep",40,100,TRUE,FALSE,FALSE,24.83,"young",50,179,73,"m"
13,"ABDUCTOR",2,"Rep02",1720,1740,1800,1800,1730,1800,0.04,-70,1765,"Rep",-20,0,FALSE,FALSE,FALSE,3.89,"young",50,179,73,"m"
13,"ABDUCTOR",2,"Rep03",1980,1940,1900,1900,1960,1900,0.031,60,1930,"Rep",40,0,FALSE,FALSE,FALSE,3.16,"young",50,179,73,"m"
13,"ABDUCTOR",2,"Rep04",1740,1760,1800,1800,1750,1800,0.029,-50,1775,"Rep",-20,0,FALSE,FALSE,FALSE,2.78,"young",50,179,73,"m"
13,"ABDUCTOR",2,"Rep05",1720,1720,1700,1700,1720,1700,0.012,20,1710,"Rep",0,0,FALSE,FALSE,FALSE,1.18,"young",50,179,73,"m"
13,"ABDUCTOR",2,"Rep06",1780,1780,1700,1700,1780,1700,0.045,80,1740,"Rep",0,0,FALSE,FALSE,FALSE,4.71,"young",50,179,73,"m"
13,"ABDUCTOR",2,"Rep07",1780,1780,1750,1750,1780,1750,0.017,30,1765,"Rep",0,0,FALSE,FALSE,FALSE,1.71,"young",50,179,73,"m"
13,"ABDUCTOR",2,"Rep08",1780,1780,1800,1800,1780,1800,0.011,-20,1790,"Rep",0,0,FALSE,FALSE,FALSE,1.11,"young",50,179,73,"m"
13,"ABDUCTOR",2,"Rep09",1660,1660,1700,1750,1660,1725,0.039,-65,1692.5,"Rep",0,-50,FALSE,FALSE,FALSE,3.77,"young",50,179,73,"m"
13,"ABDUCTOR",2,"Rep10",2460,2400,2600,2400,2430,2500,0.029,-70,2465,"Rep",60,200,FALSE,FALSE,FALSE,2.8,"young",50,179,73,"m"
13,"ABDUCTOR",1,"TuT",18380,18340,18650,18850,18360,18750,0.021,-390,18555,"TuT",40,-200,FALSE,TRUE,FALSE,2.08,"young",50,179,73,"m"
13,"ABDUCTOR",2,"TuT",18820,18720,19700,19450,18770,19575,0.043,-805,19172.5,"TuT",100,250,TRUE,TRUE,FALSE,4.11,"young",50,179,73,"m"
13,"ADDUCTOR",1,"Con01",760,740,1000,850,750,925,0.233,-175,837.5,"Con",20,150,FALSE,FALSE,FALSE,18.92,"young",50,179,73,"m"
13,"ADDUCTOR",1,"Con02",740,760,850,750,750,800,0.067,-50,775,"Con",-20,100,FALSE,FALSE,FALSE,6.25,"young",50,179,73,"m"
13,"ADDUCTOR",1,"Con03",740,760,650,800,750,725,0.033,25,737.5,"Con",-20,-150,FALSE,FALSE,FALSE,3.45,"young",50,179,73,"m"
13,"ADDUCTOR",1,"Con04",760,760,700,850,760,775,0.02,-15,767.5,"Con",0,-150,FALSE,FALSE,FALSE,1.94,"young",50,179,73,"m"
13,"ADDUCTOR",1,"Con05",860,820,550,650,840,600,0.286,240,720,"Con",40,-100,FALSE,TRUE,FALSE,40,"young",50,179,73,"m"
13,"ADDUCTOR",1,"Con06",800,840,600,700,820,650,0.207,170,735,"Con",-40,-100,FALSE,TRUE,FALSE,26.15,"young",50,179,73,"m"
13,"ADDUCTOR",1,"Con07",780,760,800,800,770,800,0.039,-30,785,"Con",20,0,FALSE,FALSE,FALSE,3.75,"young",50,179,73,"m"
13,"ADDUCTOR",1,"Con08",800,820,950,900,810,925,0.142,-115,867.5,"Con",-20,50,FALSE,FALSE,FALSE,12.43,"young",50,179,73,"m"
13,"ADDUCTOR",1,"Con09",700,720,1000,900,710,950,0.338,-240,830,"Con",-20,100,FALSE,FALSE,FALSE,25.26,"young",50,179,73,"m"
13,"ADDUCTOR",1,"Con10",840,840,1200,1100,840,1150,0.369,-310,995,"Con",0,100,FALSE,FALSE,FALSE,26.96,"young",50,179,73,"m"
13,"ADDUCTOR",2,"Con01",860,880,750,900,870,825,0.052,45,847.5,"Con",-20,-150,FALSE,FALSE,FALSE,5.45,"young",50,179,73,"m"
13,"ADDUCTOR",2,"Con02",740,740,650,700,740,675,0.088,65,707.5,"Con",0,-50,FALSE,FALSE,FALSE,9.63,"young",50,179,73,"m"
13,"ADDUCTOR",2,"Con03",760,780,700,750,770,725,0.058,45,747.5,"Con",-20,-50,FALSE,FALSE,FALSE,6.21,"young",50,179,73,"m"
13,"ADDUCTOR",2,"Con04",740,760,700,750,750,725,0.033,25,737.5,"Con",-20,-50,FALSE,FALSE,FALSE,3.45,"young",50,179,73,"m"
13,"ADDUCTOR",2,"Con05",700,700,700,700,700,700,0,0,700,"Con",0,0,FALSE,FALSE,FALSE,0,"young",50,179,73,"m"
13,"ADDUCTOR",2,"Con06",740,720,750,800,730,775,0.062,-45,752.5,"Con",20,-50,FALSE,FALSE,FALSE,5.81,"young",50,179,73,"m"
13,"ADDUCTOR",2,"Con07",740,760,800,900,750,850,0.133,-100,800,"Con",-20,-100,FALSE,FALSE,FALSE,11.76,"young",50,179,73,"m"
13,"ADDUCTOR",2,"Con08",660,680,700,800,670,750,0.119,-80,710,"Con",-20,-100,FALSE,FALSE,FALSE,10.67,"young",50,179,73,"m"
13,"ADDUCTOR",2,"Con09",760,740,850,850,750,850,0.133,-100,800,"Con",20,0,FALSE,FALSE,FALSE,11.76,"young",50,179,73,"m"
13,"ADDUCTOR",2,"Con10",820,860,1100,900,840,1000,0.19,-160,920,"Con",-40,200,FALSE,TRUE,FALSE,16,"young",50,179,73,"m"
13,"ADDUCTOR",1,"Ecc01",960,960,750,800,960,775,0.193,185,867.5,"Ecc",0,-50,FALSE,FALSE,FALSE,23.87,"young",50,179,73,"m"
13,"ADDUCTOR",1,"Ecc02",700,680,800,800,690,800,0.159,-110,745,"Ecc",20,0,FALSE,FALSE,FALSE,13.75,"young",50,179,73,"m"
13,"ADDUCTOR",1,"Ecc03",980,980,950,800,980,875,0.107,105,927.5,"Ecc",0,150,FALSE,FALSE,FALSE,12,"young",50,179,73,"m"
13,"ADDUCTOR",1,"Ecc04",720,760,1000,850,740,925,0.25,-185,832.5,"Ecc",-40,150,FALSE,TRUE,FALSE,20,"young",50,179,73,"m"
13,"ADDUCTOR",1,"Ecc05",820,780,1100,1000,800,1050,0.312,-250,925,"Ecc",40,100,FALSE,TRUE,FALSE,23.81,"young",50,179,73,"m"
13,"ADDUCTOR",1,"Ecc06",800,820,850,800,810,825,0.019,-15,817.5,"Ecc",-20,50,FALSE,FALSE,FALSE,1.82,"young",50,179,73,"m"
13,"ADDUCTOR",1,"Ecc07",760,740,650,700,750,675,0.1,75,712.5,"Ecc",20,-50,FALSE,FALSE,FALSE,11.11,"young",50,179,73,"m"
13,"ADDUCTOR",1,"Ecc08",820,800,650,700,810,675,0.167,135,742.5,"Ecc",20,-50,FALSE,FALSE,FALSE,20,"young",50,179,73,"m"
13,"ADDUCTOR",1,"Ecc09",800,800,450,600,800,525,0.344,275,662.5,"Ecc",0,-150,FALSE,FALSE,FALSE,52.38,"young",50,179,73,"m"
13,"ADDUCTOR",1,"Ecc10",1600,1600,1600,1550,1600,1575,0.016,25,1587.5,"Ecc",0,50,FALSE,FALSE,FALSE,1.59,"young",50,179,73,"m"
13,"ADDUCTOR",2,"Ecc01",860,840,950,950,850,950,0.118,-100,900,"Ecc",20,0,FALSE,FALSE,FALSE,10.53,"young",50,179,73,"m"
13,"ADDUCTOR",2,"Ecc02",920,920,1000,950,920,975,0.06,-55,947.5,"Ecc",0,50,FALSE,FALSE,FALSE,5.64,"young",50,179,73,"m"
13,"ADDUCTOR",2,"Ecc03",800,780,850,800,790,825,0.044,-35,807.5,"Ecc",20,50,FALSE,FALSE,FALSE,4.24,"young",50,179,73,"m"
13,"ADDUCTOR",2,"Ecc04",860,840,850,850,850,850,0,0,850,"Ecc",20,0,FALSE,FALSE,FALSE,0,"young",50,179,73,"m"
13,"ADDUCTOR",2,"Ecc05",900,900,900,850,900,875,0.028,25,887.5,"Ecc",0,50,FALSE,FALSE,FALSE,2.86,"young",50,179,73,"m"
13,"ADDUCTOR",2,"Ecc06",840,860,800,750,850,775,0.088,75,812.5,"Ecc",-20,50,FALSE,FALSE,FALSE,9.68,"young",50,179,73,"m"
13,"ADDUCTOR",2,"Ecc07",860,820,800,700,840,750,0.107,90,795,"Ecc",40,100,FALSE,TRUE,FALSE,12,"young",50,179,73,"m"
13,"ADDUCTOR",2,"Ecc08",900,900,850,750,900,800,0.111,100,850,"Ecc",0,100,FALSE,FALSE,FALSE,12.5,"young",50,179,73,"m"
13,"ADDUCTOR",2,"Ecc09",840,840,700,850,840,775,0.077,65,807.5,"Ecc",0,-150,FALSE,FALSE,FALSE,8.39,"young",50,179,73,"m"
13,"ADDUCTOR",2,"Ecc10",1840,1800,1750,1800,1820,1775,0.025,45,1797.5,"Ecc",40,-50,FALSE,TRUE,FALSE,2.54,"young",50,179,73,"m"
13,"ADDUCTOR",1,"Rep01",1720,1700,1750,1650,1710,1700,0.006,10,1705,"Rep",20,100,FALSE,FALSE,FALSE,0.59,"young",50,179,73,"m"
13,"ADDUCTOR",1,"Rep02",1440,1440,1650,1550,1440,1600,0.111,-160,1520,"Rep",0,100,FALSE,FALSE,FALSE,10,"young",50,179,73,"m"
13,"ADDUCTOR",1,"Rep03",1720,1740,1600,1600,1730,1600,0.075,130,1665,"Rep",-20,0,FALSE,FALSE,FALSE,8.12,"young",50,179,73,"m"
13,"ADDUCTOR",1,"Rep04",1480,1520,1700,1700,1500,1700,0.133,-200,1600,"Rep",-40,0,FALSE,FALSE,FALSE,11.76,"young",50,179,73,"m"
13,"ADDUCTOR",1,"Rep05",1680,1600,1650,1650,1640,1650,0.006,-10,1645,"Rep",80,0,FALSE,TRUE,FALSE,0.61,"young",50,179,73,"m"
13,"ADDUCTOR",1,"Rep06",1600,1660,1450,1500,1630,1475,0.095,155,1552.5,"Rep",-60,-50,FALSE,FALSE,FALSE,10.51,"young",50,179,73,"m"
13,"ADDUCTOR",1,"Rep07",1540,1500,1450,1500,1520,1475,0.03,45,1497.5,"Rep",40,-50,FALSE,FALSE,FALSE,3.05,"young",50,179,73,"m"
13,"ADDUCTOR",1,"Rep08",1620,1620,1600,1600,1620,1600,0.012,20,1610,"Rep",0,0,FALSE,FALSE,FALSE,1.25,"young",50,179,73,"m"
13,"ADDUCTOR",1,"Rep09",1500,1520,1450,1500,1510,1475,0.023,35,1492.5,"Rep",-20,-50,FALSE,FALSE,FALSE,2.37,"young",50,179,73,"m"
13,"ADDUCTOR",1,"Rep10",2440,2440,2800,2650,2440,2725,0.117,-285,2582.5,"Rep",0,150,FALSE,FALSE,FALSE,10.46,"young",50,179,73,"m"
13,"ADDUCTOR",2,"Rep01",1720,1720,1700,1850,1720,1775,0.032,-55,1747.5,"Rep",0,-150,FALSE,FALSE,FALSE,3.1,"young",50,179,73,"m"
13,"ADDUCTOR",2,"Rep02",1660,1660,1650,1650,1660,1650,0.006,10,1655,"Rep",0,0,FALSE,FALSE,FALSE,0.61,"young",50,179,73,"m"
13,"ADDUCTOR",2,"Rep03",1560,1560,1550,1550,1560,1550,0.006,10,1555,"Rep",0,0,FALSE,FALSE,FALSE,0.65,"young",50,179,73,"m"
13,"ADDUCTOR",2,"Rep04",1600,1600,1550,1600,1600,1575,0.016,25,1587.5,"Rep",0,-50,FALSE,FALSE,FALSE,1.59,"young",50,179,73,"m"
13,"ADDUCTOR",2,"Rep05",1600,1600,1600,1550,1600,1575,0.016,25,1587.5,"Rep",0,50,FALSE,FALSE,FALSE,1.59,"young",50,179,73,"m"
13,"ADDUCTOR",2,"Rep06",1580,1580,1550,1550,1580,1550,0.019,30,1565,"Rep",0,0,FALSE,FALSE,FALSE,1.94,"young",50,179,73,"m"
13,"ADDUCTOR",2,"Rep07",1600,1580,1600,1600,1590,1600,0.006,-10,1595,"Rep",20,0,FALSE,FALSE,FALSE,0.62,"young",50,179,73,"m"
13,"ADDUCTOR",2,"Rep08",1560,1580,1550,1550,1570,1550,0.013,20,1560,"Rep",-20,0,FALSE,FALSE,FALSE,1.29,"young",50,179,73,"m"
13,"ADDUCTOR",2,"Rep09",1600,1580,1550,1700,1590,1625,0.022,-35,1607.5,"Rep",20,-150,FALSE,FALSE,FALSE,2.15,"young",50,179,73,"m"
13,"ADDUCTOR",2,"Rep10",2660,2660,2850,2700,2660,2775,0.043,-115,2717.5,"Rep",0,150,FALSE,FALSE,FALSE,4.14,"young",50,179,73,"m"
13,"ADDUCTOR",1,"TuT",16740,16740,17100,16900,16740,17000,0.016,-260,16870,"TuT",0,200,FALSE,FALSE,FALSE,1.53,"young",50,179,73,"m"
13,"ADDUCTOR",2,"TuT",17140,17120,17150,17300,17130,17225,0.006,-95,17177.5,"TuT",20,-150,FALSE,FALSE,FALSE,0.55,"young",50,179,73,"m"
13,"LOWER BACK",1,"Con01",1400,1400,1500,1400,1400,1450,0.036,-50,1425,"Con",0,100,FALSE,FALSE,FALSE,3.45,"young",50,179,73,"m"
13,"LOWER BACK",1,"Con02",1060,1060,1050,1050,1060,1050,0.009,10,1055,"Con",0,0,FALSE,FALSE,FALSE,0.95,"young",50,179,73,"m"
13,"LOWER BACK",1,"Con03",1060,1040,1100,1050,1050,1075,0.024,-25,1062.5,"Con",20,50,FALSE,FALSE,FALSE,2.33,"young",50,179,73,"m"
13,"LOWER BACK",1,"Con04",1060,1080,1100,1050,1070,1075,0.005,-5,1072.5,"Con",-20,50,FALSE,FALSE,FALSE,0.47,"young",50,179,73,"m"
13,"LOWER BACK",1,"Con05",1000,1000,1050,1050,1000,1050,0.05,-50,1025,"Con",0,0,FALSE,FALSE,FALSE,4.76,"young",50,179,73,"m"
13,"LOWER BACK",1,"Con06",1020,1040,1050,1000,1030,1025,0.005,5,1027.5,"Con",-20,50,FALSE,FALSE,FALSE,0.49,"young",50,179,73,"m"
13,"LOWER BACK",1,"Con07",1060,1060,1100,1100,1060,1100,0.038,-40,1080,"Con",0,0,FALSE,FALSE,FALSE,3.64,"young",50,179,73,"m"
13,"LOWER BACK",1,"Con08",980,980,1050,1050,980,1050,0.071,-70,1015,"Con",0,0,FALSE,FALSE,FALSE,6.67,"young",50,179,73,"m"
13,"LOWER BACK",1,"Con09",1020,1020,1050,1100,1020,1075,0.054,-55,1047.5,"Con",0,-50,FALSE,FALSE,FALSE,5.12,"young",50,179,73,"m"
13,"LOWER BACK",1,"Con10",1020,1020,1050,1100,1020,1075,0.054,-55,1047.5,"Con",0,-50,FALSE,FALSE,FALSE,5.12,"young",50,179,73,"m"
13,"LOWER BACK",2,"Con01",1180,1180,1350,1200,1180,1275,0.081,-95,1227.5,"Con",0,150,FALSE,FALSE,FALSE,7.45,"young",50,179,73,"m"
13,"LOWER BACK",2,"Con02",980,980,950,1000,980,975,0.005,5,977.5,"Con",0,-50,FALSE,FALSE,FALSE,0.51,"young",50,179,73,"m"
13,"LOWER BACK",2,"Con03",1040,1040,1050,1000,1040,1025,0.014,15,1032.5,"Con",0,50,FALSE,FALSE,FALSE,1.46,"young",50,179,73,"m"
13,"LOWER BACK",2,"Con04",1060,1040,1050,1000,1050,1025,0.024,25,1037.5,"Con",20,50,FALSE,FALSE,FALSE,2.44,"young",50,179,73,"m"
13,"LOWER BACK",2,"Con05",1000,1020,1050,1050,1010,1050,0.04,-40,1030,"Con",-20,0,FALSE,FALSE,FALSE,3.81,"young",50,179,73,"m"
13,"LOWER BACK",2,"Con06",1000,1000,1050,1000,1000,1025,0.025,-25,1012.5,"Con",0,50,FALSE,FALSE,FALSE,2.44,"young",50,179,73,"m"
13,"LOWER BACK",2,"Con07",1000,1020,1000,1050,1010,1025,0.015,-15,1017.5,"Con",-20,-50,FALSE,FALSE,FALSE,1.46,"young",50,179,73,"m"
13,"LOWER BACK",2,"Con08",1020,1000,1000,1050,1010,1025,0.015,-15,1017.5,"Con",20,-50,FALSE,FALSE,FALSE,1.46,"young",50,179,73,"m"
13,"LOWER BACK",2,"Con09",960,960,1000,1000,960,1000,0.042,-40,980,"Con",0,0,FALSE,FALSE,FALSE,4,"young",50,179,73,"m"
13,"LOWER BACK",2,"Con10",1020,1020,1050,1100,1020,1075,0.054,-55,1047.5,"Con",0,-50,FALSE,FALSE,FALSE,5.12,"young",50,179,73,"m"
13,"LOWER BACK",1,"Ecc01",1240,1240,1250,1300,1240,1275,0.028,-35,1257.5,"Ecc",0,-50,FALSE,FALSE,FALSE,2.75,"young",50,179,73,"m"
13,"LOWER BACK",1,"Ecc02",1220,1240,1200,1200,1230,1200,0.024,30,1215,"Ecc",-20,0,FALSE,FALSE,FALSE,2.5,"young",50,179,73,"m"
13,"LOWER BACK",1,"Ecc03",1120,1120,1100,1150,1120,1125,0.004,-5,1122.5,"Ecc",0,-50,FALSE,FALSE,FALSE,0.44,"young",50,179,73,"m"
13,"LOWER BACK",1,"Ecc04",1160,1140,1100,1150,1150,1125,0.022,25,1137.5,"Ecc",20,-50,FALSE,FALSE,FALSE,2.22,"young",50,179,73,"m"
13,"LOWER BACK",1,"Ecc05",1120,1120,1100,1100,1120,1100,0.018,20,1110,"Ecc",0,0,FALSE,FALSE,FALSE,1.82,"young",50,179,73,"m"
13,"LOWER BACK",1,"Ecc06",1100,1080,1050,1100,1090,1075,0.014,15,1082.5,"Ecc",20,-50,FALSE,FALSE,FALSE,1.4,"young",50,179,73,"m"
13,"LOWER BACK",1,"Ecc07",1080,1080,1000,1000,1080,1000,0.074,80,1040,"Ecc",0,0,FALSE,FALSE,FALSE,8,"young",50,179,73,"m"
13,"LOWER BACK",1,"Ecc08",1060,1080,1050,1000,1070,1025,0.042,45,1047.5,"Ecc",-20,50,FALSE,FALSE,FALSE,4.39,"young",50,179,73,"m"
13,"LOWER BACK",1,"Ecc09",1040,1020,1000,950,1030,975,0.053,55,1002.5,"Ecc",20,50,FALSE,FALSE,FALSE,5.64,"young",50,179,73,"m"
13,"LOWER BACK",1,"Ecc10",1420,1440,1500,1450,1430,1475,0.031,-45,1452.5,"Ecc",-20,50,FALSE,FALSE,FALSE,3.05,"young",50,179,73,"m"
13,"LOWER BACK",2,"Ecc01",1020,1000,1050,1050,1010,1050,0.04,-40,1030,"Ecc",20,0,FALSE,FALSE,FALSE,3.81,"young",50,179,73,"m"
13,"LOWER BACK",2,"Ecc02",1060,1060,1050,1050,1060,1050,0.009,10,1055,"Ecc",0,0,FALSE,FALSE,FALSE,0.95,"young",50,179,73,"m"
13,"LOWER BACK",2,"Ecc03",1080,1100,1100,1150,1090,1125,0.032,-35,1107.5,"Ecc",-20,-50,FALSE,FALSE,FALSE,3.11,"young",50,179,73,"m"
13,"LOWER BACK",2,"Ecc04",1100,1100,1050,1100,1100,1075,0.023,25,1087.5,"Ecc",0,-50,FALSE,FALSE,FALSE,2.33,"young",50,179,73,"m"
13,"LOWER BACK",2,"Ecc05",1140,1120,1100,1100,1130,1100,0.027,30,1115,"Ecc",20,0,FALSE,FALSE,FALSE,2.73,"young",50,179,73,"m"
13,"LOWER BACK",2,"Ecc06",1020,1020,1000,1000,1020,1000,0.02,20,1010,"Ecc",0,0,FALSE,FALSE,FALSE,2,"young",50,179,73,"m"
13,"LOWER BACK",2,"Ecc07",1040,1040,1050,1000,1040,1025,0.014,15,1032.5,"Ecc",0,50,FALSE,FALSE,FALSE,1.46,"young",50,179,73,"m"
13,"LOWER BACK",2,"Ecc08",1020,1020,1000,1000,1020,1000,0.02,20,1010,"Ecc",0,0,FALSE,FALSE,FALSE,2,"young",50,179,73,"m"
13,"LOWER BACK",2,"Ecc09",1020,1020,1000,950,1020,975,0.044,45,997.5,"Ecc",0,50,FALSE,FALSE,FALSE,4.62,"young",50,179,73,"m"
13,"LOWER BACK",2,"Ecc10",1580,1580,1700,1600,1580,1650,0.044,-70,1615,"Ecc",0,100,FALSE,FALSE,FALSE,4.24,"young",50,179,73,"m"
13,"LOWER BACK",1,"Rep01",2640,2640,2750,2700,2640,2725,0.032,-85,2682.5,"Rep",0,50,FALSE,FALSE,FALSE,3.12,"young",50,179,73,"m"
13,"LOWER BACK",1,"Rep02",2280,2300,2250,2250,2290,2250,0.017,40,2270,"Rep",-20,0,FALSE,FALSE,FALSE,1.78,"young",50,179,73,"m"
13,"LOWER BACK",1,"Rep03",2180,2160,2200,2200,2170,2200,0.014,-30,2185,"Rep",20,0,FALSE,FALSE,FALSE,1.36,"young",50,179,73,"m"
13,"LOWER BACK",1,"Rep04",2220,2220,2200,2200,2220,2200,0.009,20,2210,"Rep",0,0,FALSE,FALSE,FALSE,0.91,"young",50,179,73,"m"
13,"LOWER BACK",1,"Rep05",2120,2120,2150,2150,2120,2150,0.014,-30,2135,"Rep",0,0,FALSE,FALSE,FALSE,1.4,"young",50,179,73,"m"
13,"LOWER BACK",1,"Rep06",2120,2120,2100,2100,2120,2100,0.009,20,2110,"Rep",0,0,FALSE,FALSE,FALSE,0.95,"young",50,179,73,"m"
13,"LOWER BACK",1,"Rep07",2140,2140,2100,2100,2140,2100,0.019,40,2120,"Rep",0,0,FALSE,FALSE,FALSE,1.9,"young",50,179,73,"m"
13,"LOWER BACK",1,"Rep08",2040,2060,2100,2050,2050,2075,0.012,-25,2062.5,"Rep",-20,50,FALSE,FALSE,FALSE,1.2,"young",50,179,73,"m"
13,"LOWER BACK",1,"Rep09",2060,2040,2050,2050,2050,2050,0,0,2050,"Rep",20,0,FALSE,FALSE,FALSE,0,"young",50,179,73,"m"
13,"LOWER BACK",1,"Rep10",2440,2460,2550,2550,2450,2550,0.041,-100,2500,"Rep",-20,0,TRUE,FALSE,FALSE,3.92,"young",50,179,73,"m"
13,"LOWER BACK",2,"Rep01",2200,2180,2400,2250,2190,2325,0.062,-135,2257.5,"Rep",20,150,TRUE,FALSE,FALSE,5.81,"young",50,179,73,"m"
13,"LOWER BACK",2,"Rep02",2040,2040,2000,2050,2040,2025,0.007,15,2032.5,"Rep",0,-50,FALSE,FALSE,FALSE,0.74,"young",50,179,73,"m"
13,"LOWER BACK",2,"Rep03",2120,2140,2150,2150,2130,2150,0.009,-20,2140,"Rep",-20,0,FALSE,FALSE,FALSE,0.93,"young",50,179,73,"m"
13,"LOWER BACK",2,"Rep04",2160,2140,2100,2100,2150,2100,0.023,50,2125,"Rep",20,0,FALSE,FALSE,FALSE,2.38,"young",50,179,73,"m"
13,"LOWER BACK",2,"Rep05",2140,2140,2150,2150,2140,2150,0.005,-10,2145,"Rep",0,0,FALSE,FALSE,FALSE,0.47,"young",50,179,73,"m"
13,"LOWER BACK",2,"Rep06",2020,2020,2050,2000,2020,2025,0.002,-5,2022.5,"Rep",0,50,FALSE,FALSE,FALSE,0.25,"young",50,179,73,"m"
13,"LOWER BACK",2,"Rep07",2040,2060,2050,2050,2050,2050,0,0,2050,"Rep",-20,0,FALSE,FALSE,FALSE,0,"young",50,179,73,"m"
13,"LOWER BACK",2,"Rep08",2040,2020,2000,2050,2030,2025,0.002,5,2027.5,"Rep",20,-50,FALSE,FALSE,FALSE,0.25,"young",50,179,73,"m"
13,"LOWER BACK",2,"Rep09",1980,1980,2000,1950,1980,1975,0.003,5,1977.5,"Rep",0,50,FALSE,FALSE,FALSE,0.25,"young",50,179,73,"m"
13,"LOWER BACK",2,"Rep10",2600,2600,2750,2700,2600,2725,0.048,-125,2662.5,"Rep",0,50,TRUE,FALSE,FALSE,4.59,"young",50,179,73,"m"
13,"LOWER BACK",1,"TuT",22240,22260,22450,22350,22250,22400,0.007,-150,22325,"TuT",-20,100,FALSE,FALSE,FALSE,0.67,"young",50,179,73,"m"
13,"LOWER BACK",2,"TuT",21340,21320,21650,21450,21330,21550,0.01,-220,21440,"TuT",20,200,TRUE,FALSE,FALSE,1.02,"young",50,179,73,"m"
13,"TOTAL ABDOMINAL",1,"Con01",1100,1100,1050,1150,1100,1100,0,0,1100,"Con",0,-100,FALSE,FALSE,FALSE,0,"young",50,179,73,"m"
13,"TOTAL ABDOMINAL",1,"Con02",900,920,850,850,910,850,0.066,60,880,"Con",-20,0,FALSE,FALSE,FALSE,7.06,"young",50,179,73,"m"
13,"TOTAL ABDOMINAL",1,"Con03",860,900,900,800,880,850,0.034,30,865,"Con",-40,100,FALSE,TRUE,FALSE,3.53,"young",50,179,73,"m"
13,"TOTAL ABDOMINAL",1,"Con04",880,900,900,850,890,875,0.017,15,882.5,"Con",-20,50,FALSE,FALSE,FALSE,1.71,"young",50,179,73,"m"
13,"TOTAL ABDOMINAL",1,"Con05",840,860,850,850,850,850,0,0,850,"Con",-20,0,FALSE,FALSE,FALSE,0,"young",50,179,73,"m"
13,"TOTAL ABDOMINAL",1,"Con06",820,840,850,850,830,850,0.024,-20,840,"Con",-20,0,FALSE,FALSE,FALSE,2.35,"young",50,179,73,"m"
13,"TOTAL ABDOMINAL",1,"Con07",860,880,900,900,870,900,0.034,-30,885,"Con",-20,0,FALSE,FALSE,FALSE,3.33,"young",50,179,73,"m"
13,"TOTAL ABDOMINAL",1,"Con08",820,820,850,900,820,875,0.067,-55,847.5,"Con",0,-50,FALSE,FALSE,FALSE,6.29,"young",50,179,73,"m"
13,"TOTAL ABDOMINAL",1,"Con09",860,860,900,900,860,900,0.047,-40,880,"Con",0,0,FALSE,FALSE,FALSE,4.44,"young",50,179,73,"m"
13,"TOTAL ABDOMINAL",1,"Con10",880,880,950,950,880,950,0.08,-70,915,"Con",0,0,FALSE,FALSE,FALSE,7.37,"young",50,179,73,"m"
13,"TOTAL ABDOMINAL",2,"Con01",1040,1040,1050,1100,1040,1075,0.034,-35,1057.5,"Con",0,-50,FALSE,FALSE,FALSE,3.26,"young",50,179,73,"m"
13,"TOTAL ABDOMINAL",2,"Con02",840,860,850,800,850,825,0.029,25,837.5,"Con",-20,50,FALSE,FALSE,FALSE,3.03,"young",50,179,73,"m"
13,"TOTAL ABDOMINAL",2,"Con03",900,900,900,850,900,875,0.028,25,887.5,"Con",0,50,FALSE,FALSE,FALSE,2.86,"young",50,179,73,"m"
13,"TOTAL ABDOMINAL",2,"Con04",800,800,850,800,800,825,0.031,-25,812.5,"Con",0,50,FALSE,FALSE,FALSE,3.03,"young",50,179,73,"m"
13,"TOTAL ABDOMINAL",2,"Con05",840,840,850,800,840,825,0.018,15,832.5,"Con",0,50,FALSE,FALSE,FALSE,1.82,"young",50,179,73,"m"
13,"TOTAL ABDOMINAL",2,"Con06",820,860,900,850,840,875,0.042,-35,857.5,"Con",-40,50,FALSE,TRUE,FALSE,4,"young",50,179,73,"m"
13,"TOTAL ABDOMINAL",2,"Con07",840,840,850,850,840,850,0.012,-10,845,"Con",0,0,FALSE,FALSE,FALSE,1.18,"young",50,179,73,"m"
13,"TOTAL ABDOMINAL",2,"Con08",820,840,800,850,830,825,0.006,5,827.5,"Con",-20,-50,FALSE,FALSE,FALSE,0.61,"young",50,179,73,"m"
13,"TOTAL ABDOMINAL",2,"Con09",840,840,850,850,840,850,0.012,-10,845,"Con",0,0,FALSE,FALSE,FALSE,1.18,"young",50,179,73,"m"
13,"TOTAL ABDOMINAL",2,"Con10",820,840,850,850,830,850,0.024,-20,840,"Con",-20,0,FALSE,FALSE,FALSE,2.35,"young",50,179,73,"m"
13,"TOTAL ABDOMINAL",1,"Ecc01",980,960,1100,1000,970,1050,0.082,-80,1010,"Ecc",20,100,FALSE,FALSE,FALSE,7.62,"young",50,179,73,"m"
13,"TOTAL ABDOMINAL",1,"Ecc02",880,860,850,950,870,900,0.034,-30,885,"Ecc",20,-100,FALSE,FALSE,FALSE,3.33,"young",50,179,73,"m"
13,"TOTAL ABDOMINAL",1,"Ecc03",920,880,900,950,900,925,0.028,-25,912.5,"Ecc",40,-50,FALSE,TRUE,FALSE,2.7,"young",50,179,73,"m"
13,"TOTAL ABDOMINAL",1,"Ecc04",900,880,900,950,890,925,0.039,-35,907.5,"Ecc",20,-50,FALSE,FALSE,FALSE,3.78,"young",50,179,73,"m"
13,"TOTAL ABDOMINAL",1,"Ecc05",880,860,850,850,870,850,0.023,20,860,"Ecc",20,0,FALSE,FALSE,FALSE,2.35,"young",50,179,73,"m"
13,"TOTAL ABDOMINAL",1,"Ecc06",880,860,850,850,870,850,0.023,20,860,"Ecc",20,0,FALSE,FALSE,FALSE,2.35,"young",50,179,73,"m"
13,"TOTAL ABDOMINAL",1,"Ecc07",880,880,850,800,880,825,0.062,55,852.5,"Ecc",0,50,FALSE,FALSE,FALSE,6.67,"young",50,179,73,"m"
13,"TOTAL ABDOMINAL",1,"Ecc08",900,900,850,850,900,850,0.056,50,875,"Ecc",0,0,FALSE,FALSE,FALSE,5.88,"young",50,179,73,"m"
13,"TOTAL ABDOMINAL",1,"Ecc09",900,900,850,850,900,850,0.056,50,875,"Ecc",0,0,FALSE,FALSE,FALSE,5.88,"young",50,179,73,"m"
13,"TOTAL ABDOMINAL",1,"Ecc10",1840,1860,1800,1850,1850,1825,0.014,25,1837.5,"Ecc",-20,-50,FALSE,FALSE,FALSE,1.37,"young",50,179,73,"m"
13,"TOTAL ABDOMINAL",2,"Ecc01",820,820,850,900,820,875,0.067,-55,847.5,"Ecc",0,-50,FALSE,FALSE,FALSE,6.29,"young",50,179,73,"m"
13,"TOTAL ABDOMINAL",2,"Ecc02",840,820,850,900,830,875,0.054,-45,852.5,"Ecc",20,-50,FALSE,FALSE,FALSE,5.14,"young",50,179,73,"m"
13,"TOTAL ABDOMINAL",2,"Ecc03",820,820,800,800,820,800,0.024,20,810,"Ecc",0,0,FALSE,FALSE,FALSE,2.5,"young",50,179,73,"m"
13,"TOTAL ABDOMINAL",2,"Ecc04",900,900,850,950,900,900,0,0,900,"Ecc",0,-100,FALSE,FALSE,FALSE,0,"young",50,179,73,"m"
13,"TOTAL ABDOMINAL",2,"Ecc05",840,820,800,850,830,825,0.006,5,827.5,"Ecc",20,-50,FALSE,FALSE,FALSE,0.61,"young",50,179,73,"m"
13,"TOTAL ABDOMINAL",2,"Ecc06",880,860,850,850,870,850,0.023,20,860,"Ecc",20,0,FALSE,FALSE,FALSE,2.35,"young",50,179,73,"m"
13,"TOTAL ABDOMINAL",2,"Ecc07",860,840,850,850,850,850,0,0,850,"Ecc",20,0,FALSE,FALSE,FALSE,0,"young",50,179,73,"m"
13,"TOTAL ABDOMINAL",2,"Ecc08",860,840,850,800,850,825,0.029,25,837.5,"Ecc",20,50,FALSE,FALSE,FALSE,3.03,"young",50,179,73,"m"
13,"TOTAL ABDOMINAL",2,"Ecc09",860,860,850,850,860,850,0.012,10,855,"Ecc",0,0,FALSE,FALSE,FALSE,1.18,"young",50,179,73,"m"
13,"TOTAL ABDOMINAL",2,"Ecc10",1480,1440,1550,1400,1460,1475,0.01,-15,1467.5,"Ecc",40,150,FALSE,TRUE,FALSE,1.02,"young",50,179,73,"m"
13,"TOTAL ABDOMINAL",1,"Rep01",2080,2060,2150,2150,2070,2150,0.039,-80,2110,"Rep",20,0,FALSE,FALSE,FALSE,3.72,"young",50,179,73,"m"
13,"TOTAL ABDOMINAL",1,"Rep02",1780,1780,1700,1800,1780,1750,0.017,30,1765,"Rep",0,-100,FALSE,FALSE,FALSE,1.71,"young",50,179,73,"m"
13,"TOTAL ABDOMINAL",1,"Rep03",1780,1780,1800,1750,1780,1775,0.003,5,1777.5,"Rep",0,50,FALSE,FALSE,FALSE,0.28,"young",50,179,73,"m"
13,"TOTAL ABDOMINAL",1,"Rep04",1780,1780,1800,1800,1780,1800,0.011,-20,1790,"Rep",0,0,FALSE,FALSE,FALSE,1.11,"young",50,179,73,"m"
13,"TOTAL ABDOMINAL",1,"Rep05",1720,1720,1700,1700,1720,1700,0.012,20,1710,"Rep",0,0,FALSE,FALSE,FALSE,1.18,"young",50,179,73,"m"
13,"TOTAL ABDOMINAL",1,"Rep06",1700,1700,1700,1700,1700,1700,0,0,1700,"Rep",0,0,FALSE,FALSE,FALSE,0,"young",50,179,73,"m"
13,"TOTAL ABDOMINAL",1,"Rep07",1740,1760,1750,1700,1750,1725,0.014,25,1737.5,"Rep",-20,50,FALSE,FALSE,FALSE,1.45,"young",50,179,73,"m"
13,"TOTAL ABDOMINAL",1,"Rep08",1720,1720,1700,1750,1720,1725,0.003,-5,1722.5,"Rep",0,-50,FALSE,FALSE,FALSE,0.29,"young",50,179,73,"m"
13,"TOTAL ABDOMINAL",1,"Rep09",1760,1760,1750,1750,1760,1750,0.006,10,1755,"Rep",0,0,FALSE,FALSE,FALSE,0.57,"young",50,179,73,"m"
13,"TOTAL ABDOMINAL",1,"Rep10",2720,2740,2750,2800,2730,2775,0.016,-45,2752.5,"Rep",-20,-50,FALSE,FALSE,FALSE,1.62,"young",50,179,73,"m"
13,"TOTAL ABDOMINAL",2,"Rep01",1860,1860,1900,2000,1860,1950,0.048,-90,1905,"Rep",0,-100,FALSE,FALSE,FALSE,4.62,"young",50,179,73,"m"
13,"TOTAL ABDOMINAL",2,"Rep02",1680,1680,1700,1700,1680,1700,0.012,-20,1690,"Rep",0,0,FALSE,FALSE,FALSE,1.18,"young",50,179,73,"m"
13,"TOTAL ABDOMINAL",2,"Rep03",1720,1720,1700,1650,1720,1675,0.026,45,1697.5,"Rep",0,50,FALSE,FALSE,FALSE,2.69,"young",50,179,73,"m"
13,"TOTAL ABDOMINAL",2,"Rep04",1700,1700,1700,1750,1700,1725,0.015,-25,1712.5,"Rep",0,-50,FALSE,FALSE,FALSE,1.45,"young",50,179,73,"m"
13,"TOTAL ABDOMINAL",2,"Rep05",1680,1660,1650,1650,1670,1650,0.012,20,1660,"Rep",20,0,FALSE,FALSE,FALSE,1.21,"young",50,179,73,"m"
13,"TOTAL ABDOMINAL",2,"Rep06",1700,1720,1750,1700,1710,1725,0.009,-15,1717.5,"Rep",-20,50,FALSE,FALSE,FALSE,0.87,"young",50,179,73,"m"
13,"TOTAL ABDOMINAL",2,"Rep07",1700,1680,1700,1700,1690,1700,0.006,-10,1695,"Rep",20,0,FALSE,FALSE,FALSE,0.59,"young",50,179,73,"m"
13,"TOTAL ABDOMINAL",2,"Rep08",1680,1680,1650,1650,1680,1650,0.018,30,1665,"Rep",0,0,FALSE,FALSE,FALSE,1.82,"young",50,179,73,"m"
13,"TOTAL ABDOMINAL",2,"Rep09",1700,1700,1700,1700,1700,1700,0,0,1700,"Rep",0,0,FALSE,FALSE,FALSE,0,"young",50,179,73,"m"
13,"TOTAL ABDOMINAL",2,"Rep10",2300,2280,2400,2250,2290,2325,0.015,-35,2307.5,"Rep",20,150,FALSE,FALSE,FALSE,1.51,"young",50,179,73,"m"
13,"TOTAL ABDOMINAL",1,"TuT",18780,18800,18800,18900,18790,18850,0.003,-60,18820,"TuT",-20,-100,FALSE,FALSE,FALSE,0.32,"young",50,179,73,"m"
13,"TOTAL ABDOMINAL",2,"TuT",17720,17680,17850,17750,17700,17800,0.006,-100,17750,"TuT",40,100,FALSE,TRUE,FALSE,0.56,"young",50,179,73,"m"
13,"VERTICAL TRACTION",1,"Con01",1180,1200,4750,1300,1190,3025,1.542,-1835,2107.5,"Con",-20,3450,TRUE,FALSE,TRUE,60.66,"young",50,179,73,"m"
13,"VERTICAL TRACTION",1,"Con02",1040,1040,1100,1100,1040,1100,0.058,-60,1070,"Con",0,0,FALSE,FALSE,FALSE,5.45,"young",50,179,73,"m"
13,"VERTICAL TRACTION",1,"Con03",1080,1040,1050,1100,1060,1075,0.014,-15,1067.5,"Con",40,-50,FALSE,FALSE,FALSE,1.4,"young",50,179,73,"m"
13,"VERTICAL TRACTION",1,"Con04",1120,1120,1100,1100,1120,1100,0.018,20,1110,"Con",0,0,FALSE,FALSE,FALSE,1.82,"young",50,179,73,"m"
13,"VERTICAL TRACTION",1,"Con05",1140,1140,1100,1150,1140,1125,0.013,15,1132.5,"Con",0,-50,FALSE,FALSE,FALSE,1.33,"young",50,179,73,"m"
13,"VERTICAL TRACTION",1,"Con06",1120,1140,1050,1100,1130,1075,0.049,55,1102.5,"Con",-20,-50,FALSE,FALSE,FALSE,5.12,"young",50,179,73,"m"
13,"VERTICAL TRACTION",1,"Con07",1100,1100,1050,1100,1100,1075,0.023,25,1087.5,"Con",0,-50,FALSE,FALSE,FALSE,2.33,"young",50,179,73,"m"
13,"VERTICAL TRACTION",1,"Con08",1060,1080,1100,1050,1070,1075,0.005,-5,1072.5,"Con",-20,50,FALSE,FALSE,FALSE,0.47,"young",50,179,73,"m"
13,"VERTICAL TRACTION",1,"Con09",1100,1100,1150,1150,1100,1150,0.045,-50,1125,"Con",0,0,FALSE,FALSE,FALSE,4.35,"young",50,179,73,"m"
13,"VERTICAL TRACTION",1,"Con10",1180,1160,1250,1200,1170,1225,0.047,-55,1197.5,"Con",20,50,FALSE,FALSE,FALSE,4.49,"young",50,179,73,"m"
13,"VERTICAL TRACTION",2,"Con01",2660,2700,4850,900,2680,2875,0.073,-195,2777.5,"Con",-40,3950,FALSE,FALSE,TRUE,6.78,"young",50,179,73,"m"
13,"VERTICAL TRACTION",2,"Con02",1120,1120,1100,1050,1120,1075,0.04,45,1097.5,"Con",0,50,FALSE,FALSE,FALSE,4.19,"young",50,179,73,"m"
13,"VERTICAL TRACTION",2,"Con03",1020,1020,1000,1000,1020,1000,0.02,20,1010,"Con",0,0,FALSE,FALSE,FALSE,2,"young",50,179,73,"m"
13,"VERTICAL TRACTION",2,"Con04",1080,1080,1050,1050,1080,1050,0.028,30,1065,"Con",0,0,FALSE,FALSE,FALSE,2.86,"young",50,179,73,"m"
13,"VERTICAL TRACTION",2,"Con05",1080,1100,1050,1100,1090,1075,0.014,15,1082.5,"Con",-20,-50,FALSE,FALSE,FALSE,1.4,"young",50,179,73,"m"
13,"VERTICAL TRACTION",2,"Con06",1000,1020,1000,1050,1010,1025,0.015,-15,1017.5,"Con",-20,-50,FALSE,FALSE,FALSE,1.46,"young",50,179,73,"m"
13,"VERTICAL TRACTION",2,"Con07",1040,1040,1100,1150,1040,1125,0.082,-85,1082.5,"Con",0,-50,FALSE,FALSE,FALSE,7.56,"young",50,179,73,"m"
13,"VERTICAL TRACTION",2,"Con08",1100,1100,1100,1150,1100,1125,0.023,-25,1112.5,"Con",0,-50,FALSE,FALSE,FALSE,2.22,"young",50,179,73,"m"
13,"VERTICAL TRACTION",2,"Con09",1060,1060,1100,1150,1060,1125,0.061,-65,1092.5,"Con",0,-50,FALSE,FALSE,FALSE,5.78,"young",50,179,73,"m"
13,"VERTICAL TRACTION",2,"Con10",1200,1200,1250,1300,1200,1275,0.062,-75,1237.5,"Con",0,-50,FALSE,FALSE,FALSE,5.88,"young",50,179,73,"m"
13,"VERTICAL TRACTION",1,"Ecc01",1040,1060,1000,1050,1050,1025,0.024,25,1037.5,"Ecc",-20,-50,FALSE,FALSE,FALSE,2.44,"young",50,179,73,"m"
13,"VERTICAL TRACTION",1,"Ecc02",1080,1080,1050,1050,1080,1050,0.028,30,1065,"Ecc",0,0,FALSE,FALSE,FALSE,2.86,"young",50,179,73,"m"
13,"VERTICAL TRACTION",1,"Ecc03",1080,1100,1150,1100,1090,1125,0.032,-35,1107.5,"Ecc",-20,50,FALSE,FALSE,FALSE,3.11,"young",50,179,73,"m"
13,"VERTICAL TRACTION",1,"Ecc04",1080,1080,1100,1100,1080,1100,0.019,-20,1090,"Ecc",0,0,FALSE,FALSE,FALSE,1.82,"young",50,179,73,"m"
13,"VERTICAL TRACTION",1,"Ecc05",1140,1140,1200,1150,1140,1175,0.031,-35,1157.5,"Ecc",0,50,FALSE,FALSE,FALSE,2.98,"young",50,179,73,"m"
13,"VERTICAL TRACTION",1,"Ecc06",1220,1200,1250,1200,1210,1225,0.012,-15,1217.5,"Ecc",20,50,FALSE,FALSE,FALSE,1.22,"young",50,179,73,"m"
13,"VERTICAL TRACTION",1,"Ecc07",1140,1120,1150,1150,1130,1150,0.018,-20,1140,"Ecc",20,0,FALSE,FALSE,FALSE,1.74,"young",50,179,73,"m"
13,"VERTICAL TRACTION",1,"Ecc08",1180,1180,1150,1150,1180,1150,0.025,30,1165,"Ecc",0,0,FALSE,FALSE,FALSE,2.61,"young",50,179,73,"m"
13,"VERTICAL TRACTION",1,"Ecc09",1160,1180,1100,1150,1170,1125,0.038,45,1147.5,"Ecc",-20,-50,FALSE,FALSE,FALSE,4,"young",50,179,73,"m"
13,"VERTICAL TRACTION",1,"Ecc10",2720,2720,3800,3800,2720,3800,0.397,-1080,3260,"Ecc",0,0,TRUE,FALSE,FALSE,28.42,"young",50,179,73,"m"
13,"VERTICAL TRACTION",2,"Ecc01",1080,1060,1050,1150,1070,1100,0.028,-30,1085,"Ecc",20,-100,FALSE,FALSE,FALSE,2.73,"young",50,179,73,"m"
13,"VERTICAL TRACTION",2,"Ecc02",1080,1100,1150,1150,1090,1150,0.055,-60,1120,"Ecc",-20,0,FALSE,FALSE,FALSE,5.22,"young",50,179,73,"m"
13,"VERTICAL TRACTION",2,"Ecc03",1060,1060,1100,1100,1060,1100,0.038,-40,1080,"Ecc",0,0,FALSE,FALSE,FALSE,3.64,"young",50,179,73,"m"
13,"VERTICAL TRACTION",2,"Ecc04",1140,1120,1150,1150,1130,1150,0.018,-20,1140,"Ecc",20,0,FALSE,FALSE,FALSE,1.74,"young",50,179,73,"m"
13,"VERTICAL TRACTION",2,"Ecc05",1180,1160,1200,1100,1170,1150,0.017,20,1160,"Ecc",20,100,FALSE,FALSE,FALSE,1.74,"young",50,179,73,"m"
13,"VERTICAL TRACTION",2,"Ecc06",1100,1100,1050,1050,1100,1050,0.045,50,1075,"Ecc",0,0,FALSE,FALSE,FALSE,4.76,"young",50,179,73,"m"
13,"VERTICAL TRACTION",2,"Ecc07",1020,1020,1000,950,1020,975,0.044,45,997.5,"Ecc",0,50,FALSE,FALSE,FALSE,4.62,"young",50,179,73,"m"
13,"VERTICAL TRACTION",2,"Ecc08",1080,1080,1050,1000,1080,1025,0.051,55,1052.5,"Ecc",0,50,FALSE,FALSE,FALSE,5.37,"young",50,179,73,"m"
13,"VERTICAL TRACTION",2,"Ecc09",1100,1100,1100,1000,1100,1050,0.045,50,1075,"Ecc",0,100,FALSE,FALSE,FALSE,4.76,"young",50,179,73,"m"
13,"VERTICAL TRACTION",2,"Ecc10",2480,2500,2500,2500,2490,2500,0.004,-10,2495,"Ecc",-20,0,FALSE,FALSE,FALSE,0.4,"young",50,179,73,"m"
13,"VERTICAL TRACTION",1,"Rep01",2220,2260,5750,2350,2240,4050,0.808,-1810,3145,"Rep",-40,3400,TRUE,FALSE,TRUE,44.69,"young",50,179,73,"m"
13,"VERTICAL TRACTION",1,"Rep02",2120,2120,2150,2150,2120,2150,0.014,-30,2135,"Rep",0,0,FALSE,FALSE,FALSE,1.4,"young",50,179,73,"m"
13,"VERTICAL TRACTION",1,"Rep03",2160,2140,2200,2200,2150,2200,0.023,-50,2175,"Rep",20,0,FALSE,FALSE,FALSE,2.27,"young",50,179,73,"m"
13,"VERTICAL TRACTION",1,"Rep04",2200,2200,2200,2200,2200,2200,0,0,2200,"Rep",0,0,FALSE,FALSE,FALSE,0,"young",50,179,73,"m"
13,"VERTICAL TRACTION",1,"Rep05",2280,2280,2300,2300,2280,2300,0.009,-20,2290,"Rep",0,0,FALSE,FALSE,FALSE,0.87,"young",50,179,73,"m"
13,"VERTICAL TRACTION",1,"Rep06",2340,2340,2300,2300,2340,2300,0.017,40,2320,"Rep",0,0,FALSE,FALSE,FALSE,1.74,"young",50,179,73,"m"
13,"VERTICAL TRACTION",1,"Rep07",2240,2220,2200,2250,2230,2225,0.002,5,2227.5,"Rep",20,-50,FALSE,FALSE,FALSE,0.22,"young",50,179,73,"m"
13,"VERTICAL TRACTION",1,"Rep08",2240,2260,2250,2200,2250,2225,0.011,25,2237.5,"Rep",-20,50,FALSE,FALSE,FALSE,1.12,"young",50,179,73,"m"
13,"VERTICAL TRACTION",1,"Rep09",2260,2280,2250,2300,2270,2275,0.002,-5,2272.5,"Rep",-20,-50,FALSE,FALSE,FALSE,0.22,"young",50,179,73,"m"
13,"VERTICAL TRACTION",1,"Rep10",3900,3880,5050,5000,3890,5025,0.292,-1135,4457.5,"Rep",20,50,TRUE,FALSE,FALSE,22.59,"young",50,179,73,"m"
13,"VERTICAL TRACTION",2,"Rep01",3740,3760,5900,2050,3750,3975,0.06,-225,3862.5,"Rep",-20,3850,TRUE,FALSE,TRUE,5.66,"young",50,179,73,"m"
13,"VERTICAL TRACTION",2,"Rep02",2200,2220,2250,2200,2210,2225,0.007,-15,2217.5,"Rep",-20,50,FALSE,FALSE,FALSE,0.67,"young",50,179,73,"m"
13,"VERTICAL TRACTION",2,"Rep03",2080,2080,2100,2100,2080,2100,0.01,-20,2090,"Rep",0,0,FALSE,FALSE,FALSE,0.95,"young",50,179,73,"m"
13,"VERTICAL TRACTION",2,"Rep04",2220,2200,2200,2200,2210,2200,0.005,10,2205,"Rep",20,0,FALSE,FALSE,FALSE,0.45,"young",50,179,73,"m"
13,"VERTICAL TRACTION",2,"Rep05",2260,2260,2250,2200,2260,2225,0.015,35,2242.5,"Rep",0,50,FALSE,FALSE,FALSE,1.57,"young",50,179,73,"m"
13,"VERTICAL TRACTION",2,"Rep06",2100,2120,2050,2100,2110,2075,0.017,35,2092.5,"Rep",-20,-50,FALSE,FALSE,FALSE,1.69,"young",50,179,73,"m"
13,"VERTICAL TRACTION",2,"Rep07",2060,2060,2100,2100,2060,2100,0.019,-40,2080,"Rep",0,0,FALSE,FALSE,FALSE,1.9,"young",50,179,73,"m"
13,"VERTICAL TRACTION",2,"Rep08",2180,2180,2150,2150,2180,2150,0.014,30,2165,"Rep",0,0,FALSE,FALSE,FALSE,1.4,"young",50,179,73,"m"
13,"VERTICAL TRACTION",2,"Rep09",2160,2160,2200,2150,2160,2175,0.007,-15,2167.5,"Rep",0,50,FALSE,FALSE,FALSE,0.69,"young",50,179,73,"m"
13,"VERTICAL TRACTION",2,"Rep10",3680,3700,3750,3800,3690,3775,0.023,-85,3732.5,"Rep",-20,-50,FALSE,FALSE,FALSE,2.25,"young",50,179,73,"m"
13,"VERTICAL TRACTION",1,"TuT",23960,23980,28650,25250,23970,26950,0.124,-2980,25460,"TuT",-20,3400,TRUE,FALSE,TRUE,11.06,"young",50,179,73,"m"
13,"VERTICAL TRACTION",2,"TuT",24680,24740,26950,23050,24710,25000,0.012,-290,24855,"TuT",-60,3900,FALSE,FALSE,TRUE,1.16,"young",50,179,73,"m"
13,"CHEST PRESS",1,"Con01",1400,1400,1400,4150,1400,2775,0.982,-1375,2087.5,"Con",0,-2750,TRUE,FALSE,TRUE,49.55,"young",50,179,73,"m"
13,"CHEST PRESS",1,"Con02",1080,1080,1050,1150,1080,1100,0.019,-20,1090,"Con",0,-100,FALSE,FALSE,FALSE,1.82,"young",50,179,73,"m"
13,"CHEST PRESS",1,"Con03",1080,1080,1050,1100,1080,1075,0.005,5,1077.5,"Con",0,-50,FALSE,FALSE,FALSE,0.47,"young",50,179,73,"m"
13,"CHEST PRESS",1,"Con04",1080,1080,1050,1100,1080,1075,0.005,5,1077.5,"Con",0,-50,FALSE,FALSE,FALSE,0.47,"young",50,179,73,"m"
13,"CHEST PRESS",1,"Con05",1080,1080,1100,1100,1080,1100,0.019,-20,1090,"Con",0,0,FALSE,FALSE,FALSE,1.82,"young",50,179,73,"m"
13,"CHEST PRESS",1,"Con06",1100,1100,1100,1050,1100,1075,0.023,25,1087.5,"Con",0,50,FALSE,FALSE,FALSE,2.33,"young",50,179,73,"m"
13,"CHEST PRESS",1,"Con07",1080,1100,1150,1050,1090,1100,0.009,-10,1095,"Con",-20,100,FALSE,FALSE,FALSE,0.91,"young",50,179,73,"m"
13,"CHEST PRESS",1,"Con08",1120,1120,1200,1100,1120,1150,0.027,-30,1135,"Con",0,100,FALSE,FALSE,FALSE,2.61,"young",50,179,73,"m"
13,"CHEST PRESS",1,"Con09",1180,1180,1200,1150,1180,1175,0.004,5,1177.5,"Con",0,50,FALSE,FALSE,FALSE,0.43,"young",50,179,73,"m"
13,"CHEST PRESS",1,"Con10",1200,1200,1250,1200,1200,1225,0.021,-25,1212.5,"Con",0,50,FALSE,FALSE,FALSE,2.04,"young",50,179,73,"m"
13,"CHEST PRESS",2,"Con01",1420,1420,1550,1450,1420,1500,0.056,-80,1460,"Con",0,100,FALSE,FALSE,FALSE,5.33,"young",50,179,73,"m"
13,"CHEST PRESS",2,"Con02",1060,1060,1050,1000,1060,1025,0.033,35,1042.5,"Con",0,50,FALSE,FALSE,FALSE,3.41,"young",50,179,73,"m"
13,"CHEST PRESS",2,"Con03",1060,1060,1050,1100,1060,1075,0.014,-15,1067.5,"Con",0,-50,FALSE,FALSE,FALSE,1.4,"young",50,179,73,"m"
13,"CHEST PRESS",2,"Con04",1000,1000,1000,1000,1000,1000,0,0,1000,"Con",0,0,FALSE,FALSE,FALSE,0,"young",50,179,73,"m"
13,"CHEST PRESS",2,"Con05",1060,1060,1050,1050,1060,1050,0.009,10,1055,"Con",0,0,FALSE,FALSE,FALSE,0.95,"young",50,179,73,"m"
13,"CHEST PRESS",2,"Con06",1120,1120,1100,1150,1120,1125,0.004,-5,1122.5,"Con",0,-50,FALSE,FALSE,FALSE,0.44,"young",50,179,73,"m"
13,"CHEST PRESS",2,"Con07",1100,1100,1100,1050,1100,1075,0.023,25,1087.5,"Con",0,50,FALSE,FALSE,FALSE,2.33,"young",50,179,73,"m"
13,"CHEST PRESS",2,"Con08",1140,1140,1150,1150,1140,1150,0.009,-10,1145,"Con",0,0,FALSE,FALSE,FALSE,0.87,"young",50,179,73,"m"
13,"CHEST PRESS",2,"Con09",1320,1320,1350,1300,1320,1325,0.004,-5,1322.5,"Con",0,50,FALSE,FALSE,FALSE,0.38,"young",50,179,73,"m"
13,"CHEST PRESS",2,"Con10",1360,1360,1400,1300,1360,1350,0.007,10,1355,"Con",0,100,FALSE,FALSE,FALSE,0.74,"young",50,179,73,"m"
13,"CHEST PRESS",1,"Ecc01",1180,1180,1250,1100,1180,1175,0.004,5,1177.5,"Ecc",0,150,FALSE,FALSE,FALSE,0.43,"young",50,179,73,"m"
13,"CHEST PRESS",1,"Ecc02",1180,1180,1200,1150,1180,1175,0.004,5,1177.5,"Ecc",0,50,FALSE,FALSE,FALSE,0.43,"young",50,179,73,"m"
13,"CHEST PRESS",1,"Ecc03",1100,1100,1150,1100,1100,1125,0.023,-25,1112.5,"Ecc",0,50,FALSE,FALSE,FALSE,2.22,"young",50,179,73,"m"
13,"CHEST PRESS",1,"Ecc04",1120,1120,1100,1100,1120,1100,0.018,20,1110,"Ecc",0,0,FALSE,FALSE,FALSE,1.82,"young",50,179,73,"m"
13,"CHEST PRESS",1,"Ecc05",1100,1100,1100,1100,1100,1100,0,0,1100,"Ecc",0,0,FALSE,FALSE,FALSE,0,"young",50,179,73,"m"
13,"CHEST PRESS",1,"Ecc06",1140,1120,1100,1200,1130,1150,0.018,-20,1140,"Ecc",20,-100,FALSE,FALSE,FALSE,1.74,"young",50,179,73,"m"
13,"CHEST PRESS",1,"Ecc07",1160,1160,1100,1200,1160,1150,0.009,10,1155,"Ecc",0,-100,FALSE,FALSE,FALSE,0.87,"young",50,179,73,"m"
13,"CHEST PRESS",1,"Ecc08",1040,1040,1000,1050,1040,1025,0.014,15,1032.5,"Ecc",0,-50,FALSE,FALSE,FALSE,1.46,"young",50,179,73,"m"
13,"CHEST PRESS",1,"Ecc09",1080,1080,1050,1100,1080,1075,0.005,5,1077.5,"Ecc",0,-50,FALSE,FALSE,FALSE,0.47,"young",50,179,73,"m"
13,"CHEST PRESS",1,"Ecc10",3000,2980,1150,3950,2990,2550,0.147,440,2770,"Ecc",20,-2800,TRUE,FALSE,TRUE,17.25,"young",50,179,73,"m"
13,"CHEST PRESS",2,"Ecc01",1040,1040,1050,1100,1040,1075,0.034,-35,1057.5,"Ecc",0,-50,FALSE,FALSE,FALSE,3.26,"young",50,179,73,"m"
13,"CHEST PRESS",2,"Ecc02",1080,1080,1100,1100,1080,1100,0.019,-20,1090,"Ecc",0,0,FALSE,FALSE,FALSE,1.82,"young",50,179,73,"m"
13,"CHEST PRESS",2,"Ecc03",1140,1140,1150,1100,1140,1125,0.013,15,1132.5,"Ecc",0,50,FALSE,FALSE,FALSE,1.33,"young",50,179,73,"m"
13,"CHEST PRESS",2,"Ecc04",960,960,950,1000,960,975,0.016,-15,967.5,"Ecc",0,-50,FALSE,FALSE,FALSE,1.54,"young",50,179,73,"m"
13,"CHEST PRESS",2,"Ecc05",1040,1040,1050,1000,1040,1025,0.014,15,1032.5,"Ecc",0,50,FALSE,FALSE,FALSE,1.46,"young",50,179,73,"m"
13,"CHEST PRESS",2,"Ecc06",980,980,1000,1000,980,1000,0.02,-20,990,"Ecc",0,0,FALSE,FALSE,FALSE,2,"young",50,179,73,"m"
13,"CHEST PRESS",2,"Ecc07",1020,1020,1000,1050,1020,1025,0.005,-5,1022.5,"Ecc",0,-50,FALSE,FALSE,FALSE,0.49,"young",50,179,73,"m"
13,"CHEST PRESS",2,"Ecc08",1020,1020,1000,1000,1020,1000,0.02,20,1010,"Ecc",0,0,FALSE,FALSE,FALSE,2,"young",50,179,73,"m"
13,"CHEST PRESS",2,"Ecc09",1020,1020,1000,1050,1020,1025,0.005,-5,1022.5,"Ecc",0,-50,FALSE,FALSE,FALSE,0.49,"young",50,179,73,"m"
13,"CHEST PRESS",2,"Ecc10",2660,2640,2700,2800,2650,2750,0.038,-100,2700,"Ecc",20,-100,FALSE,FALSE,FALSE,3.64,"young",50,179,73,"m"
13,"CHEST PRESS",1,"Rep01",2580,2580,2650,5250,2580,3950,0.531,-1370,3265,"Rep",0,-2600,TRUE,FALSE,TRUE,34.68,"young",50,179,73,"m"
13,"CHEST PRESS",1,"Rep02",2260,2260,2250,2300,2260,2275,0.007,-15,2267.5,"Rep",0,-50,FALSE,FALSE,FALSE,0.66,"young",50,179,73,"m"
13,"CHEST PRESS",1,"Rep03",2180,2180,2200,2200,2180,2200,0.009,-20,2190,"Rep",0,0,FALSE,FALSE,FALSE,0.91,"young",50,179,73,"m"
13,"CHEST PRESS",1,"Rep04",2200,2200,2150,2200,2200,2175,0.011,25,2187.5,"Rep",0,-50,FALSE,FALSE,FALSE,1.15,"young",50,179,73,"m"
13,"CHEST PRESS",1,"Rep05",2180,2180,2200,2200,2180,2200,0.009,-20,2190,"Rep",0,0,FALSE,FALSE,FALSE,0.91,"young",50,179,73,"m"
13,"CHEST PRESS",1,"Rep06",2240,2220,2200,2250,2230,2225,0.002,5,2227.5,"Rep",20,-50,FALSE,FALSE,FALSE,0.22,"young",50,179,73,"m"
13,"CHEST PRESS",1,"Rep07",2240,2260,2250,2250,2250,2250,0,0,2250,"Rep",-20,0,FALSE,FALSE,FALSE,0,"young",50,179,73,"m"
13,"CHEST PRESS",1,"Rep08",2160,2160,2200,2150,2160,2175,0.007,-15,2167.5,"Rep",0,50,FALSE,FALSE,FALSE,0.69,"young",50,179,73,"m"
13,"CHEST PRESS",1,"Rep09",2260,2260,2250,2250,2260,2250,0.004,10,2255,"Rep",0,0,FALSE,FALSE,FALSE,0.44,"young",50,179,73,"m"
13,"CHEST PRESS",1,"Rep10",4200,4180,2400,5150,4190,3775,0.099,415,3982.5,"Rep",20,-2750,TRUE,FALSE,TRUE,10.99,"young",50,179,73,"m"
13,"CHEST PRESS",2,"Rep01",2460,2460,2600,2550,2460,2575,0.047,-115,2517.5,"Rep",0,50,FALSE,FALSE,FALSE,4.47,"young",50,179,73,"m"
13,"CHEST PRESS",2,"Rep02",2140,2140,2150,2100,2140,2125,0.007,15,2132.5,"Rep",0,50,FALSE,FALSE,FALSE,0.71,"young",50,179,73,"m"
13,"CHEST PRESS",2,"Rep03",2200,2200,2200,2200,2200,2200,0,0,2200,"Rep",0,0,FALSE,FALSE,FALSE,0,"young",50,179,73,"m"
13,"CHEST PRESS",2,"Rep04",1960,1960,1950,2000,1960,1975,0.008,-15,1967.5,"Rep",0,-50,FALSE,FALSE,FALSE,0.76,"young",50,179,73,"m"
13,"CHEST PRESS",2,"Rep05",2100,2100,2100,2050,2100,2075,0.012,25,2087.5,"Rep",0,50,FALSE,FALSE,FALSE,1.2,"young",50,179,73,"m"
13,"CHEST PRESS",2,"Rep06",2100,2100,2100,2150,2100,2125,0.012,-25,2112.5,"Rep",0,-50,FALSE,FALSE,FALSE,1.18,"young",50,179,73,"m"
13,"CHEST PRESS",2,"Rep07",2120,2120,2100,2100,2120,2100,0.009,20,2110,"Rep",0,0,FALSE,FALSE,FALSE,0.95,"young",50,179,73,"m"
13,"CHEST PRESS",2,"Rep08",2160,2160,2150,2150,2160,2150,0.005,10,2155,"Rep",0,0,FALSE,FALSE,FALSE,0.47,"young",50,179,73,"m"
13,"CHEST PRESS",2,"Rep09",2340,2340,2350,2350,2340,2350,0.004,-10,2345,"Rep",0,0,FALSE,FALSE,FALSE,0.43,"young",50,179,73,"m"
13,"CHEST PRESS",2,"Rep10",4020,4000,4100,4100,4010,4100,0.022,-90,4055,"Rep",20,0,FALSE,FALSE,FALSE,2.2,"young",50,179,73,"m"
13,"CHEST PRESS",1,"TuT",24500,24480,22750,28200,24490,25475,0.04,-985,24982.5,"TuT",20,-5450,FALSE,FALSE,TRUE,3.87,"young",50,179,73,"m"
13,"CHEST PRESS",2,"TuT",23600,23580,23800,23750,23590,23775,0.008,-185,23682.5,"TuT",20,50,FALSE,FALSE,FALSE,0.78,"young",50,179,73,"m"
14,"LEG PRESS",1,"Con01",1260,1280,1850,1550,1270,1700,0.339,-430,1485,"Con",-20,300,TRUE,FALSE,TRUE,25.29,"young",20,182,78,"m"
14,"LEG PRESS",1,"Con02",1000,1020,1250,1150,1010,1200,0.188,-190,1105,"Con",-20,100,FALSE,FALSE,FALSE,15.83,"young",20,182,78,"m"
14,"LEG PRESS",1,"Con03",840,860,1100,1100,850,1100,0.294,-250,975,"Con",-20,0,FALSE,FALSE,FALSE,22.73,"young",20,182,78,"m"
14,"LEG PRESS",1,"Con04",880,880,1150,1150,880,1150,0.307,-270,1015,"Con",0,0,FALSE,FALSE,FALSE,23.48,"young",20,182,78,"m"
14,"LEG PRESS",1,"Con05",980,980,1200,1200,980,1200,0.224,-220,1090,"Con",0,0,FALSE,FALSE,FALSE,18.33,"young",20,182,78,"m"
14,"LEG PRESS",1,"Con06",980,1000,1150,1150,990,1150,0.162,-160,1070,"Con",-20,0,FALSE,FALSE,FALSE,13.91,"young",20,182,78,"m"
14,"LEG PRESS",1,"Con07",1000,1020,1150,1150,1010,1150,0.139,-140,1080,"Con",-20,0,FALSE,FALSE,FALSE,12.17,"young",20,182,78,"m"
14,"LEG PRESS",1,"Con08",940,900,1250,1750,920,1500,0.63,-580,1210,"Con",40,-500,TRUE,FALSE,TRUE,38.67,"young",20,182,78,"m"
14,"LEG PRESS",1,"Con09",1020,1020,2000,2050,1020,2025,0.985,-1005,1522.5,"Con",0,-50,TRUE,FALSE,FALSE,49.63,"young",20,182,78,"m"
14,"LEG PRESS",1,"Con10",980,940,2000,2000,960,2000,1.083,-1040,1480,"Con",40,0,TRUE,FALSE,FALSE,52,"young",20,182,78,"m"
14,"LEG PRESS",2,"Con01",1240,1260,2050,1550,1250,1800,0.44,-550,1525,"Con",-20,500,TRUE,FALSE,TRUE,30.56,"young",20,182,78,"m"
14,"LEG PRESS",2,"Con02",940,960,2150,1100,950,1625,0.711,-675,1287.5,"Con",-20,1050,TRUE,FALSE,TRUE,41.54,"young",20,182,78,"m"
14,"LEG PRESS",2,"Con03",880,900,1600,1000,890,1300,0.461,-410,1095,"Con",-20,600,TRUE,FALSE,TRUE,31.54,"young",20,182,78,"m"
14,"LEG PRESS",2,"Con04",940,940,1200,1050,940,1125,0.197,-185,1032.5,"Con",0,150,FALSE,FALSE,FALSE,16.44,"young",20,182,78,"m"
14,"LEG PRESS",2,"Con05",920,940,1100,1150,930,1125,0.21,-195,1027.5,"Con",-20,-50,FALSE,FALSE,FALSE,17.33,"young",20,182,78,"m"
14,"LEG PRESS",2,"Con06",920,920,1100,1700,920,1400,0.522,-480,1160,"Con",0,-600,TRUE,FALSE,TRUE,34.29,"young",20,182,78,"m"
14,"LEG PRESS",2,"Con07",880,860,1000,1650,870,1325,0.523,-455,1097.5,"Con",20,-650,TRUE,FALSE,TRUE,34.34,"young",20,182,78,"m"
14,"LEG PRESS",2,"Con08",880,880,1050,1200,880,1125,0.278,-245,1002.5,"Con",0,-150,FALSE,FALSE,FALSE,21.78,"young",20,182,78,"m"
14,"LEG PRESS",2,"Con09",900,900,1050,1650,900,1350,0.5,-450,1125,"Con",0,-600,TRUE,FALSE,TRUE,33.33,"young",20,182,78,"m"
14,"LEG PRESS",2,"Con10",980,960,1650,1700,970,1675,0.727,-705,1322.5,"Con",20,-50,TRUE,FALSE,FALSE,42.09,"young",20,182,78,"m"
14,"LEG PRESS",1,"Ecc01",2420,2420,2150,2300,2420,2225,0.081,195,2322.5,"Ecc",0,-150,FALSE,FALSE,FALSE,8.76,"young",20,182,78,"m"
14,"LEG PRESS",1,"Ecc02",2180,2140,1950,2000,2160,1975,0.086,185,2067.5,"Ecc",40,-50,FALSE,FALSE,FALSE,9.37,"young",20,182,78,"m"
14,"LEG PRESS",1,"Ecc03",2260,2260,1950,1950,2260,1950,0.137,310,2105,"Ecc",0,0,FALSE,FALSE,FALSE,15.9,"young",20,182,78,"m"
14,"LEG PRESS",1,"Ecc04",2560,2560,2350,2350,2560,2350,0.082,210,2455,"Ecc",0,0,FALSE,FALSE,FALSE,8.94,"young",20,182,78,"m"
14,"LEG PRESS",1,"Ecc05",2300,2300,2100,2100,2300,2100,0.087,200,2200,"Ecc",0,0,FALSE,FALSE,FALSE,9.52,"young",20,182,78,"m"
14,"LEG PRESS",1,"Ecc06",2420,2400,2250,2250,2410,2250,0.066,160,2330,"Ecc",20,0,FALSE,FALSE,FALSE,7.11,"young",20,182,78,"m"
14,"LEG PRESS",1,"Ecc07",2280,2280,2050,2050,2280,2050,0.101,230,2165,"Ecc",0,0,FALSE,FALSE,FALSE,11.22,"young",20,182,78,"m"
14,"LEG PRESS",1,"Ecc08",2160,2200,1900,1350,2180,1625,0.255,555,1902.5,"Ecc",-40,550,TRUE,FALSE,TRUE,34.15,"young",20,182,78,"m"
14,"LEG PRESS",1,"Ecc09",2640,2640,1400,1400,2640,1400,0.47,1240,2020,"Ecc",0,0,TRUE,FALSE,FALSE,88.57,"young",20,182,78,"m"
14,"LEG PRESS",1,"Ecc10",2620,2660,2600,1950,2640,2275,0.138,365,2457.5,"Ecc",-40,650,TRUE,FALSE,TRUE,16.04,"young",20,182,78,"m"
14,"LEG PRESS",2,"Ecc01",2300,2280,1250,2150,2290,1700,0.258,590,1995,"Ecc",20,-900,TRUE,FALSE,TRUE,34.71,"young",20,182,78,"m"
14,"LEG PRESS",2,"Ecc02",2360,2320,1250,2200,2340,1725,0.263,615,2032.5,"Ecc",40,-950,TRUE,FALSE,TRUE,35.65,"young",20,182,78,"m"
14,"LEG PRESS",2,"Ecc03",2100,2100,1400,2000,2100,1700,0.19,400,1900,"Ecc",0,-600,TRUE,FALSE,TRUE,23.53,"young",20,182,78,"m"
14,"LEG PRESS",2,"Ecc04",2180,2160,1950,2050,2170,2000,0.078,170,2085,"Ecc",20,-100,FALSE,FALSE,FALSE,8.5,"young",20,182,78,"m"
14,"LEG PRESS",2,"Ecc05",2300,2300,2100,2000,2300,2050,0.109,250,2175,"Ecc",0,100,FALSE,FALSE,FALSE,12.2,"young",20,182,78,"m"
14,"LEG PRESS",2,"Ecc06",2360,2360,2200,1600,2360,1900,0.195,460,2130,"Ecc",0,600,TRUE,FALSE,TRUE,24.21,"young",20,182,78,"m"
14,"LEG PRESS",2,"Ecc07",2160,2180,2000,1350,2170,1675,0.228,495,1922.5,"Ecc",-20,650,TRUE,FALSE,TRUE,29.55,"young",20,182,78,"m"
14,"LEG PRESS",2,"Ecc08",1980,1980,1850,1700,1980,1775,0.104,205,1877.5,"Ecc",0,150,FALSE,FALSE,FALSE,11.55,"young",20,182,78,"m"
14,"LEG PRESS",2,"Ecc09",2300,2320,2000,1400,2310,1700,0.264,610,2005,"Ecc",-20,600,TRUE,FALSE,TRUE,35.88,"young",20,182,78,"m"
14,"LEG PRESS",2,"Ecc10",2260,2260,1950,1800,2260,1875,0.17,385,2067.5,"Ecc",0,150,TRUE,FALSE,FALSE,20.53,"young",20,182,78,"m"
14,"LEG PRESS",1,"Rep01",3680,3700,4000,3850,3690,3925,0.064,-235,3807.5,"Rep",-20,150,TRUE,FALSE,TRUE,5.99,"young",20,182,78,"m"
14,"LEG PRESS",1,"Rep02",3180,3160,3200,3150,3170,3175,0.002,-5,3172.5,"Rep",20,50,FALSE,FALSE,FALSE,0.16,"young",20,182,78,"m"
14,"LEG PRESS",1,"Rep03",3100,3120,3050,3050,3110,3050,0.019,60,3080,"Rep",-20,0,FALSE,FALSE,FALSE,1.97,"young",20,182,78,"m"
14,"LEG PRESS",1,"Rep04",3440,3440,3500,3500,3440,3500,0.017,-60,3470,"Rep",0,0,FALSE,FALSE,FALSE,1.71,"young",20,182,78,"m"
14,"LEG PRESS",1,"Rep05",3280,3280,3300,3300,3280,3300,0.006,-20,3290,"Rep",0,0,FALSE,FALSE,FALSE,0.61,"young",20,182,78,"m"
14,"LEG PRESS",1,"Rep06",3400,3400,3400,3400,3400,3400,0,0,3400,"Rep",0,0,FALSE,FALSE,FALSE,0,"young",20,182,78,"m"
14,"LEG PRESS",1,"Rep07",3280,3300,3200,3200,3290,3200,0.027,90,3245,"Rep",-20,0,FALSE,FALSE,FALSE,2.81,"young",20,182,78,"m"
14,"LEG PRESS",1,"Rep08",3100,3100,3150,3100,3100,3125,0.008,-25,3112.5,"Rep",0,50,FALSE,FALSE,FALSE,0.8,"young",20,182,78,"m"
14,"LEG PRESS",1,"Rep09",3660,3660,3400,3450,3660,3425,0.064,235,3542.5,"Rep",0,-50,TRUE,FALSE,FALSE,6.86,"young",20,182,78,"m"
14,"LEG PRESS",1,"Rep10",3600,3600,4600,3950,3600,4275,0.188,-675,3937.5,"Rep",0,650,TRUE,FALSE,TRUE,15.79,"young",20,182,78,"m"
14,"LEG PRESS",2,"Rep01",3540,3540,3300,3700,3540,3500,0.011,40,3520,"Rep",0,-400,FALSE,FALSE,TRUE,1.14,"young",20,182,78,"m"
14,"LEG PRESS",2,"Rep02",3300,3280,3400,3300,3290,3350,0.018,-60,3320,"Rep",20,100,FALSE,FALSE,TRUE,1.79,"young",20,182,78,"m"
14,"LEG PRESS",2,"Rep03",2980,3000,3000,3000,2990,3000,0.003,-10,2995,"Rep",-20,0,FALSE,FALSE,FALSE,0.33,"young",20,182,78,"m"
14,"LEG PRESS",2,"Rep04",3120,3100,3150,3100,3110,3125,0.005,-15,3117.5,"Rep",20,50,FALSE,FALSE,FALSE,0.48,"young",20,182,78,"m"
14,"LEG PRESS",2,"Rep05",3220,3240,3200,3150,3230,3175,0.017,55,3202.5,"Rep",-20,50,FALSE,FALSE,FALSE,1.73,"young",20,182,78,"m"
14,"LEG PRESS",2,"Rep06",3280,3280,3300,3300,3280,3300,0.006,-20,3290,"Rep",0,0,FALSE,FALSE,FALSE,0.61,"young",20,182,78,"m"
14,"LEG PRESS",2,"Rep07",3040,3040,3000,3000,3040,3000,0.013,40,3020,"Rep",0,0,FALSE,FALSE,FALSE,1.33,"young",20,182,78,"m"
14,"LEG PRESS",2,"Rep08",2860,2860,2900,2900,2860,2900,0.014,-40,2880,"Rep",0,0,FALSE,FALSE,FALSE,1.38,"young",20,182,78,"m"
14,"LEG PRESS",2,"Rep09",3200,3220,3050,3050,3210,3050,0.05,160,3130,"Rep",-20,0,TRUE,FALSE,FALSE,5.25,"young",20,182,78,"m"
14,"LEG PRESS",2,"Rep10",3240,3220,3600,3500,3230,3550,0.099,-320,3390,"Rep",20,100,TRUE,FALSE,TRUE,9.01,"young",20,182,78,"m"
14,"LEG PRESS",1,"TuT",33720,33760,34800,33950,33740,34375,0.019,-635,34057.5,"TuT",-40,850,TRUE,FALSE,TRUE,1.85,"young",20,182,78,"m"
14,"LEG PRESS",2,"TuT",31780,31780,31900,32000,31780,31950,0.005,-170,31865,"TuT",0,-100,FALSE,FALSE,FALSE,0.53,"young",20,182,78,"m"
14,"LEG EXTENSION",1,"Con01",1180,1200,1400,1200,1190,1300,0.092,-110,1245,"Con",-20,200,FALSE,FALSE,TRUE,8.46,"young",20,182,78,"m"
14,"LEG EXTENSION",1,"Con02",1000,1000,1100,1050,1000,1075,0.075,-75,1037.5,"Con",0,50,FALSE,FALSE,FALSE,6.98,"young",20,182,78,"m"
14,"LEG EXTENSION",1,"Con03",960,980,1050,1050,970,1050,0.082,-80,1010,"Con",-20,0,FALSE,FALSE,FALSE,7.62,"young",20,182,78,"m"
14,"LEG EXTENSION",1,"Con04",920,920,1100,1050,920,1075,0.168,-155,997.5,"Con",0,50,FALSE,FALSE,FALSE,14.42,"young",20,182,78,"m"
14,"LEG EXTENSION",1,"Con05",960,960,1150,1100,960,1125,0.172,-165,1042.5,"Con",0,50,FALSE,FALSE,FALSE,14.67,"young",20,182,78,"m"
14,"LEG EXTENSION",1,"Con06",1160,1120,1300,1350,1140,1325,0.162,-185,1232.5,"Con",40,-50,TRUE,TRUE,FALSE,13.96,"young",20,182,78,"m"
14,"LEG EXTENSION",1,"Con07",1140,1120,1300,1300,1130,1300,0.15,-170,1215,"Con",20,0,FALSE,FALSE,FALSE,13.08,"young",20,182,78,"m"
14,"LEG EXTENSION",1,"Con08",1040,1060,1300,1200,1050,1250,0.19,-200,1150,"Con",-20,100,TRUE,FALSE,FALSE,16,"young",20,182,78,"m"
14,"LEG EXTENSION",1,"Con09",1000,1000,1200,1200,1000,1200,0.2,-200,1100,"Con",0,0,TRUE,FALSE,FALSE,16.67,"young",20,182,78,"m"
14,"LEG EXTENSION",1,"Con10",1020,980,1400,1600,1000,1500,0.5,-500,1250,"Con",40,-200,TRUE,TRUE,TRUE,33.33,"young",20,182,78,"m"
14,"LEG EXTENSION",2,"Con01",1200,1220,1100,1300,1210,1200,0.008,10,1205,"Con",-20,-200,FALSE,FALSE,TRUE,0.83,"young",20,182,78,"m"
14,"LEG EXTENSION",2,"Con02",960,960,1000,1150,960,1075,0.12,-115,1017.5,"Con",0,-150,FALSE,FALSE,FALSE,10.7,"young",20,182,78,"m"
14,"LEG EXTENSION",2,"Con03",1000,1020,1050,1100,1010,1075,0.064,-65,1042.5,"Con",-20,-50,FALSE,FALSE,FALSE,6.05,"young",20,182,78,"m"
14,"LEG EXTENSION",2,"Con04",1080,1080,1150,1200,1080,1175,0.088,-95,1127.5,"Con",0,-50,FALSE,FALSE,FALSE,8.09,"young",20,182,78,"m"
14,"LEG EXTENSION",2,"Con05",1000,1000,1100,1150,1000,1125,0.125,-125,1062.5,"Con",0,-50,FALSE,FALSE,FALSE,11.11,"young",20,182,78,"m"
14,"LEG EXTENSION",2,"Con06",940,940,1100,1100,940,1100,0.17,-160,1020,"Con",0,0,FALSE,FALSE,FALSE,14.55,"young",20,182,78,"m"
14,"LEG EXTENSION",2,"Con07",960,960,1200,1100,960,1150,0.198,-190,1055,"Con",0,100,TRUE,FALSE,FALSE,16.52,"young",20,182,78,"m"
14,"LEG EXTENSION",2,"Con08",900,900,1250,1150,900,1200,0.333,-300,1050,"Con",0,100,TRUE,FALSE,FALSE,25,"young",20,182,78,"m"
14,"LEG EXTENSION",2,"Con09",980,1000,1250,1200,990,1225,0.237,-235,1107.5,"Con",-20,50,TRUE,FALSE,FALSE,19.18,"young",20,182,78,"m"
14,"LEG EXTENSION",2,"Con10",900,920,1100,1100,910,1100,0.209,-190,1005,"Con",-20,0,TRUE,FALSE,FALSE,17.27,"young",20,182,78,"m"
14,"LEG EXTENSION",1,"Ecc01",3920,3940,3800,3800,3930,3800,0.033,130,3865,"Ecc",-20,0,FALSE,FALSE,FALSE,3.42,"young",20,182,78,"m"
14,"LEG EXTENSION",1,"Ecc02",3440,3440,3350,3400,3440,3375,0.019,65,3407.5,"Ecc",0,-50,FALSE,FALSE,FALSE,1.93,"young",20,182,78,"m"
14,"LEG EXTENSION",1,"Ecc03",3800,3760,3650,3650,3780,3650,0.034,130,3715,"Ecc",40,0,FALSE,TRUE,FALSE,3.56,"young",20,182,78,"m"
14,"LEG EXTENSION",1,"Ecc04",4140,4160,3950,4000,4150,3975,0.042,175,4062.5,"Ecc",-20,-50,FALSE,FALSE,FALSE,4.4,"young",20,182,78,"m"
14,"LEG EXTENSION",1,"Ecc05",2980,3020,2800,2850,3000,2825,0.058,175,2912.5,"Ecc",-40,-50,FALSE,TRUE,FALSE,6.19,"young",20,182,78,"m"
14,"LEG EXTENSION",1,"Ecc06",3420,3440,3300,3250,3430,3275,0.045,155,3352.5,"Ecc",-20,50,FALSE,FALSE,FALSE,4.73,"young",20,182,78,"m"
14,"LEG EXTENSION",1,"Ecc07",3740,3740,3500,3550,3740,3525,0.057,215,3632.5,"Ecc",0,-50,TRUE,FALSE,FALSE,6.1,"young",20,182,78,"m"
14,"LEG EXTENSION",1,"Ecc08",3060,3040,2850,2850,3050,2850,0.066,200,2950,"Ecc",20,0,TRUE,FALSE,FALSE,7.02,"young",20,182,78,"m"
14,"LEG EXTENSION",1,"Ecc09",3140,3160,2750,2550,3150,2650,0.159,500,2900,"Ecc",-20,200,TRUE,FALSE,TRUE,18.87,"young",20,182,78,"m"
14,"LEG EXTENSION",1,"Ecc10",3040,3060,3100,3050,3050,3075,0.008,-25,3062.5,"Ecc",-20,50,FALSE,FALSE,FALSE,0.81,"young",20,182,78,"m"
14,"LEG EXTENSION",2,"Ecc01",3200,3180,3100,3050,3190,3075,0.036,115,3132.5,"Ecc",20,50,FALSE,FALSE,FALSE,3.74,"young",20,182,78,"m"
14,"LEG EXTENSION",2,"Ecc02",2640,2640,2600,2500,2640,2550,0.034,90,2595,"Ecc",0,100,FALSE,FALSE,FALSE,3.53,"young",20,182,78,"m"
14,"LEG EXTENSION",2,"Ecc03",2560,2540,2500,2450,2550,2475,0.029,75,2512.5,"Ecc",20,50,FALSE,FALSE,FALSE,3.03,"young",20,182,78,"m"
14,"LEG EXTENSION",2,"Ecc04",2660,2640,2550,2500,2650,2525,0.047,125,2587.5,"Ecc",20,50,FALSE,FALSE,FALSE,4.95,"young",20,182,78,"m"
14,"LEG EXTENSION",2,"Ecc05",3160,3180,3050,3000,3170,3025,0.046,145,3097.5,"Ecc",-20,50,FALSE,FALSE,FALSE,4.79,"young",20,182,78,"m"
14,"LEG EXTENSION",2,"Ecc06",2940,2940,2700,2800,2940,2750,0.065,190,2845,"Ecc",0,-100,TRUE,FALSE,FALSE,6.91,"young",20,182,78,"m"
14,"LEG EXTENSION",2,"Ecc07",3160,3160,2800,2950,3160,2875,0.09,285,3017.5,"Ecc",0,-150,TRUE,FALSE,FALSE,9.91,"young",20,182,78,"m"
14,"LEG EXTENSION",2,"Ecc08",3280,3280,3050,3050,3280,3050,0.07,230,3165,"Ecc",0,0,TRUE,FALSE,FALSE,7.54,"young",20,182,78,"m"
14,"LEG EXTENSION",2,"Ecc09",3100,3060,2850,2900,3080,2875,0.067,205,2977.5,"Ecc",40,-50,TRUE,TRUE,FALSE,7.13,"young",20,182,78,"m"
14,"LEG EXTENSION",2,"Ecc10",2860,2860,3000,2850,2860,2925,0.023,-65,2892.5,"Ecc",0,150,FALSE,FALSE,FALSE,2.22,"young",20,182,78,"m"
14,"LEG EXTENSION",1,"Rep01",5100,5140,5200,5000,5120,5100,0.004,20,5110,"Rep",-40,200,FALSE,FALSE,TRUE,0.39,"young",20,182,78,"m"
14,"LEG EXTENSION",1,"Rep02",4440,4440,4450,4450,4440,4450,0.002,-10,4445,"Rep",0,0,FALSE,FALSE,FALSE,0.22,"young",20,182,78,"m"
14,"LEG EXTENSION",1,"Rep03",4760,4740,4700,4700,4750,4700,0.011,50,4725,"Rep",20,0,FALSE,FALSE,FALSE,1.06,"young",20,182,78,"m"
14,"LEG EXTENSION",1,"Rep04",5060,5080,5050,5050,5070,5050,0.004,20,5060,"Rep",-20,0,FALSE,FALSE,FALSE,0.4,"young",20,182,78,"m"
14,"LEG EXTENSION",1,"Rep05",3940,3980,3950,3950,3960,3950,0.003,10,3955,"Rep",-40,0,FALSE,FALSE,FALSE,0.25,"young",20,182,78,"m"
14,"LEG EXTENSION",1,"Rep06",4580,4560,4600,4600,4570,4600,0.007,-30,4585,"Rep",20,0,FALSE,FALSE,FALSE,0.65,"young",20,182,78,"m"
14,"LEG EXTENSION",1,"Rep07",4880,4860,4800,4850,4870,4825,0.009,45,4847.5,"Rep",20,-50,FALSE,FALSE,FALSE,0.93,"young",20,182,78,"m"
14,"LEG EXTENSION",1,"Rep08",4100,4100,4150,4050,4100,4100,0,0,4100,"Rep",0,100,FALSE,FALSE,FALSE,0,"young",20,182,78,"m"
14,"LEG EXTENSION",1,"Rep09",4140,4160,3950,3750,4150,3850,0.072,300,4000,"Rep",-20,200,TRUE,FALSE,TRUE,7.79,"young",20,182,78,"m"
14,"LEG EXTENSION",1,"Rep10",4060,4040,4500,4650,4050,4575,0.13,-525,4312.5,"Rep",20,-150,TRUE,FALSE,FALSE,11.48,"young",20,182,78,"m"
14,"LEG EXTENSION",2,"Rep01",4400,4400,4200,4350,4400,4275,0.028,125,4337.5,"Rep",0,-150,TRUE,FALSE,FALSE,2.92,"young",20,182,78,"m"
14,"LEG EXTENSION",2,"Rep02",3600,3600,3600,3650,3600,3625,0.007,-25,3612.5,"Rep",0,-50,FALSE,FALSE,FALSE,0.69,"young",20,182,78,"m"
14,"LEG EXTENSION",2,"Rep03",3560,3560,3550,3550,3560,3550,0.003,10,3555,"Rep",0,0,FALSE,FALSE,FALSE,0.28,"young",20,182,78,"m"
14,"LEG EXTENSION",2,"Rep04",3740,3720,3700,3700,3730,3700,0.008,30,3715,"Rep",20,0,FALSE,FALSE,FALSE,0.81,"young",20,182,78,"m"
14,"LEG EXTENSION",2,"Rep05",4160,4180,4150,4150,4170,4150,0.005,20,4160,"Rep",-20,0,FALSE,FALSE,FALSE,0.48,"young",20,182,78,"m"
14,"LEG EXTENSION",2,"Rep06",3880,3880,3800,3900,3880,3850,0.008,30,3865,"Rep",0,-100,FALSE,FALSE,FALSE,0.78,"young",20,182,78,"m"
14,"LEG EXTENSION",2,"Rep07",4120,4120,4000,4050,4120,4025,0.023,95,4072.5,"Rep",0,-50,FALSE,FALSE,FALSE,2.36,"young",20,182,78,"m"
14,"LEG EXTENSION",2,"Rep08",4180,4180,4300,4200,4180,4250,0.017,-70,4215,"Rep",0,100,FALSE,FALSE,FALSE,1.65,"young",20,182,78,"m"
14,"LEG EXTENSION",2,"Rep09",4080,4060,4100,4100,4070,4100,0.007,-30,4085,"Rep",20,0,FALSE,FALSE,FALSE,0.73,"young",20,182,78,"m"
14,"LEG EXTENSION",2,"Rep10",3760,3780,4100,3950,3770,4025,0.068,-255,3897.5,"Rep",-20,150,TRUE,FALSE,FALSE,6.34,"young",20,182,78,"m"
14,"LEG EXTENSION",1,"TuT",45060,45100,45350,45050,45080,45200,0.003,-120,45140,"TuT",-40,300,FALSE,FALSE,TRUE,0.27,"young",20,182,78,"m"
14,"LEG EXTENSION",2,"TuT",39480,39480,39500,39600,39480,39550,0.002,-70,39515,"TuT",0,-100,FALSE,FALSE,FALSE,0.18,"young",20,182,78,"m"
14,"LEG CURL",1,"Con01",1500,1520,1600,1550,1510,1575,0.043,-65,1542.5,"Con",-20,50,FALSE,FALSE,FALSE,4.13,"young",20,182,78,"m"
14,"LEG CURL",1,"Con02",1700,1700,2100,2050,1700,2075,0.221,-375,1887.5,"Con",0,50,TRUE,FALSE,FALSE,18.07,"young",20,182,78,"m"
14,"LEG CURL",1,"Con03",1340,1360,1500,1450,1350,1475,0.093,-125,1412.5,"Con",-20,50,FALSE,FALSE,FALSE,8.47,"young",20,182,78,"m"
14,"LEG CURL",1,"Con04",1340,1360,1450,1450,1350,1450,0.074,-100,1400,"Con",-20,0,FALSE,FALSE,FALSE,6.9,"young",20,182,78,"m"
14,"LEG CURL",1,"Con05",1220,1220,1350,1400,1220,1375,0.127,-155,1297.5,"Con",0,-50,FALSE,FALSE,FALSE,11.27,"young",20,182,78,"m"
14,"LEG CURL",1,"Con06",1340,1320,1450,1500,1330,1475,0.109,-145,1402.5,"Con",20,-50,FALSE,FALSE,FALSE,9.83,"young",20,182,78,"m"
14,"LEG CURL",1,"Con07",1220,1220,1350,1400,1220,1375,0.127,-155,1297.5,"Con",0,-50,FALSE,FALSE,FALSE,11.27,"young",20,182,78,"m"
14,"LEG CURL",1,"Con08",1240,1240,1450,1550,1240,1500,0.21,-260,1370,"Con",0,-100,TRUE,FALSE,FALSE,17.33,"young",20,182,78,"m"
14,"LEG CURL",1,"Con09",1280,1300,1500,1500,1290,1500,0.163,-210,1395,"Con",-20,0,FALSE,FALSE,FALSE,14,"young",20,182,78,"m"
14,"LEG CURL",1,"Con10",1300,1320,1600,1550,1310,1575,0.202,-265,1442.5,"Con",-20,50,TRUE,FALSE,FALSE,16.83,"young",20,182,78,"m"
14,"LEG CURL",2,"Con01",1420,1380,1550,1450,1400,1500,0.071,-100,1450,"Con",40,100,FALSE,FALSE,FALSE,6.67,"young",20,182,78,"m"
14,"LEG CURL",2,"Con02",1400,1400,1600,2000,1400,1800,0.286,-400,1600,"Con",0,-400,TRUE,FALSE,TRUE,22.22,"young",20,182,78,"m"
14,"LEG CURL",2,"Con03",1260,1280,1400,1500,1270,1450,0.142,-180,1360,"Con",-20,-100,FALSE,FALSE,FALSE,12.41,"young",20,182,78,"m"
14,"LEG CURL",2,"Con04",1180,1180,1400,1400,1180,1400,0.186,-220,1290,"Con",0,0,FALSE,FALSE,FALSE,15.71,"young",20,182,78,"m"
14,"LEG CURL",2,"Con05",1160,1160,1350,1300,1160,1325,0.142,-165,1242.5,"Con",0,50,FALSE,FALSE,FALSE,12.45,"young",20,182,78,"m"
14,"LEG CURL",2,"Con06",1320,1340,1400,1400,1330,1400,0.053,-70,1365,"Con",-20,0,FALSE,FALSE,FALSE,5,"young",20,182,78,"m"
14,"LEG CURL",2,"Con07",1220,1260,1350,1350,1240,1350,0.089,-110,1295,"Con",-40,0,FALSE,FALSE,FALSE,8.15,"young",20,182,78,"m"
14,"LEG CURL",2,"Con08",1160,1140,1400,1350,1150,1375,0.196,-225,1262.5,"Con",20,50,FALSE,FALSE,FALSE,16.36,"young",20,182,78,"m"
14,"LEG CURL",2,"Con09",1240,1220,2550,2550,1230,2550,1.073,-1320,1890,"Con",20,0,TRUE,FALSE,FALSE,51.76,"young",20,182,78,"m"
14,"LEG CURL",2,"Con10",1240,1220,2400,2600,1230,2500,1.033,-1270,1865,"Con",20,-200,TRUE,FALSE,TRUE,50.8,"young",20,182,78,"m"
14,"LEG CURL",1,"Ecc01",4100,4100,3600,3750,4100,3675,0.104,425,3887.5,"Ecc",0,-150,TRUE,FALSE,FALSE,11.56,"young",20,182,78,"m"
14,"LEG CURL",1,"Ecc02",4060,4040,3850,3850,4050,3850,0.049,200,3950,"Ecc",20,0,FALSE,FALSE,FALSE,5.19,"young",20,182,78,"m"
14,"LEG CURL",1,"Ecc03",3980,3960,3850,3850,3970,3850,0.03,120,3910,"Ecc",20,0,FALSE,FALSE,FALSE,3.12,"young",20,182,78,"m"
14,"LEG CURL",1,"Ecc04",3900,3900,3800,3800,3900,3800,0.026,100,3850,"Ecc",0,0,FALSE,FALSE,FALSE,2.63,"young",20,182,78,"m"
14,"LEG CURL",1,"Ecc05",3420,3440,3250,3200,3430,3225,0.06,205,3327.5,"Ecc",-20,50,FALSE,FALSE,FALSE,6.36,"young",20,182,78,"m"
14,"LEG CURL",1,"Ecc06",3280,3280,3200,3150,3280,3175,0.032,105,3227.5,"Ecc",0,50,FALSE,FALSE,FALSE,3.31,"young",20,182,78,"m"
14,"LEG CURL",1,"Ecc07",3820,3820,3600,3500,3820,3550,0.071,270,3685,"Ecc",0,100,TRUE,FALSE,FALSE,7.61,"young",20,182,78,"m"
14,"LEG CURL",1,"Ecc08",3400,3380,3150,3150,3390,3150,0.071,240,3270,"Ecc",20,0,TRUE,FALSE,FALSE,7.62,"young",20,182,78,"m"
14,"LEG CURL",1,"Ecc09",3660,3640,3450,3450,3650,3450,0.055,200,3550,"Ecc",20,0,FALSE,FALSE,FALSE,5.8,"young",20,182,78,"m"
14,"LEG CURL",1,"Ecc10",3620,3580,3500,3600,3600,3550,0.014,50,3575,"Ecc",40,-100,FALSE,FALSE,FALSE,1.41,"young",20,182,78,"m"
14,"LEG CURL",2,"Ecc01",4020,4040,3800,3650,4030,3725,0.076,305,3877.5,"Ecc",-20,150,TRUE,FALSE,FALSE,8.19,"young",20,182,78,"m"
14,"LEG CURL",2,"Ecc02",5080,5040,4850,4500,5060,4675,0.076,385,4867.5,"Ecc",40,350,TRUE,FALSE,TRUE,8.24,"young",20,182,78,"m"
14,"LEG CURL",2,"Ecc03",4100,4100,3950,3900,4100,3925,0.043,175,4012.5,"Ecc",0,50,FALSE,FALSE,FALSE,4.46,"young",20,182,78,"m"
14,"LEG CURL",2,"Ecc04",4340,4340,4150,4200,4340,4175,0.038,165,4257.5,"Ecc",0,-50,FALSE,FALSE,FALSE,3.95,"young",20,182,78,"m"
14,"LEG CURL",2,"Ecc05",4280,4260,4150,4150,4270,4150,0.028,120,4210,"Ecc",20,0,FALSE,FALSE,FALSE,2.89,"young",20,182,78,"m"
14,"LEG CURL",2,"Ecc06",4940,4920,4800,4800,4930,4800,0.026,130,4865,"Ecc",20,0,FALSE,FALSE,FALSE,2.71,"young",20,182,78,"m"
14,"LEG CURL",2,"Ecc07",4560,4560,4450,4500,4560,4475,0.019,85,4517.5,"Ecc",0,-50,FALSE,FALSE,FALSE,1.9,"young",20,182,78,"m"
14,"LEG CURL",2,"Ecc08",4460,4480,3150,3200,4470,3175,0.29,1295,3822.5,"Ecc",-20,-50,TRUE,FALSE,FALSE,40.79,"young",20,182,78,"m"
14,"LEG CURL",2,"Ecc09",4960,4980,3750,3550,4970,3650,0.266,1320,4310,"Ecc",-20,200,TRUE,FALSE,TRUE,36.16,"young",20,182,78,"m"
14,"LEG CURL",2,"Ecc10",3640,3660,3600,3700,3650,3650,0,0,3650,"Ecc",-20,-100,FALSE,FALSE,FALSE,0,"young",20,182,78,"m"
14,"LEG CURL",1,"Rep01",5600,5620,5200,5300,5610,5250,0.064,360,5430,"Rep",-20,-100,TRUE,FALSE,FALSE,6.86,"young",20,182,78,"m"
14,"LEG CURL",1,"Rep02",5760,5740,5950,5900,5750,5925,0.03,-175,5837.5,"Rep",20,50,TRUE,FALSE,FALSE,2.95,"young",20,182,78,"m"
14,"LEG CURL",1,"Rep03",5320,5320,5350,5300,5320,5325,0.001,-5,5322.5,"Rep",0,50,FALSE,FALSE,FALSE,0.09,"young",20,182,78,"m"
14,"LEG CURL",1,"Rep04",5240,5260,5250,5250,5250,5250,0,0,5250,"Rep",-20,0,FALSE,FALSE,FALSE,0,"young",20,182,78,"m"
14,"LEG CURL",1,"Rep05",4640,4660,4600,4600,4650,4600,0.011,50,4625,"Rep",-20,0,FALSE,FALSE,FALSE,1.09,"young",20,182,78,"m"
14,"LEG CURL",1,"Rep06",4620,4600,4650,4650,4610,4650,0.009,-40,4630,"Rep",20,0,FALSE,FALSE,FALSE,0.86,"young",20,182,78,"m"
14,"LEG CURL",1,"Rep07",5040,5040,4950,4900,5040,4925,0.023,115,4982.5,"Rep",0,50,FALSE,FALSE,FALSE,2.34,"young",20,182,78,"m"
14,"LEG CURL",1,"Rep08",4640,4620,4600,4700,4630,4650,0.004,-20,4640,"Rep",20,-100,FALSE,FALSE,FALSE,0.43,"young",20,182,78,"m"
14,"LEG CURL",1,"Rep09",4940,4940,4950,4950,4940,4950,0.002,-10,4945,"Rep",0,0,FALSE,FALSE,FALSE,0.2,"young",20,182,78,"m"
14,"LEG CURL",1,"Rep10",4920,4900,5100,5150,4910,5125,0.044,-215,5017.5,"Rep",20,-50,TRUE,FALSE,FALSE,4.2,"young",20,182,78,"m"
14,"LEG CURL",2,"Rep01",5440,5420,5350,5100,5430,5225,0.038,205,5327.5,"Rep",20,250,TRUE,FALSE,TRUE,3.92,"young",20,182,78,"m"
14,"LEG CURL",2,"Rep02",6480,6440,6450,6500,6460,6475,0.002,-15,6467.5,"Rep",40,-50,FALSE,FALSE,FALSE,0.23,"young",20,182,78,"m"
14,"LEG CURL",2,"Rep03",5360,5380,5350,5400,5370,5375,0.001,-5,5372.5,"Rep",-20,-50,FALSE,FALSE,FALSE,0.09,"young",20,182,78,"m"
14,"LEG CURL",2,"Rep04",5520,5520,5550,5600,5520,5575,0.01,-55,5547.5,"Rep",0,-50,FALSE,FALSE,FALSE,0.99,"young",20,182,78,"m"
14,"LEG CURL",2,"Rep05",5440,5420,5500,5450,5430,5475,0.008,-45,5452.5,"Rep",20,50,FALSE,FALSE,FALSE,0.82,"young",20,182,78,"m"
14,"LEG CURL",2,"Rep06",6260,6260,6200,6200,6260,6200,0.01,60,6230,"Rep",0,0,FALSE,FALSE,FALSE,0.97,"young",20,182,78,"m"
14,"LEG CURL",2,"Rep07",5780,5820,5800,5850,5800,5825,0.004,-25,5812.5,"Rep",-40,-50,FALSE,FALSE,FALSE,0.43,"young",20,182,78,"m"
14,"LEG CURL",2,"Rep08",5620,5620,4550,4550,5620,4550,0.19,1070,5085,"Rep",0,0,TRUE,FALSE,FALSE,23.52,"young",20,182,78,"m"
14,"LEG CURL",2,"Rep09",6200,6200,6300,6100,6200,6200,0,0,6200,"Rep",0,200,FALSE,FALSE,TRUE,0,"young",20,182,78,"m"
14,"LEG CURL",2,"Rep10",4880,4880,6000,6300,4880,6150,0.26,-1270,5515,"Rep",0,-300,TRUE,FALSE,TRUE,20.65,"young",20,182,78,"m"
14,"LEG CURL",1,"TuT",50720,50700,50600,50700,50710,50650,0.001,60,50680,"TuT",20,-100,FALSE,FALSE,FALSE,0.12,"young",20,182,78,"m"
14,"LEG CURL",2,"TuT",56980,56960,57050,57050,56970,57050,0.001,-80,57010,"TuT",20,0,FALSE,FALSE,FALSE,0.14,"young",20,182,78,"m"
14,"ABDUCTOR",1,"Con01",1180,1140,1250,1400,1160,1325,0.142,-165,1242.5,"Con",40,-150,FALSE,TRUE,FALSE,12.45,"young",20,182,78,"m"
14,"ABDUCTOR",1,"Con02",900,920,1100,1150,910,1125,0.236,-215,1017.5,"Con",-20,-50,FALSE,FALSE,FALSE,19.11,"young",20,182,78,"m"
14,"ABDUCTOR",1,"Con03",820,840,1000,1000,830,1000,0.205,-170,915,"Con",-20,0,FALSE,FALSE,FALSE,17,"young",20,182,78,"m"
14,"ABDUCTOR",1,"Con04",800,820,1050,1050,810,1050,0.296,-240,930,"Con",-20,0,FALSE,FALSE,FALSE,22.86,"young",20,182,78,"m"
14,"ABDUCTOR",1,"Con05",780,800,1050,900,790,975,0.234,-185,882.5,"Con",-20,150,FALSE,FALSE,FALSE,18.97,"young",20,182,78,"m"
14,"ABDUCTOR",1,"Con06",840,880,1050,1000,860,1025,0.192,-165,942.5,"Con",-40,50,FALSE,TRUE,FALSE,16.1,"young",20,182,78,"m"
14,"ABDUCTOR",1,"Con07",1040,1040,1150,1200,1040,1175,0.13,-135,1107.5,"Con",0,-50,FALSE,FALSE,FALSE,11.49,"young",20,182,78,"m"
14,"ABDUCTOR",1,"Con08",860,860,1100,1400,860,1250,0.453,-390,1055,"Con",0,-300,TRUE,FALSE,TRUE,31.2,"young",20,182,78,"m"
14,"ABDUCTOR",1,"Con09",820,840,1150,1250,830,1200,0.446,-370,1015,"Con",-20,-100,TRUE,FALSE,FALSE,30.83,"young",20,182,78,"m"
14,"ABDUCTOR",1,"Con10",860,900,1100,1150,880,1125,0.278,-245,1002.5,"Con",-40,-50,FALSE,TRUE,FALSE,21.78,"young",20,182,78,"m"
14,"ABDUCTOR",2,"Con01",1080,1080,1350,1250,1080,1300,0.204,-220,1190,"Con",0,100,FALSE,FALSE,FALSE,16.92,"young",20,182,78,"m"
14,"ABDUCTOR",2,"Con02",980,980,1150,1150,980,1150,0.173,-170,1065,"Con",0,0,FALSE,FALSE,FALSE,14.78,"young",20,182,78,"m"
14,"ABDUCTOR",2,"Con03",940,960,1150,1350,950,1250,0.316,-300,1100,"Con",-20,-200,TRUE,FALSE,FALSE,24,"young",20,182,78,"m"
14,"ABDUCTOR",2,"Con04",820,820,1050,1050,820,1050,0.28,-230,935,"Con",0,0,FALSE,FALSE,FALSE,21.9,"young",20,182,78,"m"
14,"ABDUCTOR",2,"Con05",840,840,1050,950,840,1000,0.19,-160,920,"Con",0,100,FALSE,FALSE,FALSE,16,"young",20,182,78,"m"
14,"ABDUCTOR",2,"Con06",820,840,1050,1000,830,1025,0.235,-195,927.5,"Con",-20,50,FALSE,FALSE,FALSE,19.02,"young",20,182,78,"m"
14,"ABDUCTOR",2,"Con07",860,880,1000,1050,870,1025,0.178,-155,947.5,"Con",-20,-50,FALSE,FALSE,FALSE,15.12,"young",20,182,78,"m"
14,"ABDUCTOR",2,"Con08",960,940,1150,1100,950,1125,0.184,-175,1037.5,"Con",20,50,FALSE,FALSE,FALSE,15.56,"young",20,182,78,"m"
14,"ABDUCTOR",2,"Con09",900,860,1050,1100,880,1075,0.222,-195,977.5,"Con",40,-50,FALSE,TRUE,FALSE,18.14,"young",20,182,78,"m"
14,"ABDUCTOR",2,"Con10",860,840,1050,1000,850,1025,0.206,-175,937.5,"Con",20,50,FALSE,FALSE,FALSE,17.07,"young",20,182,78,"m"
14,"ABDUCTOR",1,"Ecc01",3460,3420,3250,3200,3440,3225,0.062,215,3332.5,"Ecc",40,50,FALSE,TRUE,FALSE,6.67,"young",20,182,78,"m"
14,"ABDUCTOR",1,"Ecc02",3340,3320,3200,3150,3330,3175,0.047,155,3252.5,"Ecc",20,50,FALSE,FALSE,FALSE,4.88,"young",20,182,78,"m"
14,"ABDUCTOR",1,"Ecc03",3260,3240,3050,3050,3250,3050,0.062,200,3150,"Ecc",20,0,FALSE,FALSE,FALSE,6.56,"young",20,182,78,"m"
14,"ABDUCTOR",1,"Ecc04",3700,3680,3400,3500,3690,3450,0.065,240,3570,"Ecc",20,-100,FALSE,FALSE,FALSE,6.96,"young",20,182,78,"m"
14,"ABDUCTOR",1,"Ecc05",3180,3160,3000,3100,3170,3050,0.038,120,3110,"Ecc",20,-100,FALSE,FALSE,FALSE,3.93,"young",20,182,78,"m"
14,"ABDUCTOR",1,"Ecc06",3280,3260,3100,3150,3270,3125,0.044,145,3197.5,"Ecc",20,-50,FALSE,FALSE,FALSE,4.64,"young",20,182,78,"m"
14,"ABDUCTOR",1,"Ecc07",3220,3220,3000,2650,3220,2825,0.123,395,3022.5,"Ecc",0,350,TRUE,FALSE,TRUE,13.98,"young",20,182,78,"m"
14,"ABDUCTOR",1,"Ecc08",3060,3060,2850,2750,3060,2800,0.085,260,2930,"Ecc",0,100,FALSE,FALSE,FALSE,9.29,"young",20,182,78,"m"
14,"ABDUCTOR",1,"Ecc09",3160,3120,2850,2750,3140,2800,0.108,340,2970,"Ecc",40,100,TRUE,TRUE,FALSE,12.14,"young",20,182,78,"m"
14,"ABDUCTOR",1,"Ecc10",3220,3220,3100,3200,3220,3150,0.022,70,3185,"Ecc",0,-100,FALSE,FALSE,FALSE,2.22,"young",20,182,78,"m"
14,"ABDUCTOR",2,"Ecc01",3520,3520,3350,3350,3520,3350,0.048,170,3435,"Ecc",0,0,FALSE,FALSE,FALSE,5.07,"young",20,182,78,"m"
14,"ABDUCTOR",2,"Ecc02",2460,2440,2250,2100,2450,2175,0.112,275,2312.5,"Ecc",20,150,FALSE,FALSE,FALSE,12.64,"young",20,182,78,"m"
14,"ABDUCTOR",2,"Ecc03",3500,3500,3300,3200,3500,3250,0.071,250,3375,"Ecc",0,100,FALSE,FALSE,FALSE,7.69,"young",20,182,78,"m"
14,"ABDUCTOR",2,"Ecc04",3140,3120,2850,2950,3130,2900,0.073,230,3015,"Ecc",20,-100,FALSE,FALSE,FALSE,7.93,"young",20,182,78,"m"
14,"ABDUCTOR",2,"Ecc05",3260,3280,3100,3150,3270,3125,0.044,145,3197.5,"Ecc",-20,-50,FALSE,FALSE,FALSE,4.64,"young",20,182,78,"m"
14,"ABDUCTOR",2,"Ecc06",2800,2780,2600,2600,2790,2600,0.068,190,2695,"Ecc",20,0,FALSE,FALSE,FALSE,7.31,"young",20,182,78,"m"
14,"ABDUCTOR",2,"Ecc07",3220,3220,3050,3050,3220,3050,0.053,170,3135,"Ecc",0,0,FALSE,FALSE,FALSE,5.57,"young",20,182,78,"m"
14,"ABDUCTOR",2,"Ecc08",2960,2980,2800,2800,2970,2800,0.057,170,2885,"Ecc",-20,0,FALSE,FALSE,FALSE,6.07,"young",20,182,78,"m"
14,"ABDUCTOR",2,"Ecc09",3180,3200,3000,3000,3190,3000,0.06,190,3095,"Ecc",-20,0,FALSE,FALSE,FALSE,6.33,"young",20,182,78,"m"
14,"ABDUCTOR",2,"Ecc10",2920,2920,2950,2900,2920,2925,0.002,-5,2922.5,"Ecc",0,50,FALSE,FALSE,FALSE,0.17,"young",20,182,78,"m"
14,"ABDUCTOR",1,"Rep01",4640,4560,4500,4600,4600,4550,0.011,50,4575,"Rep",80,-100,FALSE,TRUE,FALSE,1.1,"young",20,182,78,"m"
14,"ABDUCTOR",1,"Rep02",4240,4240,4300,4300,4240,4300,0.014,-60,4270,"Rep",0,0,FALSE,FALSE,FALSE,1.4,"young",20,182,78,"m"
14,"ABDUCTOR",1,"Rep03",4080,4080,4050,4050,4080,4050,0.007,30,4065,"Rep",0,0,FALSE,FALSE,FALSE,0.74,"young",20,182,78,"m"
14,"ABDUCTOR",1,"Rep04",4500,4500,4450,4550,4500,4500,0,0,4500,"Rep",0,-100,FALSE,FALSE,FALSE,0,"young",20,182,78,"m"
14,"ABDUCTOR",1,"Rep05",3960,3960,4050,4000,3960,4025,0.016,-65,3992.5,"Rep",0,50,FALSE,FALSE,FALSE,1.61,"young",20,182,78,"m"
14,"ABDUCTOR",1,"Rep06",4120,4140,4150,4150,4130,4150,0.005,-20,4140,"Rep",-20,0,FALSE,FALSE,FALSE,0.48,"young",20,182,78,"m"
14,"ABDUCTOR",1,"Rep07",4260,4260,4150,3850,4260,4000,0.061,260,4130,"Rep",0,300,FALSE,FALSE,FALSE,6.5,"young",20,182,78,"m"
14,"ABDUCTOR",1,"Rep08",3920,3920,3950,4150,3920,4050,0.033,-130,3985,"Rep",0,-200,FALSE,FALSE,FALSE,3.21,"young",20,182,78,"m"
14,"ABDUCTOR",1,"Rep09",3980,3960,4000,4000,3970,4000,0.008,-30,3985,"Rep",20,0,FALSE,FALSE,FALSE,0.75,"young",20,182,78,"m"
14,"ABDUCTOR",1,"Rep10",4080,4120,4200,4350,4100,4275,0.043,-175,4187.5,"Rep",-40,-150,FALSE,FALSE,FALSE,4.09,"young",20,182,78,"m"
14,"ABDUCTOR",2,"Rep01",4600,4600,4700,4600,4600,4650,0.011,-50,4625,"Rep",0,100,FALSE,FALSE,FALSE,1.08,"young",20,182,78,"m"
14,"ABDUCTOR",2,"Rep02",3440,3420,3400,3250,3430,3325,0.031,105,3377.5,"Rep",20,150,FALSE,FALSE,FALSE,3.16,"young",20,182,78,"m"
14,"ABDUCTOR",2,"Rep03",4440,4460,4450,4550,4450,4500,0.011,-50,4475,"Rep",-20,-100,FALSE,FALSE,FALSE,1.11,"young",20,182,78,"m"
14,"ABDUCTOR",2,"Rep04",3960,3940,3900,4000,3950,3950,0,0,3950,"Rep",20,-100,FALSE,FALSE,FALSE,0,"young",20,182,78,"m"
14,"ABDUCTOR",2,"Rep05",4100,4120,4150,4100,4110,4125,0.004,-15,4117.5,"Rep",-20,50,FALSE,FALSE,FALSE,0.36,"young",20,182,78,"m"
14,"ABDUCTOR",2,"Rep06",3620,3620,3650,3600,3620,3625,0.001,-5,3622.5,"Rep",0,50,FALSE,FALSE,FALSE,0.14,"young",20,182,78,"m"
14,"ABDUCTOR",2,"Rep07",4080,4100,4050,4100,4090,4075,0.004,15,4082.5,"Rep",-20,-50,FALSE,FALSE,FALSE,0.37,"young",20,182,78,"m"
14,"ABDUCTOR",2,"Rep08",3920,3920,3950,3900,3920,3925,0.001,-5,3922.5,"Rep",0,50,FALSE,FALSE,FALSE,0.13,"young",20,182,78,"m"
14,"ABDUCTOR",2,"Rep09",4080,4060,4050,4100,4070,4075,0.001,-5,4072.5,"Rep",20,-50,FALSE,FALSE,FALSE,0.12,"young",20,182,78,"m"
14,"ABDUCTOR",2,"Rep10",3780,3760,4000,3900,3770,3950,0.048,-180,3860,"Rep",20,100,FALSE,FALSE,FALSE,4.56,"young",20,182,78,"m"
14,"ABDUCTOR",1,"TuT",41780,41740,41800,42000,41760,41900,0.003,-140,41830,"TuT",40,-200,FALSE,TRUE,FALSE,0.33,"young",20,182,78,"m"
14,"ABDUCTOR",2,"TuT",40020,40000,40300,40100,40010,40200,0.005,-190,40105,"TuT",20,200,FALSE,FALSE,FALSE,0.47,"young",20,182,78,"m"
14,"ADDUCTOR",1,"Con01",1020,1000,1300,1450,1010,1375,0.361,-365,1192.5,"Con",20,-150,FALSE,FALSE,FALSE,26.55,"young",20,182,78,"m"
14,"ADDUCTOR",1,"Con02",1180,1180,1150,1500,1180,1325,0.123,-145,1252.5,"Con",0,-350,FALSE,FALSE,TRUE,10.94,"young",20,182,78,"m"
14,"ADDUCTOR",1,"Con03",920,980,1100,1100,950,1100,0.158,-150,1025,"Con",-60,0,FALSE,TRUE,FALSE,13.64,"young",20,182,78,"m"
14,"ADDUCTOR",1,"Con04",860,880,1050,900,870,975,0.121,-105,922.5,"Con",-20,150,FALSE,FALSE,FALSE,10.77,"young",20,182,78,"m"
14,"ADDUCTOR",1,"Con05",920,940,1150,900,930,1025,0.102,-95,977.5,"Con",-20,250,FALSE,FALSE,FALSE,9.27,"young",20,182,78,"m"
14,"ADDUCTOR",1,"Con06",820,840,1700,1200,830,1450,0.747,-620,1140,"Con",-20,500,TRUE,FALSE,TRUE,42.76,"young",20,182,78,"m"
14,"ADDUCTOR",1,"Con07",920,920,1750,2050,920,1900,1.065,-980,1410,"Con",0,-300,TRUE,FALSE,FALSE,51.58,"young",20,182,78,"m"
14,"ADDUCTOR",1,"Con08",880,860,1100,1850,870,1475,0.695,-605,1172.5,"Con",20,-750,TRUE,FALSE,TRUE,41.02,"young",20,182,78,"m"
14,"ADDUCTOR",1,"Con09",820,840,1050,1500,830,1275,0.536,-445,1052.5,"Con",-20,-450,FALSE,FALSE,TRUE,34.9,"young",20,182,78,"m"
14,"ADDUCTOR",1,"Con10",880,920,1100,1350,900,1225,0.361,-325,1062.5,"Con",-40,-250,FALSE,TRUE,FALSE,26.53,"young",20,182,78,"m"
14,"ADDUCTOR",2,"Con01",1020,1020,1500,1550,1020,1525,0.495,-505,1272.5,"Con",0,-50,FALSE,FALSE,FALSE,33.11,"young",20,182,78,"m"
14,"ADDUCTOR",2,"Con02",860,860,1250,1200,860,1225,0.424,-365,1042.5,"Con",0,50,FALSE,FALSE,FALSE,29.8,"young",20,182,78,"m"
14,"ADDUCTOR",2,"Con03",1000,960,1400,1150,980,1275,0.301,-295,1127.5,"Con",40,250,FALSE,TRUE,FALSE,23.14,"young",20,182,78,"m"
14,"ADDUCTOR",2,"Con04",760,780,1150,1150,770,1150,0.494,-380,960,"Con",-20,0,FALSE,FALSE,FALSE,33.04,"young",20,182,78,"m"
14,"ADDUCTOR",2,"Con05",820,820,1400,1350,820,1375,0.677,-555,1097.5,"Con",0,50,FALSE,FALSE,FALSE,40.36,"young",20,182,78,"m"
14,"ADDUCTOR",2,"Con06",820,840,900,1000,830,950,0.145,-120,890,"Con",-20,-100,FALSE,FALSE,FALSE,12.63,"young",20,182,78,"m"
14,"ADDUCTOR",2,"Con07",680,700,850,850,690,850,0.232,-160,770,"Con",-20,0,FALSE,FALSE,FALSE,18.82,"young",20,182,78,"m"
14,"ADDUCTOR",2,"Con08",720,740,850,850,730,850,0.164,-120,790,"Con",-20,0,FALSE,FALSE,FALSE,14.12,"young",20,182,78,"m"
14,"ADDUCTOR",2,"Con09",740,780,1450,1200,760,1325,0.743,-565,1042.5,"Con",-40,250,FALSE,TRUE,FALSE,42.64,"young",20,182,78,"m"
14,"ADDUCTOR",2,"Con10",780,820,1700,1050,800,1375,0.719,-575,1087.5,"Con",-40,650,FALSE,TRUE,TRUE,41.82,"young",20,182,78,"m"
14,"ADDUCTOR",1,"Ecc01",3260,3280,3100,2950,3270,3025,0.075,245,3147.5,"Ecc",-20,150,FALSE,FALSE,FALSE,8.1,"young",20,182,78,"m"
14,"ADDUCTOR",1,"Ecc02",3340,3320,3300,3000,3330,3150,0.054,180,3240,"Ecc",20,300,FALSE,FALSE,FALSE,5.71,"young",20,182,78,"m"
14,"ADDUCTOR",1,"Ecc03",3280,3220,3100,3200,3250,3150,0.031,100,3200,"Ecc",60,-100,FALSE,TRUE,FALSE,3.17,"young",20,182,78,"m"
14,"ADDUCTOR",1,"Ecc04",3240,3240,3050,3200,3240,3125,0.035,115,3182.5,"Ecc",0,-150,FALSE,FALSE,FALSE,3.68,"young",20,182,78,"m"
14,"ADDUCTOR",1,"Ecc05",3420,3400,2950,3350,3410,3150,0.076,260,3280,"Ecc",20,-400,FALSE,FALSE,TRUE,8.25,"young",20,182,78,"m"
14,"ADDUCTOR",1,"Ecc06",3220,3200,2500,2800,3210,2650,0.174,560,2930,"Ecc",20,-300,TRUE,FALSE,FALSE,21.13,"young",20,182,78,"m"
14,"ADDUCTOR",1,"Ecc07",3060,3060,2250,1550,3060,1900,0.379,1160,2480,"Ecc",0,700,TRUE,FALSE,TRUE,61.05,"young",20,182,78,"m"
14,"ADDUCTOR",1,"Ecc08",3060,3060,2950,2400,3060,2675,0.126,385,2867.5,"Ecc",0,550,FALSE,FALSE,TRUE,14.39,"young",20,182,78,"m"
14,"ADDUCTOR",1,"Ecc09",2960,2940,2700,2250,2950,2475,0.161,475,2712.5,"Ecc",20,450,FALSE,FALSE,TRUE,19.19,"young",20,182,78,"m"
14,"ADDUCTOR",1,"Ecc10",2640,2620,2550,2500,2630,2525,0.04,105,2577.5,"Ecc",20,50,FALSE,FALSE,FALSE,4.16,"young",20,182,78,"m"
14,"ADDUCTOR",2,"Ecc01",2660,2660,2050,2050,2660,2050,0.229,610,2355,"Ecc",0,0,TRUE,FALSE,FALSE,29.76,"young",20,182,78,"m"
14,"ADDUCTOR",2,"Ecc02",2520,2500,2050,2150,2510,2100,0.163,410,2305,"Ecc",20,-100,FALSE,FALSE,FALSE,19.52,"young",20,182,78,"m"
14,"ADDUCTOR",2,"Ecc03",2560,2600,2200,2450,2580,2325,0.099,255,2452.5,"Ecc",-40,-250,FALSE,TRUE,FALSE,10.97,"young",20,182,78,"m"
14,"ADDUCTOR",2,"Ecc04",2940,2940,2450,2450,2940,2450,0.167,490,2695,"Ecc",0,0,FALSE,FALSE,FALSE,20,"young",20,182,78,"m"
14,"ADDUCTOR",2,"Ecc05",2740,2740,2350,2350,2740,2350,0.142,390,2545,"Ecc",0,0,FALSE,FALSE,FALSE,16.6,"young",20,182,78,"m"
14,"ADDUCTOR",2,"Ecc06",3320,3280,3250,3150,3300,3200,0.03,100,3250,"Ecc",40,100,FALSE,TRUE,FALSE,3.12,"young",20,182,78,"m"
14,"ADDUCTOR",2,"Ecc07",3480,3480,3300,3350,3480,3325,0.045,155,3402.5,"Ecc",0,-50,FALSE,FALSE,FALSE,4.66,"young",20,182,78,"m"
14,"ADDUCTOR",2,"Ecc08",3700,3660,3100,3350,3680,3225,0.124,455,3452.5,"Ecc",40,-250,FALSE,TRUE,FALSE,14.11,"young",20,182,78,"m"
14,"ADDUCTOR",2,"Ecc09",3420,3360,3050,3100,3390,3075,0.093,315,3232.5,"Ecc",60,-50,FALSE,TRUE,FALSE,10.24,"young",20,182,78,"m"
14,"ADDUCTOR",2,"Ecc10",3240,3260,2600,3150,3250,2875,0.115,375,3062.5,"Ecc",-20,-550,FALSE,FALSE,TRUE,13.04,"young",20,182,78,"m"
14,"ADDUCTOR",1,"Rep01",4280,4280,4400,4400,4280,4400,0.028,-120,4340,"Rep",0,0,FALSE,FALSE,FALSE,2.73,"young",20,182,78,"m"
14,"ADDUCTOR",1,"Rep02",4520,4500,4450,4500,4510,4475,0.008,35,4492.5,"Rep",20,-50,FALSE,FALSE,FALSE,0.78,"young",20,182,78,"m"
14,"ADDUCTOR",1,"Rep03",4200,4200,4200,4300,4200,4250,0.012,-50,4225,"Rep",0,-100,FALSE,FALSE,FALSE,1.18,"young",20,182,78,"m"
14,"ADDUCTOR",1,"Rep04",4100,4120,4100,4100,4110,4100,0.002,10,4105,"Rep",-20,0,FALSE,FALSE,FALSE,0.24,"young",20,182,78,"m"
14,"ADDUCTOR",1,"Rep05",4340,4340,4100,4250,4340,4175,0.038,165,4257.5,"Rep",0,-150,FALSE,FALSE,FALSE,3.95,"young",20,182,78,"m"
14,"ADDUCTOR",1,"Rep06",4040,4040,4200,4000,4040,4100,0.015,-60,4070,"Rep",0,200,FALSE,FALSE,FALSE,1.46,"young",20,182,78,"m"
14,"ADDUCTOR",1,"Rep07",3980,3980,4000,3600,3980,3800,0.045,180,3890,"Rep",0,400,FALSE,FALSE,TRUE,4.74,"young",20,182,78,"m"
14,"ADDUCTOR",1,"Rep08",3940,3920,4050,4250,3930,4150,0.056,-220,4040,"Rep",20,-200,FALSE,FALSE,FALSE,5.3,"young",20,182,78,"m"
14,"ADDUCTOR",1,"Rep09",3780,3780,3750,3750,3780,3750,0.008,30,3765,"Rep",0,0,FALSE,FALSE,FALSE,0.8,"young",20,182,78,"m"
14,"ADDUCTOR",1,"Rep10",3520,3540,3650,3850,3530,3750,0.062,-220,3640,"Rep",-20,-200,FALSE,FALSE,FALSE,5.87,"young",20,182,78,"m"
14,"ADDUCTOR",2,"Rep01",3680,3680,3550,3600,3680,3575,0.029,105,3627.5,"Rep",0,-50,FALSE,FALSE,FALSE,2.94,"young",20,182,78,"m"
14,"ADDUCTOR",2,"Rep02",3380,3360,3300,3350,3370,3325,0.013,45,3347.5,"Rep",20,-50,FALSE,FALSE,FALSE,1.35,"young",20,182,78,"m"
14,"ADDUCTOR",2,"Rep03",3560,3560,3600,3600,3560,3600,0.011,-40,3580,"Rep",0,0,FALSE,FALSE,FALSE,1.11,"young",20,182,78,"m"
14,"ADDUCTOR",2,"Rep04",3700,3720,3600,3600,3710,3600,0.03,110,3655,"Rep",-20,0,FALSE,FALSE,FALSE,3.06,"young",20,182,78,"m"
14,"ADDUCTOR",2,"Rep05",3560,3560,3750,3700,3560,3725,0.046,-165,3642.5,"Rep",0,50,FALSE,FALSE,FALSE,4.43,"young",20,182,78,"m"
14,"ADDUCTOR",2,"Rep06",4140,4120,4150,4150,4130,4150,0.005,-20,4140,"Rep",20,0,FALSE,FALSE,FALSE,0.48,"young",20,182,78,"m"
14,"ADDUCTOR",2,"Rep07",4160,4180,4150,4200,4170,4175,0.001,-5,4172.5,"Rep",-20,-50,FALSE,FALSE,FALSE,0.12,"young",20,182,78,"m"
14,"ADDUCTOR",2,"Rep08",4420,4400,3950,4200,4410,4075,0.076,335,4242.5,"Rep",20,-250,FALSE,FALSE,TRUE,8.22,"young",20,182,78,"m"
14,"ADDUCTOR",2,"Rep09",4160,4140,4500,4300,4150,4400,0.06,-250,4275,"Rep",20,200,FALSE,FALSE,FALSE,5.68,"young",20,182,78,"m"
14,"ADDUCTOR",2,"Rep10",4020,4080,4300,4200,4050,4250,0.049,-200,4150,"Rep",-60,100,FALSE,FALSE,FALSE,4.71,"young",20,182,78,"m"
14,"ADDUCTOR",1,"TuT",40700,40700,40900,41000,40700,40950,0.006,-250,40825,"TuT",0,-100,FALSE,FALSE,FALSE,0.61,"young",20,182,78,"m"
14,"ADDUCTOR",2,"TuT",38780,38800,38850,38900,38790,38875,0.002,-85,38832.5,"TuT",-20,-50,FALSE,FALSE,FALSE,0.22,"young",20,182,78,"m"
14,"LOWER BACK",1,"Con01",1460,1460,1600,1600,1460,1600,0.096,-140,1530,"Con",0,0,FALSE,FALSE,FALSE,8.75,"young",20,182,78,"m"
14,"LOWER BACK",1,"Con02",1500,1500,1650,1600,1500,1625,0.083,-125,1562.5,"Con",0,50,FALSE,FALSE,FALSE,7.69,"young",20,182,78,"m"
14,"LOWER BACK",1,"Con03",1580,1580,1700,1800,1580,1750,0.108,-170,1665,"Con",0,-100,FALSE,FALSE,FALSE,9.71,"young",20,182,78,"m"
14,"LOWER BACK",1,"Con04",1540,1560,1700,1700,1550,1700,0.097,-150,1625,"Con",-20,0,FALSE,FALSE,FALSE,8.82,"young",20,182,78,"m"
14,"LOWER BACK",1,"Con05",1620,1660,1800,1800,1640,1800,0.098,-160,1720,"Con",-40,0,FALSE,TRUE,FALSE,8.89,"young",20,182,78,"m"
14,"LOWER BACK",1,"Con06",1560,1600,1750,1700,1580,1725,0.092,-145,1652.5,"Con",-40,50,FALSE,TRUE,FALSE,8.41,"young",20,182,78,"m"
14,"LOWER BACK",1,"Con07",1680,1680,1800,1800,1680,1800,0.071,-120,1740,"Con",0,0,FALSE,FALSE,FALSE,6.67,"young",20,182,78,"m"
14,"LOWER BACK",1,"Con08",1660,1660,1800,1800,1660,1800,0.084,-140,1730,"Con",0,0,FALSE,FALSE,FALSE,7.78,"young",20,182,78,"m"
14,"LOWER BACK",1,"Con09",1780,1800,1950,2050,1790,2000,0.117,-210,1895,"Con",-20,-100,TRUE,FALSE,FALSE,10.5,"young",20,182,78,"m"
14,"LOWER BACK",1,"Con10",1680,1720,1900,2000,1700,1950,0.147,-250,1825,"Con",-40,-100,TRUE,TRUE,FALSE,12.82,"young",20,182,78,"m"
14,"LOWER BACK",2,"Con01",1720,1720,1850,1850,1720,1850,0.076,-130,1785,"Con",0,0,FALSE,FALSE,FALSE,7.03,"young",20,182,78,"m"
14,"LOWER BACK",2,"Con02",1400,1420,1550,1500,1410,1525,0.082,-115,1467.5,"Con",-20,50,FALSE,FALSE,FALSE,7.54,"young",20,182,78,"m"
14,"LOWER BACK",2,"Con03",1340,1340,1450,1500,1340,1475,0.101,-135,1407.5,"Con",0,-50,FALSE,FALSE,FALSE,9.15,"young",20,182,78,"m"
14,"LOWER BACK",2,"Con04",1420,1440,1600,1550,1430,1575,0.101,-145,1502.5,"Con",-20,50,FALSE,FALSE,FALSE,9.21,"young",20,182,78,"m"
14,"LOWER BACK",2,"Con05",1580,1580,1750,1750,1580,1750,0.108,-170,1665,"Con",0,0,FALSE,FALSE,FALSE,9.71,"young",20,182,78,"m"
14,"LOWER BACK",2,"Con06",1580,1560,1750,1750,1570,1750,0.115,-180,1660,"Con",20,0,FALSE,FALSE,FALSE,10.29,"young",20,182,78,"m"
14,"LOWER BACK",2,"Con07",1540,1520,1700,1750,1530,1725,0.127,-195,1627.5,"Con",20,-50,TRUE,FALSE,FALSE,11.3,"young",20,182,78,"m"
14,"LOWER BACK",2,"Con08",1640,1640,1850,1900,1640,1875,0.143,-235,1757.5,"Con",0,-50,TRUE,FALSE,FALSE,12.53,"young",20,182,78,"m"
14,"LOWER BACK",2,"Con09",1660,1640,1950,2000,1650,1975,0.197,-325,1812.5,"Con",20,-50,TRUE,FALSE,FALSE,16.46,"young",20,182,78,"m"
14,"LOWER BACK",2,"Con10",1520,1500,2000,2050,1510,2025,0.341,-515,1767.5,"Con",20,-50,TRUE,FALSE,FALSE,25.43,"young",20,182,78,"m"
14,"LOWER BACK",1,"Ecc01",4040,4040,3950,3950,4040,3950,0.022,90,3995,"Ecc",0,0,FALSE,FALSE,FALSE,2.28,"young",20,182,78,"m"
14,"LOWER BACK",1,"Ecc02",4280,4280,4150,4150,4280,4150,0.03,130,4215,"Ecc",0,0,FALSE,FALSE,FALSE,3.13,"young",20,182,78,"m"
14,"LOWER BACK",1,"Ecc03",4100,4100,3950,3900,4100,3925,0.043,175,4012.5,"Ecc",0,50,TRUE,FALSE,FALSE,4.46,"young",20,182,78,"m"
14,"LOWER BACK",1,"Ecc04",4220,4180,4050,4050,4200,4050,0.036,150,4125,"Ecc",40,0,FALSE,FALSE,FALSE,3.7,"young",20,182,78,"m"
14,"LOWER BACK",1,"Ecc05",3840,3800,3650,3650,3820,3650,0.045,170,3735,"Ecc",40,0,FALSE,FALSE,FALSE,4.66,"young",20,182,78,"m"
14,"LOWER BACK",1,"Ecc06",3900,3880,3750,3800,3890,3775,0.03,115,3832.5,"Ecc",20,-50,FALSE,FALSE,FALSE,3.05,"young",20,182,78,"m"
14,"LOWER BACK",1,"Ecc07",3520,3520,3400,3400,3520,3400,0.034,120,3460,"Ecc",0,0,FALSE,FALSE,FALSE,3.53,"young",20,182,78,"m"
14,"LOWER BACK",1,"Ecc08",3560,3540,3400,3350,3550,3375,0.049,175,3462.5,"Ecc",20,50,TRUE,FALSE,FALSE,5.19,"young",20,182,78,"m"
14,"LOWER BACK",1,"Ecc09",3520,3520,3350,3250,3520,3300,0.062,220,3410,"Ecc",0,100,TRUE,FALSE,FALSE,6.67,"young",20,182,78,"m"
14,"LOWER BACK",1,"Ecc10",4140,4140,4000,3650,4140,3825,0.076,315,3982.5,"Ecc",0,350,TRUE,FALSE,TRUE,8.24,"young",20,182,78,"m"
14,"LOWER BACK",2,"Ecc01",4060,4020,3900,3950,4040,3925,0.028,115,3982.5,"Ecc",40,-50,FALSE,FALSE,FALSE,2.93,"young",20,182,78,"m"
14,"LOWER BACK",2,"Ecc02",4120,4100,4000,4000,4110,4000,0.027,110,4055,"Ecc",20,0,FALSE,FALSE,FALSE,2.75,"young",20,182,78,"m"
14,"LOWER BACK",2,"Ecc03",3760,3760,3600,3600,3760,3600,0.043,160,3680,"Ecc",0,0,FALSE,FALSE,FALSE,4.44,"young",20,182,78,"m"
14,"LOWER BACK",2,"Ecc04",4120,4120,3950,4000,4120,3975,0.035,145,4047.5,"Ecc",0,-50,FALSE,FALSE,FALSE,3.65,"young",20,182,78,"m"
14,"LOWER BACK",2,"Ecc05",4080,4100,3900,3900,4090,3900,0.046,190,3995,"Ecc",-20,0,TRUE,FALSE,FALSE,4.87,"young",20,182,78,"m"
14,"LOWER BACK",2,"Ecc06",4360,4360,4200,4200,4360,4200,0.037,160,4280,"Ecc",0,0,FALSE,FALSE,FALSE,3.81,"young",20,182,78,"m"
14,"LOWER BACK",2,"Ecc07",3940,3960,3750,3700,3950,3725,0.057,225,3837.5,"Ecc",-20,50,TRUE,FALSE,FALSE,6.04,"young",20,182,78,"m"
14,"LOWER BACK",2,"Ecc08",3880,3880,3650,3600,3880,3625,0.066,255,3752.5,"Ecc",0,50,TRUE,FALSE,FALSE,7.03,"young",20,182,78,"m"
14,"LOWER BACK",2,"Ecc09",3500,3540,3250,3200,3520,3225,0.084,295,3372.5,"Ecc",-40,50,TRUE,FALSE,FALSE,9.15,"young",20,182,78,"m"
14,"LOWER BACK",2,"Ecc10",3320,3300,3050,2950,3310,3000,0.094,310,3155,"Ecc",20,100,TRUE,FALSE,FALSE,10.33,"young",20,182,78,"m"
14,"LOWER BACK",1,"Rep01",5500,5500,5550,5550,5500,5550,0.009,-50,5525,"Rep",0,0,FALSE,FALSE,FALSE,0.9,"young",20,182,78,"m"
14,"LOWER BACK",1,"Rep02",5780,5780,5800,5750,5780,5775,0.001,5,5777.5,"Rep",0,50,FALSE,FALSE,FALSE,0.09,"young",20,182,78,"m"
14,"LOWER BACK",1,"Rep03",5680,5680,5650,5700,5680,5675,0.001,5,5677.5,"Rep",0,-50,FALSE,FALSE,FALSE,0.09,"young",20,182,78,"m"
14,"LOWER BACK",1,"Rep04",5760,5740,5750,5750,5750,5750,0,0,5750,"Rep",20,0,FALSE,FALSE,FALSE,0,"young",20,182,78,"m"
14,"LOWER BACK",1,"Rep05",5460,5460,5450,5450,5460,5450,0.002,10,5455,"Rep",0,0,FALSE,FALSE,FALSE,0.18,"young",20,182,78,"m"
14,"LOWER BACK",1,"Rep06",5460,5480,5500,5500,5470,5500,0.005,-30,5485,"Rep",-20,0,FALSE,FALSE,FALSE,0.55,"young",20,182,78,"m"
14,"LOWER BACK",1,"Rep07",5200,5200,5200,5200,5200,5200,0,0,5200,"Rep",0,0,FALSE,FALSE,FALSE,0,"young",20,182,78,"m"
14,"LOWER BACK",1,"Rep08",5220,5200,5200,5150,5210,5175,0.007,35,5192.5,"Rep",20,50,FALSE,FALSE,FALSE,0.68,"young",20,182,78,"m"
14,"LOWER BACK",1,"Rep09",5300,5320,5300,5300,5310,5300,0.002,10,5305,"Rep",-20,0,FALSE,FALSE,FALSE,0.19,"young",20,182,78,"m"
14,"LOWER BACK",1,"Rep10",5820,5860,5900,5650,5840,5775,0.011,65,5807.5,"Rep",-40,250,FALSE,FALSE,TRUE,1.13,"young",20,182,78,"m"
14,"LOWER BACK",2,"Rep01",5780,5740,5750,5800,5760,5775,0.003,-15,5767.5,"Rep",40,-50,FALSE,FALSE,FALSE,0.26,"young",20,182,78,"m"
14,"LOWER BACK",2,"Rep02",5520,5520,5550,5500,5520,5525,0.001,-5,5522.5,"Rep",0,50,FALSE,FALSE,FALSE,0.09,"young",20,182,78,"m"
14,"LOWER BACK",2,"Rep03",5100,5100,5050,5100,5100,5075,0.005,25,5087.5,"Rep",0,-50,FALSE,FALSE,FALSE,0.49,"young",20,182,78,"m"
14,"LOWER BACK",2,"Rep04",5540,5560,5550,5550,5550,5550,0,0,5550,"Rep",-20,0,FALSE,FALSE,FALSE,0,"young",20,182,78,"m"
14,"LOWER BACK",2,"Rep05",5660,5680,5650,5650,5670,5650,0.004,20,5660,"Rep",-20,0,FALSE,FALSE,FALSE,0.35,"young",20,182,78,"m"
14,"LOWER BACK",2,"Rep06",5940,5920,5950,5950,5930,5950,0.003,-20,5940,"Rep",20,0,FALSE,FALSE,FALSE,0.34,"young",20,182,78,"m"
14,"LOWER BACK",2,"Rep07",5480,5480,5450,5450,5480,5450,0.005,30,5465,"Rep",0,0,FALSE,FALSE,FALSE,0.55,"young",20,182,78,"m"
14,"LOWER BACK",2,"Rep08",5520,5520,5500,5500,5520,5500,0.004,20,5510,"Rep",0,0,FALSE,FALSE,FALSE,0.36,"young",20,182,78,"m"
14,"LOWER BACK",2,"Rep09",5160,5180,5200,5200,5170,5200,0.006,-30,5185,"Rep",-20,0,FALSE,FALSE,FALSE,0.58,"young",20,182,78,"m"
14,"LOWER BACK",2,"Rep10",4840,4800,5050,5000,4820,5025,0.043,-205,4922.5,"Rep",40,50,TRUE,FALSE,FALSE,4.08,"young",20,182,78,"m"
14,"LOWER BACK",1,"TuT",55180,55220,55300,55000,55200,55150,0.001,50,55175,"TuT",-40,300,FALSE,FALSE,TRUE,0.09,"young",20,182,78,"m"
14,"LOWER BACK",2,"TuT",54540,54500,54700,54700,54520,54700,0.003,-180,54610,"TuT",40,0,FALSE,FALSE,FALSE,0.33,"young",20,182,78,"m"
14,"TOTAL ABDOMINAL",1,"Con01",1620,1640,2100,1800,1630,1950,0.196,-320,1790,"Con",-20,300,TRUE,FALSE,TRUE,16.41,"young",20,182,78,"m"
14,"TOTAL ABDOMINAL",1,"Con02",1420,1440,1450,1450,1430,1450,0.014,-20,1440,"Con",-20,0,FALSE,FALSE,FALSE,1.38,"young",20,182,78,"m"
14,"TOTAL ABDOMINAL",1,"Con03",1360,1400,1500,1400,1380,1450,0.051,-70,1415,"Con",-40,100,FALSE,TRUE,FALSE,4.83,"young",20,182,78,"m"
14,"TOTAL ABDOMINAL",1,"Con04",1440,1480,1450,1500,1460,1475,0.01,-15,1467.5,"Con",-40,-50,FALSE,TRUE,FALSE,1.02,"young",20,182,78,"m"
14,"TOTAL ABDOMINAL",1,"Con05",1340,1380,1350,1450,1360,1400,0.029,-40,1380,"Con",-40,-100,FALSE,TRUE,FALSE,2.86,"young",20,182,78,"m"
14,"TOTAL ABDOMINAL",1,"Con06",1320,1340,1400,1450,1330,1425,0.071,-95,1377.5,"Con",-20,-50,FALSE,FALSE,FALSE,6.67,"young",20,182,78,"m"
14,"TOTAL ABDOMINAL",1,"Con07",1280,1280,1450,1400,1280,1425,0.113,-145,1352.5,"Con",0,50,TRUE,FALSE,FALSE,10.18,"young",20,182,78,"m"
14,"TOTAL ABDOMINAL",1,"Con08",1360,1360,1700,1500,1360,1600,0.176,-240,1480,"Con",0,200,TRUE,FALSE,TRUE,15,"young",20,182,78,"m"
14,"TOTAL ABDOMINAL",1,"Con09",1220,1260,1950,1550,1240,1750,0.411,-510,1495,"Con",-40,400,TRUE,TRUE,TRUE,29.14,"young",20,182,78,"m"
14,"TOTAL ABDOMINAL",1,"Con10",1400,1400,2050,2050,1400,2050,0.464,-650,1725,"Con",0,0,TRUE,FALSE,FALSE,31.71,"young",20,182,78,"m"
14,"TOTAL ABDOMINAL",2,"Con01",1380,1400,1500,1550,1390,1525,0.097,-135,1457.5,"Con",-20,-50,FALSE,FALSE,FALSE,8.85,"young",20,182,78,"m"
14,"TOTAL ABDOMINAL",2,"Con02",1360,1360,1400,1400,1360,1400,0.029,-40,1380,"Con",0,0,FALSE,FALSE,FALSE,2.86,"young",20,182,78,"m"
14,"TOTAL ABDOMINAL",2,"Con03",1300,1300,1550,1350,1300,1450,0.115,-150,1375,"Con",0,200,TRUE,FALSE,TRUE,10.34,"young",20,182,78,"m"
14,"TOTAL ABDOMINAL",2,"Con04",1360,1360,1500,1350,1360,1425,0.048,-65,1392.5,"Con",0,150,FALSE,FALSE,FALSE,4.56,"young",20,182,78,"m"
14,"TOTAL ABDOMINAL",2,"Con05",1160,1160,1300,1150,1160,1225,0.056,-65,1192.5,"Con",0,150,FALSE,FALSE,FALSE,5.31,"young",20,182,78,"m"
14,"TOTAL ABDOMINAL",2,"Con06",1280,1280,1350,1450,1280,1400,0.094,-120,1340,"Con",0,-100,FALSE,FALSE,FALSE,8.57,"young",20,182,78,"m"
14,"TOTAL ABDOMINAL",2,"Con07",1160,1160,1200,1400,1160,1300,0.121,-140,1230,"Con",0,-200,FALSE,FALSE,TRUE,10.77,"young",20,182,78,"m"
14,"TOTAL ABDOMINAL",2,"Con08",1280,1320,1450,1500,1300,1475,0.135,-175,1387.5,"Con",-40,-50,TRUE,TRUE,FALSE,11.86,"young",20,182,78,"m"
14,"TOTAL ABDOMINAL",2,"Con09",1340,1360,1550,1600,1350,1575,0.167,-225,1462.5,"Con",-20,-50,TRUE,FALSE,FALSE,14.29,"young",20,182,78,"m"
14,"TOTAL ABDOMINAL",2,"Con10",1440,1440,1750,1600,1440,1675,0.163,-235,1557.5,"Con",0,150,TRUE,FALSE,FALSE,14.03,"young",20,182,78,"m"
14,"TOTAL ABDOMINAL",1,"Ecc01",3200,3180,3250,3100,3190,3175,0.005,15,3182.5,"Ecc",20,150,FALSE,FALSE,FALSE,0.47,"young",20,182,78,"m"
14,"TOTAL ABDOMINAL",1,"Ecc02",3420,3400,3250,3400,3410,3325,0.025,85,3367.5,"Ecc",20,-150,FALSE,FALSE,FALSE,2.56,"young",20,182,78,"m"
14,"TOTAL ABDOMINAL",1,"Ecc03",3040,3000,3050,3000,3020,3025,0.002,-5,3022.5,"Ecc",40,50,FALSE,TRUE,FALSE,0.17,"young",20,182,78,"m"
14,"TOTAL ABDOMINAL",1,"Ecc04",2940,2900,2850,2850,2920,2850,0.024,70,2885,"Ecc",40,0,FALSE,TRUE,FALSE,2.46,"young",20,182,78,"m"
14,"TOTAL ABDOMINAL",1,"Ecc05",2840,2800,2850,2750,2820,2800,0.007,20,2810,"Ecc",40,100,FALSE,TRUE,FALSE,0.71,"young",20,182,78,"m"
14,"TOTAL ABDOMINAL",1,"Ecc06",2700,2700,2600,2550,2700,2575,0.046,125,2637.5,"Ecc",0,50,FALSE,FALSE,FALSE,4.85,"young",20,182,78,"m"
14,"TOTAL ABDOMINAL",1,"Ecc07",2660,2660,2350,2550,2660,2450,0.079,210,2555,"Ecc",0,-200,TRUE,FALSE,TRUE,8.57,"young",20,182,78,"m"
14,"TOTAL ABDOMINAL",1,"Ecc08",2840,2820,2100,2600,2830,2350,0.17,480,2590,"Ecc",20,-500,TRUE,FALSE,TRUE,20.43,"young",20,182,78,"m"
14,"TOTAL ABDOMINAL",1,"Ecc09",2860,2820,2150,2150,2840,2150,0.243,690,2495,"Ecc",40,0,TRUE,TRUE,FALSE,32.09,"young",20,182,78,"m"
14,"TOTAL ABDOMINAL",1,"Ecc10",2940,2940,2900,2900,2940,2900,0.014,40,2920,"Ecc",0,0,FALSE,FALSE,FALSE,1.38,"young",20,182,78,"m"
14,"TOTAL ABDOMINAL",2,"Ecc01",2900,2880,2900,2850,2890,2875,0.005,15,2882.5,"Ecc",20,50,FALSE,FALSE,FALSE,0.52,"young",20,182,78,"m"
14,"TOTAL ABDOMINAL",2,"Ecc02",3040,3060,2750,3000,3050,2875,0.057,175,2962.5,"Ecc",-20,-250,TRUE,FALSE,TRUE,6.09,"young",20,182,78,"m"
14,"TOTAL ABDOMINAL",2,"Ecc03",2700,2700,2600,2700,2700,2650,0.019,50,2675,"Ecc",0,-100,FALSE,FALSE,FALSE,1.89,"young",20,182,78,"m"
14,"TOTAL ABDOMINAL",2,"Ecc04",2640,2640,2500,2650,2640,2575,0.025,65,2607.5,"Ecc",0,-150,FALSE,FALSE,FALSE,2.52,"young",20,182,78,"m"
14,"TOTAL ABDOMINAL",2,"Ecc05",2760,2780,2650,2700,2770,2675,0.034,95,2722.5,"Ecc",-20,-50,FALSE,FALSE,FALSE,3.55,"young",20,182,78,"m"
14,"TOTAL ABDOMINAL",2,"Ecc06",2720,2680,2700,2450,2700,2575,0.046,125,2637.5,"Ecc",40,250,FALSE,TRUE,TRUE,4.85,"young",20,182,78,"m"
14,"TOTAL ABDOMINAL",2,"Ecc07",2380,2380,2250,2150,2380,2200,0.076,180,2290,"Ecc",0,100,TRUE,FALSE,FALSE,8.18,"young",20,182,78,"m"
14,"TOTAL ABDOMINAL",2,"Ecc08",2240,2220,2050,2000,2230,2025,0.092,205,2127.5,"Ecc",20,50,TRUE,FALSE,FALSE,10.12,"young",20,182,78,"m"
14,"TOTAL ABDOMINAL",2,"Ecc09",2460,2440,2150,2250,2450,2200,0.102,250,2325,"Ecc",20,-100,TRUE,FALSE,FALSE,11.36,"young",20,182,78,"m"
14,"TOTAL ABDOMINAL",2,"Ecc10",3080,3060,3600,3100,3070,3350,0.091,-280,3210,"Ecc",20,500,TRUE,FALSE,TRUE,8.36,"young",20,182,78,"m"
14,"TOTAL ABDOMINAL",1,"Rep01",4820,4820,5350,4900,4820,5125,0.063,-305,4972.5,"Rep",0,450,TRUE,FALSE,TRUE,5.95,"young",20,182,78,"m"
14,"TOTAL ABDOMINAL",1,"Rep02",4840,4840,4700,4850,4840,4775,0.013,65,4807.5,"Rep",0,-150,FALSE,FALSE,FALSE,1.36,"young",20,182,78,"m"
14,"TOTAL ABDOMINAL",1,"Rep03",4400,4400,4550,4400,4400,4475,0.017,-75,4437.5,"Rep",0,150,FALSE,FALSE,FALSE,1.68,"young",20,182,78,"m"
14,"TOTAL ABDOMINAL",1,"Rep04",4380,4380,4300,4350,4380,4325,0.013,55,4352.5,"Rep",0,-50,FALSE,FALSE,FALSE,1.27,"young",20,182,78,"m"
14,"TOTAL ABDOMINAL",1,"Rep05",4180,4180,4200,4200,4180,4200,0.005,-20,4190,"Rep",0,0,FALSE,FALSE,FALSE,0.48,"young",20,182,78,"m"
14,"TOTAL ABDOMINAL",1,"Rep06",4020,4040,4000,4000,4030,4000,0.007,30,4015,"Rep",-20,0,FALSE,FALSE,FALSE,0.75,"young",20,182,78,"m"
14,"TOTAL ABDOMINAL",1,"Rep07",3940,3940,3800,3950,3940,3875,0.016,65,3907.5,"Rep",0,-150,FALSE,FALSE,FALSE,1.68,"young",20,182,78,"m"
14,"TOTAL ABDOMINAL",1,"Rep08",4200,4180,3800,4100,4190,3950,0.057,240,4070,"Rep",20,-300,TRUE,FALSE,TRUE,6.08,"young",20,182,78,"m"
14,"TOTAL ABDOMINAL",1,"Rep09",4080,4080,4100,3700,4080,3900,0.044,180,3990,"Rep",0,400,TRUE,FALSE,TRUE,4.62,"young",20,182,78,"m"
14,"TOTAL ABDOMINAL",1,"Rep10",4340,4340,4950,4950,4340,4950,0.141,-610,4645,"Rep",0,0,TRUE,FALSE,FALSE,12.32,"young",20,182,78,"m"
14,"TOTAL ABDOMINAL",2,"Rep01",4280,4280,4400,4400,4280,4400,0.028,-120,4340,"Rep",0,0,FALSE,FALSE,FALSE,2.73,"young",20,182,78,"m"
14,"TOTAL ABDOMINAL",2,"Rep02",4400,4420,4150,4400,4410,4275,0.031,135,4342.5,"Rep",-20,-250,TRUE,FALSE,TRUE,3.16,"young",20,182,78,"m"
14,"TOTAL ABDOMINAL",2,"Rep03",4000,4000,4150,4050,4000,4100,0.025,-100,4050,"Rep",0,100,FALSE,FALSE,FALSE,2.44,"young",20,182,78,"m"
14,"TOTAL ABDOMINAL",2,"Rep04",4000,4000,4000,4000,4000,4000,0,0,4000,"Rep",0,0,FALSE,FALSE,FALSE,0,"young",20,182,78,"m"
14,"TOTAL ABDOMINAL",2,"Rep05",3920,3940,3950,3850,3930,3900,0.008,30,3915,"Rep",-20,100,FALSE,FALSE,FALSE,0.77,"young",20,182,78,"m"
14,"TOTAL ABDOMINAL",2,"Rep06",4000,3960,4050,3900,3980,3975,0.001,5,3977.5,"Rep",40,150,FALSE,FALSE,FALSE,0.13,"young",20,182,78,"m"
14,"TOTAL ABDOMINAL",2,"Rep07",3540,3540,3450,3550,3540,3500,0.011,40,3520,"Rep",0,-100,FALSE,FALSE,FALSE,1.14,"young",20,182,78,"m"
14,"TOTAL ABDOMINAL",2,"Rep08",3520,3540,3500,3500,3530,3500,0.008,30,3515,"Rep",-20,0,FALSE,FALSE,FALSE,0.86,"young",20,182,78,"m"
14,"TOTAL ABDOMINAL",2,"Rep09",3800,3800,3700,3850,3800,3775,0.007,25,3787.5,"Rep",0,-150,FALSE,FALSE,FALSE,0.66,"young",20,182,78,"m"
14,"TOTAL ABDOMINAL",2,"Rep10",4520,4500,5350,4700,4510,5025,0.114,-515,4767.5,"Rep",20,650,TRUE,FALSE,TRUE,10.25,"young",20,182,78,"m"
14,"TOTAL ABDOMINAL",1,"TuT",43200,43200,43750,43400,43200,43575,0.009,-375,43387.5,"TuT",0,350,TRUE,FALSE,TRUE,0.86,"young",20,182,78,"m"
14,"TOTAL ABDOMINAL",2,"TuT",39980,39980,40700,40200,39980,40450,0.012,-470,40215,"TuT",0,500,TRUE,FALSE,TRUE,1.16,"young",20,182,78,"m"
14,"VERTICAL TRACTION",1,"Con01",2080,2060,3600,2200,2070,2900,0.401,-830,2485,"Con",20,1400,TRUE,FALSE,TRUE,28.62,"young",20,182,78,"m"
14,"VERTICAL TRACTION",1,"Con02",1460,1480,1800,1650,1470,1725,0.173,-255,1597.5,"Con",-20,150,FALSE,FALSE,FALSE,14.78,"young",20,182,78,"m"
14,"VERTICAL TRACTION",1,"Con03",1320,1360,1600,1500,1340,1550,0.157,-210,1445,"Con",-40,100,FALSE,FALSE,FALSE,13.55,"young",20,182,78,"m"
14,"VERTICAL TRACTION",1,"Con04",1200,1200,1350,1600,1200,1475,0.229,-275,1337.5,"Con",0,-250,FALSE,FALSE,TRUE,18.64,"young",20,182,78,"m"
14,"VERTICAL TRACTION",1,"Con05",1340,1380,1450,1650,1360,1550,0.14,-190,1455,"Con",-40,-200,FALSE,FALSE,TRUE,12.26,"young",20,182,78,"m"
14,"VERTICAL TRACTION",1,"Con06",1360,1360,1650,1950,1360,1800,0.324,-440,1580,"Con",0,-300,TRUE,FALSE,TRUE,24.44,"young",20,182,78,"m"
14,"VERTICAL TRACTION",1,"Con07",1380,1400,1700,1600,1390,1650,0.187,-260,1520,"Con",-20,100,FALSE,FALSE,FALSE,15.76,"young",20,182,78,"m"
14,"VERTICAL TRACTION",1,"Con08",1420,1420,1600,1600,1420,1600,0.127,-180,1510,"Con",0,0,FALSE,FALSE,FALSE,11.25,"young",20,182,78,"m"
14,"VERTICAL TRACTION",1,"Con09",1300,1340,2050,1550,1320,1800,0.364,-480,1560,"Con",-40,500,TRUE,FALSE,TRUE,26.67,"young",20,182,78,"m"
14,"VERTICAL TRACTION",1,"Con10",1460,1460,2150,1650,1460,1900,0.301,-440,1680,"Con",0,500,TRUE,FALSE,TRUE,23.16,"young",20,182,78,"m"
14,"VERTICAL TRACTION",2,"Con01",1740,1740,1900,1850,1740,1875,0.078,-135,1807.5,"Con",0,50,FALSE,FALSE,FALSE,7.2,"young",20,182,78,"m"
14,"VERTICAL TRACTION",2,"Con02",1300,1340,1600,1550,1320,1575,0.193,-255,1447.5,"Con",-40,50,FALSE,FALSE,FALSE,16.19,"young",20,182,78,"m"
14,"VERTICAL TRACTION",2,"Con03",1160,1180,1750,1800,1170,1775,0.517,-605,1472.5,"Con",-20,-50,TRUE,FALSE,FALSE,34.08,"young",20,182,78,"m"
14,"VERTICAL TRACTION",2,"Con04",1280,1320,1550,1550,1300,1550,0.192,-250,1425,"Con",-40,0,FALSE,FALSE,FALSE,16.13,"young",20,182,78,"m"
14,"VERTICAL TRACTION",2,"Con05",1280,1280,1550,1650,1280,1600,0.25,-320,1440,"Con",0,-100,TRUE,FALSE,FALSE,20,"young",20,182,78,"m"
14,"VERTICAL TRACTION",2,"Con06",1260,1220,1600,2100,1240,1850,0.492,-610,1545,"Con",40,-500,TRUE,FALSE,TRUE,32.97,"young",20,182,78,"m"
14,"VERTICAL TRACTION",2,"Con07",1160,1160,1500,1450,1160,1475,0.272,-315,1317.5,"Con",0,50,TRUE,FALSE,FALSE,21.36,"young",20,182,78,"m"
14,"VERTICAL TRACTION",2,"Con08",1180,1180,1450,1350,1180,1400,0.186,-220,1290,"Con",0,100,FALSE,FALSE,FALSE,15.71,"young",20,182,78,"m"
14,"VERTICAL TRACTION",2,"Con09",1380,1400,1500,1500,1390,1500,0.079,-110,1445,"Con",-20,0,FALSE,FALSE,FALSE,7.33,"young",20,182,78,"m"
14,"VERTICAL TRACTION",2,"Con10",1360,1380,1450,1450,1370,1450,0.058,-80,1410,"Con",-20,0,FALSE,FALSE,FALSE,5.52,"young",20,182,78,"m"
14,"VERTICAL TRACTION",1,"Ecc01",3680,3660,3250,3500,3670,3375,0.08,295,3522.5,"Ecc",20,-250,TRUE,FALSE,TRUE,8.74,"young",20,182,78,"m"
14,"VERTICAL TRACTION",1,"Ecc02",3520,3480,3250,3350,3500,3300,0.057,200,3400,"Ecc",40,-100,FALSE,FALSE,FALSE,6.06,"young",20,182,78,"m"
14,"VERTICAL TRACTION",1,"Ecc03",3880,3840,3600,3600,3860,3600,0.067,260,3730,"Ecc",40,0,FALSE,FALSE,FALSE,7.22,"young",20,182,78,"m"
14,"VERTICAL TRACTION",1,"Ecc04",3700,3700,3600,3350,3700,3475,0.061,225,3587.5,"Ecc",0,250,FALSE,FALSE,TRUE,6.47,"young",20,182,78,"m"
14,"VERTICAL TRACTION",1,"Ecc05",3760,3740,3600,3400,3750,3500,0.067,250,3625,"Ecc",20,200,FALSE,FALSE,TRUE,7.14,"young",20,182,78,"m"
14,"VERTICAL TRACTION",1,"Ecc06",3460,3440,3200,2950,3450,3075,0.109,375,3262.5,"Ecc",20,250,TRUE,FALSE,TRUE,12.2,"young",20,182,78,"m"
14,"VERTICAL TRACTION",1,"Ecc07",3380,3380,3100,3200,3380,3150,0.068,230,3265,"Ecc",0,-100,FALSE,FALSE,FALSE,7.3,"young",20,182,78,"m"
14,"VERTICAL TRACTION",1,"Ecc08",3420,3400,3100,3200,3410,3150,0.076,260,3280,"Ecc",20,-100,FALSE,FALSE,FALSE,8.25,"young",20,182,78,"m"
14,"VERTICAL TRACTION",1,"Ecc09",3320,3300,2550,3100,3310,2825,0.147,485,3067.5,"Ecc",20,-550,TRUE,FALSE,TRUE,17.17,"young",20,182,78,"m"
14,"VERTICAL TRACTION",1,"Ecc10",2700,2720,2200,2600,2710,2400,0.114,310,2555,"Ecc",-20,-400,TRUE,FALSE,TRUE,12.92,"young",20,182,78,"m"
14,"VERTICAL TRACTION",2,"Ecc01",3900,3880,3700,3750,3890,3725,0.042,165,3807.5,"Ecc",20,-50,FALSE,FALSE,FALSE,4.43,"young",20,182,78,"m"
14,"VERTICAL TRACTION",2,"Ecc02",3620,3580,3300,3300,3600,3300,0.083,300,3450,"Ecc",40,0,TRUE,FALSE,FALSE,9.09,"young",20,182,78,"m"
14,"VERTICAL TRACTION",2,"Ecc03",3640,3600,3100,3000,3620,3050,0.157,570,3335,"Ecc",40,100,TRUE,FALSE,FALSE,18.69,"young",20,182,78,"m"
14,"VERTICAL TRACTION",2,"Ecc04",3140,3140,2850,2900,3140,2875,0.084,265,3007.5,"Ecc",0,-50,TRUE,FALSE,FALSE,9.22,"young",20,182,78,"m"
14,"VERTICAL TRACTION",2,"Ecc05",3440,3460,3150,2950,3450,3050,0.116,400,3250,"Ecc",-20,200,TRUE,FALSE,TRUE,13.11,"young",20,182,78,"m"
14,"VERTICAL TRACTION",2,"Ecc06",3660,3680,3300,2900,3670,3100,0.155,570,3385,"Ecc",-20,400,TRUE,FALSE,TRUE,18.39,"young",20,182,78,"m"
14,"VERTICAL TRACTION",2,"Ecc07",3440,3420,3100,3250,3430,3175,0.074,255,3302.5,"Ecc",20,-150,FALSE,FALSE,FALSE,8.03,"young",20,182,78,"m"
14,"VERTICAL TRACTION",2,"Ecc08",3280,3280,3100,3150,3280,3125,0.047,155,3202.5,"Ecc",0,-50,FALSE,FALSE,FALSE,4.96,"young",20,182,78,"m"
14,"VERTICAL TRACTION",2,"Ecc09",3440,3440,3350,3350,3440,3350,0.026,90,3395,"Ecc",0,0,FALSE,FALSE,FALSE,2.69,"young",20,182,78,"m"
14,"VERTICAL TRACTION",2,"Ecc10",3220,3240,3300,3150,3230,3225,0.002,5,3227.5,"Ecc",-20,150,FALSE,FALSE,FALSE,0.16,"young",20,182,78,"m"
14,"VERTICAL TRACTION",1,"Rep01",5760,5720,6850,5700,5740,6275,0.093,-535,6007.5,"Rep",40,1150,TRUE,FALSE,TRUE,8.53,"young",20,182,78,"m"
14,"VERTICAL TRACTION",1,"Rep02",4980,4960,5050,5000,4970,5025,0.011,-55,4997.5,"Rep",20,50,FALSE,FALSE,FALSE,1.09,"young",20,182,78,"m"
14,"VERTICAL TRACTION",1,"Rep03",5200,5200,5200,5100,5200,5150,0.01,50,5175,"Rep",0,100,FALSE,FALSE,FALSE,0.97,"young",20,182,78,"m"
14,"VERTICAL TRACTION",1,"Rep04",4900,4900,4950,4950,4900,4950,0.01,-50,4925,"Rep",0,0,FALSE,FALSE,FALSE,1.01,"young",20,182,78,"m"
14,"VERTICAL TRACTION",1,"Rep05",5100,5120,5050,5050,5110,5050,0.012,60,5080,"Rep",-20,0,FALSE,FALSE,FALSE,1.19,"young",20,182,78,"m"
14,"VERTICAL TRACTION",1,"Rep06",4820,4800,4850,4900,4810,4875,0.014,-65,4842.5,"Rep",20,-50,FALSE,FALSE,FALSE,1.33,"young",20,182,78,"m"
14,"VERTICAL TRACTION",1,"Rep07",4760,4780,4800,4800,4770,4800,0.006,-30,4785,"Rep",-20,0,FALSE,FALSE,FALSE,0.62,"young",20,182,78,"m"
14,"VERTICAL TRACTION",1,"Rep08",4840,4820,4700,4800,4830,4750,0.017,80,4790,"Rep",20,-100,FALSE,FALSE,FALSE,1.68,"young",20,182,78,"m"
14,"VERTICAL TRACTION",1,"Rep09",4620,4640,4600,4650,4630,4625,0.001,5,4627.5,"Rep",-20,-50,FALSE,FALSE,FALSE,0.11,"young",20,182,78,"m"
14,"VERTICAL TRACTION",1,"Rep10",4160,4180,4350,4250,4170,4300,0.031,-130,4235,"Rep",-20,100,FALSE,FALSE,FALSE,3.02,"young",20,182,78,"m"
14,"VERTICAL TRACTION",2,"Rep01",5640,5620,5600,5600,5630,5600,0.005,30,5615,"Rep",20,0,FALSE,FALSE,FALSE,0.54,"young",20,182,78,"m"
14,"VERTICAL TRACTION",2,"Rep02",4920,4920,4900,4850,4920,4875,0.009,45,4897.5,"Rep",0,50,FALSE,FALSE,FALSE,0.92,"young",20,182,78,"m"
14,"VERTICAL TRACTION",2,"Rep03",4800,4780,4850,4800,4790,4825,0.007,-35,4807.5,"Rep",20,50,FALSE,FALSE,FALSE,0.73,"young",20,182,78,"m"
14,"VERTICAL TRACTION",2,"Rep04",4420,4460,4400,4450,4440,4425,0.003,15,4432.5,"Rep",-40,-50,FALSE,FALSE,FALSE,0.34,"young",20,182,78,"m"
14,"VERTICAL TRACTION",2,"Rep05",4720,4740,4700,4600,4730,4650,0.017,80,4690,"Rep",-20,100,FALSE,FALSE,FALSE,1.72,"young",20,182,78,"m"
14,"VERTICAL TRACTION",2,"Rep06",4920,4900,4900,5000,4910,4950,0.008,-40,4930,"Rep",20,-100,FALSE,FALSE,FALSE,0.81,"young",20,182,78,"m"
14,"VERTICAL TRACTION",2,"Rep07",4600,4580,4600,4700,4590,4650,0.013,-60,4620,"Rep",20,-100,FALSE,FALSE,FALSE,1.29,"young",20,182,78,"m"
14,"VERTICAL TRACTION",2,"Rep08",4460,4460,4550,4500,4460,4525,0.015,-65,4492.5,"Rep",0,50,FALSE,FALSE,FALSE,1.44,"young",20,182,78,"m"
14,"VERTICAL TRACTION",2,"Rep09",4820,4840,4850,4850,4830,4850,0.004,-20,4840,"Rep",-20,0,FALSE,FALSE,FALSE,0.41,"young",20,182,78,"m"
14,"VERTICAL TRACTION",2,"Rep10",4580,4620,4750,4600,4600,4675,0.016,-75,4637.5,"Rep",-40,150,FALSE,FALSE,FALSE,1.6,"young",20,182,78,"m"
14,"VERTICAL TRACTION",1,"TuT",49140,49120,50400,49200,49130,49800,0.014,-670,49465,"TuT",20,1200,FALSE,FALSE,FALSE,1.35,"young",20,182,78,"m"
14,"VERTICAL TRACTION",2,"TuT",47880,47920,48100,47950,47900,48025,0.003,-125,47962.5,"TuT",-40,150,FALSE,FALSE,FALSE,0.26,"young",20,182,78,"m"
14,"CHEST PRESS",1,"Con01",2000,2000,2850,1550,2000,2200,0.1,-200,2100,"Con",0,1300,FALSE,FALSE,TRUE,9.09,"young",20,182,78,"m"
14,"CHEST PRESS",1,"Con02",1940,2000,2300,3050,1970,2675,0.358,-705,2322.5,"Con",-60,-750,TRUE,TRUE,TRUE,26.36,"young",20,182,78,"m"
14,"CHEST PRESS",1,"Con03",1180,1180,3650,4500,1180,4075,2.453,-2895,2627.5,"Con",0,-850,TRUE,FALSE,TRUE,71.04,"young",20,182,78,"m"
14,"CHEST PRESS",1,"Con04",1140,1140,3450,4100,1140,3775,2.311,-2635,2457.5,"Con",0,-650,TRUE,FALSE,TRUE,69.8,"young",20,182,78,"m"
14,"CHEST PRESS",1,"Con05",1140,1180,3450,2500,1160,2975,1.565,-1815,2067.5,"Con",-40,950,TRUE,TRUE,TRUE,61.01,"young",20,182,78,"m"
14,"CHEST PRESS",1,"Con06",1200,1200,1650,1500,1200,1575,0.312,-375,1387.5,"Con",0,150,TRUE,FALSE,FALSE,23.81,"young",20,182,78,"m"
14,"CHEST PRESS",1,"Con07",1220,1240,1650,1500,1230,1575,0.28,-345,1402.5,"Con",-20,150,FALSE,FALSE,FALSE,21.9,"young",20,182,78,"m"
14,"CHEST PRESS",1,"Con08",1280,1300,1300,1250,1290,1275,0.012,15,1282.5,"Con",-20,50,FALSE,FALSE,FALSE,1.18,"young",20,182,78,"m"
14,"CHEST PRESS",1,"Con09",1300,1280,1400,1350,1290,1375,0.066,-85,1332.5,"Con",20,50,FALSE,FALSE,FALSE,6.18,"young",20,182,78,"m"
14,"CHEST PRESS",1,"Con10",1440,1440,1550,1400,1440,1475,0.024,-35,1457.5,"Con",0,150,FALSE,FALSE,FALSE,2.37,"young",20,182,78,"m"
14,"CHEST PRESS",2,"Con01",1420,1440,3350,2300,1430,2825,0.976,-1395,2127.5,"Con",-20,1050,TRUE,FALSE,TRUE,49.38,"young",20,182,78,"m"
14,"CHEST PRESS",2,"Con02",1280,1300,2550,2600,1290,2575,0.996,-1285,1932.5,"Con",-20,-50,TRUE,FALSE,FALSE,49.9,"young",20,182,78,"m"
14,"CHEST PRESS",2,"Con03",1160,1180,2650,3300,1170,2975,1.543,-1805,2072.5,"Con",-20,-650,TRUE,FALSE,TRUE,60.67,"young",20,182,78,"m"
14,"CHEST PRESS",2,"Con04",1120,1140,1350,2500,1130,1925,0.704,-795,1527.5,"Con",-20,-1150,TRUE,FALSE,TRUE,41.3,"young",20,182,78,"m"
14,"CHEST PRESS",2,"Con05",1140,1160,1300,1300,1150,1300,0.13,-150,1225,"Con",-20,0,FALSE,FALSE,FALSE,11.54,"young",20,182,78,"m"
14,"CHEST PRESS",2,"Con06",1160,1160,1300,1400,1160,1350,0.164,-190,1255,"Con",0,-100,FALSE,FALSE,FALSE,14.07,"young",20,182,78,"m"
14,"CHEST PRESS",2,"Con07",1240,1220,2100,1500,1230,1800,0.463,-570,1515,"Con",20,600,TRUE,FALSE,TRUE,31.67,"young",20,182,78,"m"
14,"CHEST PRESS",2,"Con08",1200,1200,1800,1600,1200,1700,0.417,-500,1450,"Con",0,200,TRUE,FALSE,FALSE,29.41,"young",20,182,78,"m"
14,"CHEST PRESS",2,"Con09",1380,1400,2200,1700,1390,1950,0.403,-560,1670,"Con",-20,500,TRUE,FALSE,TRUE,28.72,"young",20,182,78,"m"
14,"CHEST PRESS",2,"Con10",1420,1400,1800,1550,1410,1675,0.188,-265,1542.5,"Con",20,250,FALSE,FALSE,FALSE,15.82,"young",20,182,78,"m"
14,"CHEST PRESS",1,"Ecc01",3200,3140,3100,3150,3170,3125,0.014,45,3147.5,"Ecc",60,-50,FALSE,TRUE,FALSE,1.44,"young",20,182,78,"m"
14,"CHEST PRESS",1,"Ecc02",4740,4700,2900,1300,4720,2100,0.555,2620,3410,"Ecc",40,1600,TRUE,TRUE,TRUE,124.76,"young",20,182,78,"m"
14,"CHEST PRESS",1,"Ecc03",4760,4760,2500,1900,4760,2200,0.538,2560,3480,"Ecc",0,600,TRUE,FALSE,TRUE,116.36,"young",20,182,78,"m"
14,"CHEST PRESS",1,"Ecc04",4540,4520,2300,2450,4530,2375,0.476,2155,3452.5,"Ecc",20,-150,TRUE,FALSE,FALSE,90.74,"young",20,182,78,"m"
14,"CHEST PRESS",1,"Ecc05",4260,4240,3050,3850,4250,3450,0.188,800,3850,"Ecc",20,-800,TRUE,FALSE,TRUE,23.19,"young",20,182,78,"m"
14,"CHEST PRESS",1,"Ecc06",4140,4120,3550,3800,4130,3675,0.11,455,3902.5,"Ecc",20,-250,TRUE,FALSE,TRUE,12.38,"young",20,182,78,"m"
14,"CHEST PRESS",1,"Ecc07",4100,4080,4000,4000,4090,4000,0.022,90,4045,"Ecc",20,0,FALSE,FALSE,FALSE,2.25,"young",20,182,78,"m"
14,"CHEST PRESS",1,"Ecc08",4060,4080,4000,4050,4070,4025,0.011,45,4047.5,"Ecc",-20,-50,FALSE,FALSE,FALSE,1.12,"young",20,182,78,"m"
14,"CHEST PRESS",1,"Ecc09",4240,4240,4150,4200,4240,4175,0.015,65,4207.5,"Ecc",0,-50,FALSE,FALSE,FALSE,1.56,"young",20,182,78,"m"
14,"CHEST PRESS",1,"Ecc10",2960,2960,3000,3100,2960,3050,0.03,-90,3005,"Ecc",0,-100,FALSE,FALSE,FALSE,2.95,"young",20,182,78,"m"
14,"CHEST PRESS",2,"Ecc01",4680,4660,2600,3400,4670,3000,0.358,1670,3835,"Ecc",20,-800,TRUE,FALSE,TRUE,55.67,"young",20,182,78,"m"
14,"CHEST PRESS",2,"Ecc02",3780,3760,3050,2550,3770,2800,0.257,970,3285,"Ecc",20,500,TRUE,FALSE,TRUE,34.64,"young",20,182,78,"m"
14,"CHEST PRESS",2,"Ecc03",4180,4160,3100,1900,4170,2500,0.4,1670,3335,"Ecc",20,1200,TRUE,FALSE,TRUE,66.8,"young",20,182,78,"m"
14,"CHEST PRESS",2,"Ecc04",3860,3840,3700,3600,3850,3650,0.052,200,3750,"Ecc",20,100,FALSE,FALSE,FALSE,5.48,"young",20,182,78,"m"
14,"CHEST PRESS",2,"Ecc05",3620,3620,3500,3450,3620,3475,0.04,145,3547.5,"Ecc",0,50,FALSE,FALSE,FALSE,4.17,"young",20,182,78,"m"
14,"CHEST PRESS",2,"Ecc06",3920,3940,3650,3650,3930,3650,0.071,280,3790,"Ecc",-20,0,FALSE,FALSE,FALSE,7.67,"young",20,182,78,"m"
14,"CHEST PRESS",2,"Ecc07",3500,3500,2400,3150,3500,2775,0.207,725,3137.5,"Ecc",0,-750,TRUE,FALSE,TRUE,26.13,"young",20,182,78,"m"
14,"CHEST PRESS",2,"Ecc08",3500,3500,3150,3150,3500,3150,0.1,350,3325,"Ecc",0,0,TRUE,FALSE,FALSE,11.11,"young",20,182,78,"m"
14,"CHEST PRESS",2,"Ecc09",3720,3700,2900,3450,3710,3175,0.144,535,3442.5,"Ecc",20,-550,TRUE,FALSE,TRUE,16.85,"young",20,182,78,"m"
14,"CHEST PRESS",2,"Ecc10",2620,2060,2450,2850,2340,2650,0.132,-310,2495,"Ecc",560,-400,FALSE,TRUE,TRUE,11.7,"young",20,182,78,"m"
14,"CHEST PRESS",1,"Rep01",5200,5140,5950,4700,5170,5325,0.03,-155,5247.5,"Rep",60,1250,TRUE,FALSE,TRUE,2.91,"young",20,182,78,"m"
14,"CHEST PRESS",1,"Rep02",6680,6700,5200,4350,6690,4775,0.286,1915,5732.5,"Rep",-20,850,TRUE,FALSE,TRUE,40.1,"young",20,182,78,"m"
14,"CHEST PRESS",1,"Rep03",5940,5940,6150,6400,5940,6275,0.056,-335,6107.5,"Rep",0,-250,TRUE,FALSE,TRUE,5.34,"young",20,182,78,"m"
14,"CHEST PRESS",1,"Rep04",5680,5660,5750,6550,5670,6150,0.085,-480,5910,"Rep",20,-800,TRUE,FALSE,TRUE,7.8,"young",20,182,78,"m"
14,"CHEST PRESS",1,"Rep05",5400,5420,6500,6350,5410,6425,0.188,-1015,5917.5,"Rep",-20,150,TRUE,FALSE,FALSE,15.8,"young",20,182,78,"m"
14,"CHEST PRESS",1,"Rep06",5340,5320,5200,5300,5330,5250,0.015,80,5290,"Rep",20,-100,FALSE,FALSE,FALSE,1.52,"young",20,182,78,"m"
14,"CHEST PRESS",1,"Rep07",5320,5320,5650,5500,5320,5575,0.048,-255,5447.5,"Rep",0,150,TRUE,FALSE,FALSE,4.57,"young",20,182,78,"m"
14,"CHEST PRESS",1,"Rep08",5340,5380,5300,5300,5360,5300,0.011,60,5330,"Rep",-40,0,FALSE,FALSE,FALSE,1.13,"young",20,182,78,"m"
14,"CHEST PRESS",1,"Rep09",5540,5520,5550,5550,5530,5550,0.004,-20,5540,"Rep",20,0,FALSE,FALSE,FALSE,0.36,"young",20,182,78,"m"
14,"CHEST PRESS",1,"Rep10",4400,4400,4550,4500,4400,4525,0.028,-125,4462.5,"Rep",0,50,FALSE,FALSE,FALSE,2.76,"young",20,182,78,"m"
14,"CHEST PRESS",2,"Rep01",6100,6100,5950,5700,6100,5825,0.045,275,5962.5,"Rep",0,250,TRUE,FALSE,TRUE,4.72,"young",20,182,78,"m"
14,"CHEST PRESS",2,"Rep02",5060,5060,5600,5150,5060,5375,0.062,-315,5217.5,"Rep",0,450,TRUE,FALSE,TRUE,5.86,"young",20,182,78,"m"
14,"CHEST PRESS",2,"Rep03",5340,5340,5750,5200,5340,5475,0.025,-135,5407.5,"Rep",0,550,FALSE,FALSE,TRUE,2.47,"young",20,182,78,"m"
14,"CHEST PRESS",2,"Rep04",4980,4980,5050,6100,4980,5575,0.119,-595,5277.5,"Rep",0,-1050,TRUE,FALSE,TRUE,10.67,"young",20,182,78,"m"
14,"CHEST PRESS",2,"Rep05",4760,4780,4800,4750,4770,4775,0.001,-5,4772.5,"Rep",-20,50,FALSE,FALSE,FALSE,0.1,"young",20,182,78,"m"
14,"CHEST PRESS",2,"Rep06",5080,5100,4950,5050,5090,5000,0.018,90,5045,"Rep",-20,-100,FALSE,FALSE,FALSE,1.8,"young",20,182,78,"m"
14,"CHEST PRESS",2,"Rep07",4740,4720,4500,4650,4730,4575,0.033,155,4652.5,"Rep",20,-150,TRUE,FALSE,FALSE,3.39,"young",20,182,78,"m"
14,"CHEST PRESS",2,"Rep08",4700,4700,4950,4750,4700,4850,0.032,-150,4775,"Rep",0,200,TRUE,FALSE,TRUE,3.09,"young",20,182,78,"m"
14,"CHEST PRESS",2,"Rep09",5100,5100,5100,5150,5100,5125,0.005,-25,5112.5,"Rep",0,-50,FALSE,FALSE,FALSE,0.49,"young",20,182,78,"m"
14,"CHEST PRESS",2,"Rep10",4040,3460,4250,4400,3750,4325,0.153,-575,4037.5,"Rep",580,-150,TRUE,TRUE,FALSE,13.29,"young",20,182,78,"m"
14,"CHEST PRESS",1,"TuT",54840,54800,55800,54500,54820,55150,0.006,-330,54985,"TuT",40,1300,FALSE,FALSE,TRUE,0.6,"young",20,182,78,"m"
14,"CHEST PRESS",2,"TuT",49900,49340,50900,50900,49620,50900,0.026,-1280,50260,"TuT",560,0,FALSE,TRUE,FALSE,2.51,"young",20,182,78,"m"
15,"LEG PRESS",1,"Con01",2340,2340,2550,2850,2340,2700,0.154,-360,2520,"Con",0,-300,TRUE,FALSE,TRUE,13.33,"young",19,160,51,"f"
15,"LEG PRESS",1,"Con02",1740,1740,1850,1750,1740,1800,0.034,-60,1770,"Con",0,100,FALSE,FALSE,FALSE,3.33,"young",19,160,51,"f"
15,"LEG PRESS",1,"Con03",1960,1980,2050,2050,1970,2050,0.041,-80,2010,"Con",-20,0,FALSE,FALSE,FALSE,3.9,"young",19,160,51,"f"
15,"LEG PRESS",1,"Con04",1660,1680,1750,1650,1670,1700,0.018,-30,1685,"Con",-20,100,FALSE,FALSE,FALSE,1.76,"young",19,160,51,"f"
15,"LEG PRESS",1,"Con05",1700,1700,1700,1900,1700,1800,0.059,-100,1750,"Con",0,-200,FALSE,FALSE,TRUE,5.56,"young",19,160,51,"f"
15,"LEG PRESS",1,"Con06",1680,1720,1950,2700,1700,2325,0.368,-625,2012.5,"Con",-40,-750,TRUE,FALSE,TRUE,26.88,"young",19,160,51,"f"
15,"LEG PRESS",1,"Con07",1560,1600,2400,2400,1580,2400,0.519,-820,1990,"Con",-40,0,TRUE,FALSE,FALSE,34.17,"young",19,160,51,"f"
15,"LEG PRESS",1,"Con08",1960,1920,2850,2850,1940,2850,0.469,-910,2395,"Con",40,0,TRUE,FALSE,FALSE,31.93,"young",19,160,51,"f"
15,"LEG PRESS",1,"Con09",1680,1700,3000,2950,1690,2975,0.76,-1285,2332.5,"Con",-20,50,TRUE,FALSE,FALSE,43.19,"young",19,160,51,"f"
15,"LEG PRESS",1,"Con10",1620,1620,3000,3000,1620,3000,0.852,-1380,2310,"Con",0,0,TRUE,FALSE,FALSE,46,"young",19,160,51,"f"
15,"LEG PRESS",2,"Con01",1920,1940,2200,2200,1930,2200,0.14,-270,2065,"Con",-20,0,FALSE,FALSE,FALSE,12.27,"young",19,160,51,"f"
15,"LEG PRESS",2,"Con02",1480,1480,1700,1500,1480,1600,0.081,-120,1540,"Con",0,200,FALSE,FALSE,TRUE,7.5,"young",19,160,51,"f"
15,"LEG PRESS",2,"Con03",1680,1680,1950,1850,1680,1900,0.131,-220,1790,"Con",0,100,FALSE,FALSE,FALSE,11.58,"young",19,160,51,"f"
15,"LEG PRESS",2,"Con04",1860,1860,2050,1850,1860,1950,0.048,-90,1905,"Con",0,200,FALSE,FALSE,TRUE,4.62,"young",19,160,51,"f"
15,"LEG PRESS",2,"Con05",2000,2020,2150,2050,2010,2100,0.045,-90,2055,"Con",-20,100,FALSE,FALSE,FALSE,4.29,"young",19,160,51,"f"
15,"LEG PRESS",2,"Con06",1940,1900,2350,2100,1920,2225,0.159,-305,2072.5,"Con",40,250,FALSE,FALSE,TRUE,13.71,"young",19,160,51,"f"
15,"LEG PRESS",2,"Con07",1760,1800,2450,2600,1780,2525,0.419,-745,2152.5,"Con",-40,-150,TRUE,FALSE,FALSE,29.5,"young",19,160,51,"f"
15,"LEG PRESS",2,"Con08",1780,1820,2300,2550,1800,2425,0.347,-625,2112.5,"Con",-40,-250,TRUE,FALSE,TRUE,25.77,"young",19,160,51,"f"
15,"LEG PRESS",2,"Con09",1840,1840,2800,2900,1840,2850,0.549,-1010,2345,"Con",0,-100,TRUE,FALSE,FALSE,35.44,"young",19,160,51,"f"
15,"LEG PRESS",2,"Con10",1460,1500,2400,2450,1480,2425,0.639,-945,1952.5,"Con",-40,-50,TRUE,FALSE,FALSE,38.97,"young",19,160,51,"f"
15,"LEG PRESS",1,"Ecc01",4020,4020,3850,3900,4020,3875,0.036,145,3947.5,"Ecc",0,-50,FALSE,FALSE,FALSE,3.74,"young",19,160,51,"f"
15,"LEG PRESS",1,"Ecc02",3760,3740,3650,3700,3750,3675,0.02,75,3712.5,"Ecc",20,-50,FALSE,FALSE,FALSE,2.04,"young",19,160,51,"f"
15,"LEG PRESS",1,"Ecc03",4000,3980,3950,3950,3990,3950,0.01,40,3970,"Ecc",20,0,FALSE,FALSE,FALSE,1.01,"young",19,160,51,"f"
15,"LEG PRESS",1,"Ecc04",3560,3540,3450,3550,3550,3500,0.014,50,3525,"Ecc",20,-100,FALSE,FALSE,FALSE,1.43,"young",19,160,51,"f"
15,"LEG PRESS",1,"Ecc05",3780,3780,3750,3550,3780,3650,0.034,130,3715,"Ecc",0,200,FALSE,FALSE,TRUE,3.56,"young",19,160,51,"f"
15,"LEG PRESS",1,"Ecc06",3900,3860,3600,2800,3880,3200,0.175,680,3540,"Ecc",40,800,TRUE,FALSE,TRUE,21.25,"young",19,160,51,"f"
15,"LEG PRESS",1,"Ecc07",3280,3260,2450,2500,3270,2475,0.243,795,2872.5,"Ecc",20,-50,TRUE,FALSE,FALSE,32.12,"young",19,160,51,"f"
15,"LEG PRESS",1,"Ecc08",3400,3420,2450,2450,3410,2450,0.282,960,2930,"Ecc",-20,0,TRUE,FALSE,FALSE,39.18,"young",19,160,51,"f"
15,"LEG PRESS",1,"Ecc09",3700,3700,2350,2400,3700,2375,0.358,1325,3037.5,"Ecc",0,-50,TRUE,FALSE,FALSE,55.79,"young",19,160,51,"f"
15,"LEG PRESS",1,"Ecc10",2880,2880,2350,1750,2880,2050,0.288,830,2465,"Ecc",0,600,TRUE,FALSE,TRUE,40.49,"young",19,160,51,"f"
15,"LEG PRESS",2,"Ecc01",4080,4100,3800,4100,4090,3950,0.034,140,4020,"Ecc",-20,-300,FALSE,FALSE,TRUE,3.54,"young",19,160,51,"f"
15,"LEG PRESS",2,"Ecc02",2940,2920,2750,2900,2930,2825,0.036,105,2877.5,"Ecc",20,-150,FALSE,FALSE,FALSE,3.72,"young",19,160,51,"f"
15,"LEG PRESS",2,"Ecc03",3380,3400,3100,3200,3390,3150,0.071,240,3270,"Ecc",-20,-100,FALSE,FALSE,FALSE,7.62,"young",19,160,51,"f"
15,"LEG PRESS",2,"Ecc04",3280,3220,3050,3250,3250,3150,0.031,100,3200,"Ecc",60,-200,FALSE,FALSE,TRUE,3.17,"young",19,160,51,"f"
15,"LEG PRESS",2,"Ecc05",2840,2900,2700,2800,2870,2750,0.042,120,2810,"Ecc",-60,-100,FALSE,FALSE,FALSE,4.36,"young",19,160,51,"f"
15,"LEG PRESS",2,"Ecc06",3040,3040,2600,2850,3040,2725,0.104,315,2882.5,"Ecc",0,-250,FALSE,FALSE,TRUE,11.56,"young",19,160,51,"f"
15,"LEG PRESS",2,"Ecc07",3120,3080,2450,2150,3100,2300,0.258,800,2700,"Ecc",40,300,TRUE,FALSE,TRUE,34.78,"young",19,160,51,"f"
15,"LEG PRESS",2,"Ecc08",2660,2620,2100,1900,2640,2000,0.242,640,2320,"Ecc",40,200,TRUE,FALSE,TRUE,32,"young",19,160,51,"f"
15,"LEG PRESS",2,"Ecc09",3200,3200,2150,2100,3200,2125,0.336,1075,2662.5,"Ecc",0,50,TRUE,FALSE,FALSE,50.59,"young",19,160,51,"f"
15,"LEG PRESS",2,"Ecc10",2280,2260,2000,1950,2270,1975,0.13,295,2122.5,"Ecc",20,50,FALSE,FALSE,FALSE,14.94,"young",19,160,51,"f"
15,"LEG PRESS",1,"Rep01",6360,6360,6400,6750,6360,6575,0.034,-215,6467.5,"Rep",0,-350,TRUE,FALSE,TRUE,3.27,"young",19,160,51,"f"
15,"LEG PRESS",1,"Rep02",5500,5480,5500,5450,5490,5475,0.003,15,5482.5,"Rep",20,50,FALSE,FALSE,FALSE,0.27,"young",19,160,51,"f"
15,"LEG PRESS",1,"Rep03",5960,5960,6000,6000,5960,6000,0.007,-40,5980,"Rep",0,0,FALSE,FALSE,FALSE,0.67,"young",19,160,51,"f"
15,"LEG PRESS",1,"Rep04",5220,5220,5200,5200,5220,5200,0.004,20,5210,"Rep",0,0,FALSE,FALSE,FALSE,0.38,"young",19,160,51,"f"
15,"LEG PRESS",1,"Rep05",5480,5480,5450,5450,5480,5450,0.005,30,5465,"Rep",0,0,FALSE,FALSE,FALSE,0.55,"young",19,160,51,"f"
15,"LEG PRESS",1,"Rep06",5580,5580,5550,5500,5580,5525,0.01,55,5552.5,"Rep",0,50,FALSE,FALSE,FALSE,1,"young",19,160,51,"f"
15,"LEG PRESS",1,"Rep07",4840,4860,4850,4900,4850,4875,0.005,-25,4862.5,"Rep",-20,-50,FALSE,FALSE,FALSE,0.51,"young",19,160,51,"f"
15,"LEG PRESS",1,"Rep08",5360,5340,5300,5300,5350,5300,0.009,50,5325,"Rep",20,0,FALSE,FALSE,FALSE,0.94,"young",19,160,51,"f"
15,"LEG PRESS",1,"Rep09",5380,5400,5350,5350,5390,5350,0.007,40,5370,"Rep",-20,0,FALSE,FALSE,FALSE,0.75,"young",19,160,51,"f"
15,"LEG PRESS",1,"Rep10",4500,4500,5350,4750,4500,5050,0.122,-550,4775,"Rep",0,600,TRUE,FALSE,TRUE,10.89,"young",19,160,51,"f"
15,"LEG PRESS",2,"Rep01",6000,6040,6000,6300,6020,6150,0.022,-130,6085,"Rep",-40,-300,TRUE,FALSE,TRUE,2.11,"young",19,160,51,"f"
15,"LEG PRESS",2,"Rep02",4420,4400,4450,4400,4410,4425,0.003,-15,4417.5,"Rep",20,50,FALSE,FALSE,FALSE,0.34,"young",19,160,51,"f"
15,"LEG PRESS",2,"Rep03",5060,5080,5050,5050,5070,5050,0.004,20,5060,"Rep",-20,0,FALSE,FALSE,FALSE,0.4,"young",19,160,51,"f"
15,"LEG PRESS",2,"Rep04",5140,5080,5100,5100,5110,5100,0.002,10,5105,"Rep",60,0,FALSE,FALSE,FALSE,0.2,"young",19,160,51,"f"
15,"LEG PRESS",2,"Rep05",4840,4920,4850,4850,4880,4850,0.006,30,4865,"Rep",-80,0,FALSE,TRUE,FALSE,0.62,"young",19,160,51,"f"
15,"LEG PRESS",2,"Rep06",4980,4940,4950,4950,4960,4950,0.002,10,4955,"Rep",40,0,FALSE,FALSE,FALSE,0.2,"young",19,160,51,"f"
15,"LEG PRESS",2,"Rep07",4880,4880,4900,4750,4880,4825,0.011,55,4852.5,"Rep",0,150,FALSE,FALSE,TRUE,1.14,"young",19,160,51,"f"
15,"LEG PRESS",2,"Rep08",4440,4440,4400,4450,4440,4425,0.003,15,4432.5,"Rep",0,-50,FALSE,FALSE,FALSE,0.34,"young",19,160,51,"f"
15,"LEG PRESS",2,"Rep09",5040,5040,4950,5000,5040,4975,0.013,65,5007.5,"Rep",0,-50,FALSE,FALSE,FALSE,1.31,"young",19,160,51,"f"
15,"LEG PRESS",2,"Rep10",3740,3760,4400,4400,3750,4400,0.173,-650,4075,"Rep",-20,0,TRUE,FALSE,FALSE,14.77,"young",19,160,51,"f"
15,"LEG PRESS",1,"TuT",54180,54180,54950,54650,54180,54800,0.011,-620,54490,"TuT",0,300,TRUE,FALSE,FALSE,1.13,"young",19,160,51,"f"
15,"LEG PRESS",2,"TuT",48540,48580,49050,49250,48560,49150,0.012,-590,48855,"TuT",-40,-200,TRUE,FALSE,FALSE,1.2,"young",19,160,51,"f"
15,"LEG EXTENSION",1,"Con01",2220,2240,1700,2300,2230,2000,0.103,230,2115,"Con",-20,-600,TRUE,FALSE,TRUE,11.5,"young",19,160,51,"f"
15,"LEG EXTENSION",1,"Con02",1520,1560,1550,1750,1540,1650,0.071,-110,1595,"Con",-40,-200,FALSE,TRUE,TRUE,6.67,"young",19,160,51,"f"
15,"LEG EXTENSION",1,"Con03",1900,1920,2000,2050,1910,2025,0.06,-115,1967.5,"Con",-20,-50,FALSE,FALSE,FALSE,5.68,"young",19,160,51,"f"
15,"LEG EXTENSION",1,"Con04",1480,1520,1550,1650,1500,1600,0.067,-100,1550,"Con",-40,-100,FALSE,TRUE,FALSE,6.25,"young",19,160,51,"f"
15,"LEG EXTENSION",1,"Con05",1460,1480,1650,1650,1470,1650,0.122,-180,1560,"Con",-20,0,FALSE,FALSE,FALSE,10.91,"young",19,160,51,"f"
15,"LEG EXTENSION",1,"Con06",1540,1560,1850,1750,1550,1800,0.161,-250,1675,"Con",-20,100,TRUE,FALSE,FALSE,13.89,"young",19,160,51,"f"
15,"LEG EXTENSION",1,"Con07",1460,1500,1800,1700,1480,1750,0.182,-270,1615,"Con",-40,100,TRUE,TRUE,FALSE,15.43,"young",19,160,51,"f"
15,"LEG EXTENSION",1,"Con08",1360,1380,1600,1500,1370,1550,0.131,-180,1460,"Con",-20,100,FALSE,FALSE,FALSE,11.61,"young",19,160,51,"f"
15,"LEG EXTENSION",1,"Con09",1380,1380,1750,1700,1380,1725,0.25,-345,1552.5,"Con",0,50,TRUE,FALSE,FALSE,20,"young",19,160,51,"f"
15,"LEG EXTENSION",1,"Con10",1460,1460,1800,1850,1460,1825,0.25,-365,1642.5,"Con",0,-50,TRUE,FALSE,FALSE,20,"young",19,160,51,"f"
15,"LEG EXTENSION",2,"Con01",1960,1980,2000,2100,1970,2050,0.041,-80,2010,"Con",-20,-100,FALSE,FALSE,FALSE,3.9,"young",19,160,51,"f"
15,"LEG EXTENSION",2,"Con02",1640,1660,1700,1800,1650,1750,0.061,-100,1700,"Con",-20,-100,FALSE,FALSE,FALSE,5.71,"young",19,160,51,"f"
15,"LEG EXTENSION",2,"Con03",1680,1720,1900,1900,1700,1900,0.118,-200,1800,"Con",-40,0,TRUE,TRUE,FALSE,10.53,"young",19,160,51,"f"
15,"LEG EXTENSION",2,"Con04",1520,1540,1700,1750,1530,1725,0.127,-195,1627.5,"Con",-20,-50,TRUE,FALSE,FALSE,11.3,"young",19,160,51,"f"
15,"LEG EXTENSION",2,"Con05",1520,1500,1750,1700,1510,1725,0.142,-215,1617.5,"Con",20,50,TRUE,FALSE,FALSE,12.46,"young",19,160,51,"f"
15,"LEG EXTENSION",2,"Con06",1520,1540,1650,1700,1530,1675,0.095,-145,1602.5,"Con",-20,-50,FALSE,FALSE,FALSE,8.66,"young",19,160,51,"f"
15,"LEG EXTENSION",2,"Con07",1360,1380,1500,1500,1370,1500,0.095,-130,1435,"Con",-20,0,FALSE,FALSE,FALSE,8.67,"young",19,160,51,"f"
15,"LEG EXTENSION",2,"Con08",1240,1260,1400,1400,1250,1400,0.12,-150,1325,"Con",-20,0,FALSE,FALSE,FALSE,10.71,"young",19,160,51,"f"
15,"LEG EXTENSION",2,"Con09",1520,1500,1850,1850,1510,1850,0.225,-340,1680,"Con",20,0,TRUE,FALSE,FALSE,18.38,"young",19,160,51,"f"
15,"LEG EXTENSION",2,"Con10",1880,1940,3350,3600,1910,3475,0.819,-1565,2692.5,"Con",-60,-250,TRUE,TRUE,TRUE,45.04,"young",19,160,51,"f"
15,"LEG EXTENSION",1,"Ecc01",5420,5380,5450,5200,5400,5325,0.014,75,5362.5,"Ecc",40,250,FALSE,TRUE,TRUE,1.41,"young",19,160,51,"f"
15,"LEG EXTENSION",1,"Ecc02",7560,7560,7450,7300,7560,7375,0.024,185,7467.5,"Ecc",0,150,FALSE,FALSE,FALSE,2.51,"young",19,160,51,"f"
15,"LEG EXTENSION",1,"Ecc03",6640,6580,6550,6500,6610,6525,0.013,85,6567.5,"Ecc",60,50,FALSE,TRUE,FALSE,1.3,"young",19,160,51,"f"
15,"LEG EXTENSION",1,"Ecc04",6220,6200,6100,6050,6210,6075,0.022,135,6142.5,"Ecc",20,50,FALSE,FALSE,FALSE,2.22,"young",19,160,51,"f"
15,"LEG EXTENSION",1,"Ecc05",5620,5620,5350,5400,5620,5375,0.044,245,5497.5,"Ecc",0,-50,TRUE,FALSE,FALSE,4.56,"young",19,160,51,"f"
15,"LEG EXTENSION",1,"Ecc06",6300,6260,5950,6050,6280,6000,0.045,280,6140,"Ecc",40,-100,TRUE,TRUE,FALSE,4.67,"young",19,160,51,"f"
15,"LEG EXTENSION",1,"Ecc07",5000,4960,4750,4850,4980,4800,0.036,180,4890,"Ecc",40,-100,FALSE,TRUE,FALSE,3.75,"young",19,160,51,"f"
15,"LEG EXTENSION",1,"Ecc08",5440,5440,5050,5150,5440,5100,0.062,340,5270,"Ecc",0,-100,TRUE,FALSE,FALSE,6.67,"young",19,160,51,"f"
15,"LEG EXTENSION",1,"Ecc09",4520,4500,4200,4150,4510,4175,0.074,335,4342.5,"Ecc",20,50,TRUE,FALSE,FALSE,8.02,"young",19,160,51,"f"
15,"LEG EXTENSION",1,"Ecc10",3860,3880,3800,3750,3870,3775,0.025,95,3822.5,"Ecc",-20,50,FALSE,FALSE,FALSE,2.52,"young",19,160,51,"f"
15,"LEG EXTENSION",2,"Ecc01",4920,4920,4900,4800,4920,4850,0.014,70,4885,"Ecc",0,100,FALSE,FALSE,FALSE,1.44,"young",19,160,51,"f"
15,"LEG EXTENSION",2,"Ecc02",6040,6020,5900,5850,6030,5875,0.026,155,5952.5,"Ecc",20,50,FALSE,FALSE,FALSE,2.64,"young",19,160,51,"f"
15,"LEG EXTENSION",2,"Ecc03",5980,5940,5750,5750,5960,5750,0.035,210,5855,"Ecc",40,0,TRUE,TRUE,FALSE,3.65,"young",19,160,51,"f"
15,"LEG EXTENSION",2,"Ecc04",7160,7160,6950,6950,7160,6950,0.029,210,7055,"Ecc",0,0,TRUE,FALSE,FALSE,3.02,"young",19,160,51,"f"
15,"LEG EXTENSION",2,"Ecc05",6600,6600,6400,6400,6600,6400,0.03,200,6500,"Ecc",0,0,TRUE,FALSE,FALSE,3.12,"young",19,160,51,"f"
15,"LEG EXTENSION",2,"Ecc06",6200,6180,6100,6050,6190,6075,0.019,115,6132.5,"Ecc",20,50,FALSE,FALSE,FALSE,1.89,"young",19,160,51,"f"
15,"LEG EXTENSION",2,"Ecc07",5100,5080,4950,4950,5090,4950,0.028,140,5020,"Ecc",20,0,FALSE,FALSE,FALSE,2.83,"young",19,160,51,"f"
15,"LEG EXTENSION",2,"Ecc08",5740,5760,5550,5550,5750,5550,0.035,200,5650,"Ecc",-20,0,TRUE,FALSE,FALSE,3.6,"young",19,160,51,"f"
15,"LEG EXTENSION",2,"Ecc09",5640,5600,4600,4500,5620,4550,0.19,1070,5085,"Ecc",40,100,TRUE,TRUE,FALSE,23.52,"young",19,160,51,"f"
15,"LEG EXTENSION",2,"Ecc10",3400,3380,2850,2650,3390,2750,0.189,640,3070,"Ecc",20,200,TRUE,FALSE,TRUE,23.27,"young",19,160,51,"f"
15,"LEG EXTENSION",1,"Rep01",7640,7620,7150,7500,7630,7325,0.04,305,7477.5,"Rep",20,-350,TRUE,FALSE,TRUE,4.16,"young",19,160,51,"f"
15,"LEG EXTENSION",1,"Rep02",9080,9120,9000,9050,9100,9025,0.008,75,9062.5,"Rep",-40,-50,FALSE,FALSE,FALSE,0.83,"young",19,160,51,"f"
15,"LEG EXTENSION",1,"Rep03",8540,8500,8550,8550,8520,8550,0.004,-30,8535,"Rep",40,0,FALSE,FALSE,FALSE,0.35,"young",19,160,51,"f"
15,"LEG EXTENSION",1,"Rep04",7700,7720,7650,7700,7710,7675,0.005,35,7692.5,"Rep",-20,-50,FALSE,FALSE,FALSE,0.46,"young",19,160,51,"f"
15,"LEG EXTENSION",1,"Rep05",7080,7100,7000,7050,7090,7025,0.009,65,7057.5,"Rep",-20,-50,FALSE,FALSE,FALSE,0.93,"young",19,160,51,"f"
15,"LEG EXTENSION",1,"Rep06",7840,7820,7800,7800,7830,7800,0.004,30,7815,"Rep",20,0,FALSE,FALSE,FALSE,0.38,"young",19,160,51,"f"
15,"LEG EXTENSION",1,"Rep07",6460,6460,6550,6550,6460,6550,0.014,-90,6505,"Rep",0,0,FALSE,FALSE,FALSE,1.37,"young",19,160,51,"f"
15,"LEG EXTENSION",1,"Rep08",6800,6820,6650,6650,6810,6650,0.023,160,6730,"Rep",-20,0,TRUE,FALSE,FALSE,2.41,"young",19,160,51,"f"
15,"LEG EXTENSION",1,"Rep09",5900,5880,5950,5850,5890,5900,0.002,-10,5895,"Rep",20,100,FALSE,FALSE,FALSE,0.17,"young",19,160,51,"f"
15,"LEG EXTENSION",1,"Rep10",5320,5340,5600,5600,5330,5600,0.051,-270,5465,"Rep",-20,0,TRUE,FALSE,FALSE,4.82,"young",19,160,51,"f"
15,"LEG EXTENSION",2,"Rep01",6880,6900,6900,6900,6890,6900,0.001,-10,6895,"Rep",-20,0,FALSE,FALSE,FALSE,0.14,"young",19,160,51,"f"
15,"LEG EXTENSION",2,"Rep02",7680,7680,7600,7650,7680,7625,0.007,55,7652.5,"Rep",0,-50,FALSE,FALSE,FALSE,0.72,"young",19,160,51,"f"
15,"LEG EXTENSION",2,"Rep03",7660,7660,7650,7650,7660,7650,0.001,10,7655,"Rep",0,0,FALSE,FALSE,FALSE,0.13,"young",19,160,51,"f"
15,"LEG EXTENSION",2,"Rep04",8680,8700,8650,8700,8690,8675,0.002,15,8682.5,"Rep",-20,-50,FALSE,FALSE,FALSE,0.17,"young",19,160,51,"f"
15,"LEG EXTENSION",2,"Rep05",8120,8100,8150,8100,8110,8125,0.002,-15,8117.5,"Rep",20,50,FALSE,FALSE,FALSE,0.18,"young",19,160,51,"f"
15,"LEG EXTENSION",2,"Rep06",7720,7720,7750,7750,7720,7750,0.004,-30,7735,"Rep",0,0,FALSE,FALSE,FALSE,0.39,"young",19,160,51,"f"
15,"LEG EXTENSION",2,"Rep07",6460,6460,6450,6450,6460,6450,0.002,10,6455,"Rep",0,0,FALSE,FALSE,FALSE,0.16,"young",19,160,51,"f"
15,"LEG EXTENSION",2,"Rep08",6980,7020,6950,6950,7000,6950,0.007,50,6975,"Rep",-40,0,FALSE,FALSE,FALSE,0.72,"young",19,160,51,"f"
15,"LEG EXTENSION",2,"Rep09",7160,7100,6450,6350,7130,6400,0.102,730,6765,"Rep",60,100,TRUE,FALSE,FALSE,11.41,"young",19,160,51,"f"
15,"LEG EXTENSION",2,"Rep10",5280,5320,6200,6250,5300,6225,0.175,-925,5762.5,"Rep",-40,-50,TRUE,FALSE,FALSE,14.86,"young",19,160,51,"f"
15,"LEG EXTENSION",1,"TuT",72360,72380,71900,72300,72370,72100,0.004,270,72235,"TuT",-20,-400,TRUE,FALSE,TRUE,0.37,"young",19,160,51,"f"
15,"LEG EXTENSION",2,"TuT",72620,72660,72750,72750,72640,72750,0.002,-110,72695,"TuT",-40,0,FALSE,FALSE,FALSE,0.15,"young",19,160,51,"f"
15,"LEG CURL",1,"Con01",4200,4200,2250,3300,4200,2775,0.339,1425,3487.5,"Con",0,-1050,TRUE,FALSE,TRUE,51.35,"young",19,160,51,"f"
15,"LEG CURL",1,"Con02",2360,2360,2450,2400,2360,2425,0.028,-65,2392.5,"Con",0,50,FALSE,FALSE,FALSE,2.68,"young",19,160,51,"f"
15,"LEG CURL",1,"Con03",2220,2220,2300,2200,2220,2250,0.014,-30,2235,"Con",0,100,FALSE,FALSE,FALSE,1.33,"young",19,160,51,"f"
15,"LEG CURL",1,"Con04",3020,3020,2850,2800,3020,2825,0.065,195,2922.5,"Con",0,50,FALSE,FALSE,FALSE,6.9,"young",19,160,51,"f"
15,"LEG CURL",1,"Con05",2380,2360,2550,2500,2370,2525,0.065,-155,2447.5,"Con",20,50,FALSE,FALSE,FALSE,6.14,"young",19,160,51,"f"
15,"LEG CURL",1,"Con06",2140,2080,3450,3450,2110,3450,0.635,-1340,2780,"Con",60,0,TRUE,FALSE,FALSE,38.84,"young",19,160,51,"f"
15,"LEG CURL",1,"Con07",2340,2300,2550,3700,2320,3125,0.347,-805,2722.5,"Con",40,-1150,TRUE,FALSE,TRUE,25.76,"young",19,160,51,"f"
15,"LEG CURL",1,"Con08",2320,2300,4150,4200,2310,4175,0.807,-1865,3242.5,"Con",20,-50,TRUE,FALSE,FALSE,44.67,"young",19,160,51,"f"
15,"LEG CURL",1,"Con09",2220,2220,4250,4100,2220,4175,0.881,-1955,3197.5,"Con",0,150,TRUE,FALSE,FALSE,46.83,"young",19,160,51,"f"
15,"LEG CURL",1,"Con10",2660,2640,4700,4550,2650,4625,0.745,-1975,3637.5,"Con",20,150,TRUE,FALSE,FALSE,42.7,"young",19,160,51,"f"
15,"LEG CURL",2,"Con01",2320,2340,2650,3200,2330,2925,0.255,-595,2627.5,"Con",-20,-550,TRUE,FALSE,TRUE,20.34,"young",19,160,51,"f"
15,"LEG CURL",2,"Con02",2560,2600,2850,2500,2580,2675,0.037,-95,2627.5,"Con",-40,350,FALSE,FALSE,TRUE,3.55,"young",19,160,51,"f"
15,"LEG CURL",2,"Con03",2280,2280,2300,2150,2280,2225,0.024,55,2252.5,"Con",0,150,FALSE,FALSE,FALSE,2.47,"young",19,160,51,"f"
15,"LEG CURL",2,"Con04",1940,1940,2150,2050,1940,2100,0.082,-160,2020,"Con",0,100,FALSE,FALSE,FALSE,7.62,"young",19,160,51,"f"
15,"LEG CURL",2,"Con05",2380,2400,2700,3350,2390,3025,0.266,-635,2707.5,"Con",-20,-650,TRUE,FALSE,TRUE,20.99,"young",19,160,51,"f"
15,"LEG CURL",2,"Con06",2260,2300,2550,2600,2280,2575,0.129,-295,2427.5,"Con",-40,-50,TRUE,FALSE,FALSE,11.46,"young",19,160,51,"f"
15,"LEG CURL",2,"Con07",2020,2060,2300,3200,2040,2750,0.348,-710,2395,"Con",-40,-900,TRUE,FALSE,TRUE,25.82,"young",19,160,51,"f"
15,"LEG CURL",2,"Con08",2520,2580,4100,4200,2550,4150,0.627,-1600,3350,"Con",-60,-100,TRUE,FALSE,FALSE,38.55,"young",19,160,51,"f"
15,"LEG CURL",2,"Con09",2520,2520,4100,4050,2520,4075,0.617,-1555,3297.5,"Con",0,50,TRUE,FALSE,FALSE,38.16,"young",19,160,51,"f"
15,"LEG CURL",2,"Con10",2580,2560,4900,4950,2570,4925,0.916,-2355,3747.5,"Con",20,-50,TRUE,FALSE,FALSE,47.82,"young",19,160,51,"f"
15,"LEG CURL",1,"Ecc01",5860,5860,5750,5650,5860,5700,0.027,160,5780,"Ecc",0,100,FALSE,FALSE,FALSE,2.81,"young",19,160,51,"f"
15,"LEG CURL",1,"Ecc02",5440,5440,5400,5550,5440,5475,0.006,-35,5457.5,"Ecc",0,-150,FALSE,FALSE,FALSE,0.64,"young",19,160,51,"f"
15,"LEG CURL",1,"Ecc03",6820,6820,6700,6650,6820,6675,0.021,145,6747.5,"Ecc",0,50,FALSE,FALSE,FALSE,2.17,"young",19,160,51,"f"
15,"LEG CURL",1,"Ecc04",5200,5220,5400,5450,5210,5425,0.041,-215,5317.5,"Ecc",-20,-50,FALSE,FALSE,FALSE,3.96,"young",19,160,51,"f"
15,"LEG CURL",1,"Ecc05",6080,6120,5850,5900,6100,5875,0.037,225,5987.5,"Ecc",-40,-50,FALSE,FALSE,FALSE,3.83,"young",19,160,51,"f"
15,"LEG CURL",1,"Ecc06",6580,6620,5250,5150,6600,5200,0.212,1400,5900,"Ecc",-40,100,TRUE,FALSE,FALSE,26.92,"young",19,160,51,"f"
15,"LEG CURL",1,"Ecc07",6820,6860,6550,5450,6840,6000,0.123,840,6420,"Ecc",-40,1100,TRUE,FALSE,TRUE,14,"young",19,160,51,"f"
15,"LEG CURL",1,"Ecc08",7560,7580,5700,5650,7570,5675,0.25,1895,6622.5,"Ecc",-20,50,TRUE,FALSE,FALSE,33.39,"young",19,160,51,"f"
15,"LEG CURL",1,"Ecc09",6700,6700,4300,4600,6700,4450,0.336,2250,5575,"Ecc",0,-300,TRUE,FALSE,TRUE,50.56,"young",19,160,51,"f"
15,"LEG CURL",1,"Ecc10",8980,8960,7600,7550,8970,7575,0.156,1395,8272.5,"Ecc",20,50,TRUE,FALSE,FALSE,18.42,"young",19,160,51,"f"
15,"LEG CURL",2,"Ecc01",5200,5180,4800,5050,5190,4925,0.051,265,5057.5,"Ecc",20,-250,TRUE,FALSE,TRUE,5.38,"young",19,160,51,"f"
15,"LEG CURL",2,"Ecc02",7180,7160,7100,7350,7170,7225,0.008,-55,7197.5,"Ecc",20,-250,FALSE,FALSE,TRUE,0.76,"young",19,160,51,"f"
15,"LEG CURL",2,"Ecc03",6060,6060,5950,6050,6060,6000,0.01,60,6030,"Ecc",0,-100,FALSE,FALSE,FALSE,1,"young",19,160,51,"f"
15,"LEG CURL",2,"Ecc04",6560,6560,6300,6350,6560,6325,0.036,235,6442.5,"Ecc",0,-50,TRUE,FALSE,FALSE,3.72,"young",19,160,51,"f"
15,"LEG CURL",2,"Ecc05",7020,6980,6650,6000,7000,6325,0.096,675,6662.5,"Ecc",40,650,TRUE,FALSE,TRUE,10.67,"young",19,160,51,"f"
15,"LEG CURL",2,"Ecc06",5960,5920,5750,5650,5940,5700,0.04,240,5820,"Ecc",40,100,TRUE,FALSE,FALSE,4.21,"young",19,160,51,"f"
15,"LEG CURL",2,"Ecc07",6580,6520,6150,5200,6550,5675,0.134,875,6112.5,"Ecc",60,950,TRUE,FALSE,TRUE,15.42,"young",19,160,51,"f"
15,"LEG CURL",2,"Ecc08",6200,6180,4650,4650,6190,4650,0.249,1540,5420,"Ecc",20,0,TRUE,FALSE,FALSE,33.12,"young",19,160,51,"f"
15,"LEG CURL",2,"Ecc09",6300,6320,4550,4450,6310,4500,0.287,1810,5405,"Ecc",-20,100,TRUE,FALSE,FALSE,40.22,"young",19,160,51,"f"
15,"LEG CURL",2,"Ecc10",6340,6340,4400,4500,6340,4450,0.298,1890,5395,"Ecc",0,-100,TRUE,FALSE,FALSE,42.47,"young",19,160,51,"f"
15,"LEG CURL",1,"Rep01",10060,10060,8000,8950,10060,8475,0.158,1585,9267.5,"Rep",0,-950,TRUE,FALSE,TRUE,18.7,"young",19,160,51,"f"
15,"LEG CURL",1,"Rep02",7800,7800,7850,7950,7800,7900,0.013,-100,7850,"Rep",0,-100,FALSE,FALSE,FALSE,1.27,"young",19,160,51,"f"
15,"LEG CURL",1,"Rep03",9040,9040,9000,8850,9040,8925,0.013,115,8982.5,"Rep",0,150,FALSE,FALSE,FALSE,1.29,"young",19,160,51,"f"
15,"LEG CURL",1,"Rep04",8220,8240,8250,8250,8230,8250,0.002,-20,8240,"Rep",-20,0,FALSE,FALSE,FALSE,0.24,"young",19,160,51,"f"
15,"LEG CURL",1,"Rep05",8460,8480,8400,8400,8470,8400,0.008,70,8435,"Rep",-20,0,FALSE,FALSE,FALSE,0.83,"young",19,160,51,"f"
15,"LEG CURL",1,"Rep06",8720,8700,8700,8600,8710,8650,0.007,60,8680,"Rep",20,100,FALSE,FALSE,FALSE,0.69,"young",19,160,51,"f"
15,"LEG CURL",1,"Rep07",9160,9160,9100,9150,9160,9125,0.004,35,9142.5,"Rep",0,-50,FALSE,FALSE,FALSE,0.38,"young",19,160,51,"f"
15,"LEG CURL",1,"Rep08",9880,9880,9850,9850,9880,9850,0.003,30,9865,"Rep",0,0,FALSE,FALSE,FALSE,0.3,"young",19,160,51,"f"
15,"LEG CURL",1,"Rep09",8920,8920,8550,8700,8920,8625,0.033,295,8772.5,"Rep",0,-150,TRUE,FALSE,FALSE,3.42,"young",19,160,51,"f"
15,"LEG CURL",1,"Rep10",11640,11600,12300,12100,11620,12200,0.05,-580,11910,"Rep",40,200,TRUE,FALSE,TRUE,4.75,"young",19,160,51,"f"
15,"LEG CURL",2,"Rep01",7520,7520,7450,8250,7520,7850,0.044,-330,7685,"Rep",0,-800,TRUE,FALSE,TRUE,4.2,"young",19,160,51,"f"
15,"LEG CURL",2,"Rep02",9740,9760,9950,9850,9750,9900,0.015,-150,9825,"Rep",-20,100,FALSE,FALSE,FALSE,1.52,"young",19,160,51,"f"
15,"LEG CURL",2,"Rep03",8340,8340,8250,8200,8340,8225,0.014,115,8282.5,"Rep",0,50,FALSE,FALSE,FALSE,1.4,"young",19,160,51,"f"
15,"LEG CURL",2,"Rep04",8500,8500,8450,8400,8500,8425,0.009,75,8462.5,"Rep",0,50,FALSE,FALSE,FALSE,0.89,"young",19,160,51,"f"
15,"LEG CURL",2,"Rep05",9400,9380,9350,9350,9390,9350,0.004,40,9370,"Rep",20,0,FALSE,FALSE,FALSE,0.43,"young",19,160,51,"f"
15,"LEG CURL",2,"Rep06",8220,8220,8300,8250,8220,8275,0.007,-55,8247.5,"Rep",0,50,FALSE,FALSE,FALSE,0.66,"young",19,160,51,"f"
15,"LEG CURL",2,"Rep07",8600,8580,8450,8400,8590,8425,0.019,165,8507.5,"Rep",20,50,TRUE,FALSE,FALSE,1.96,"young",19,160,51,"f"
15,"LEG CURL",2,"Rep08",8720,8760,8750,8850,8740,8800,0.007,-60,8770,"Rep",-40,-100,FALSE,FALSE,FALSE,0.68,"young",19,160,51,"f"
15,"LEG CURL",2,"Rep09",8820,8840,8650,8500,8830,8575,0.029,255,8702.5,"Rep",-20,150,TRUE,FALSE,FALSE,2.97,"young",19,160,51,"f"
15,"LEG CURL",2,"Rep10",8920,8900,9300,9450,8910,9375,0.052,-465,9142.5,"Rep",20,-150,TRUE,FALSE,FALSE,4.96,"young",19,160,51,"f"
15,"LEG CURL",1,"TuT",91900,91880,90000,90800,91890,90400,0.016,1490,91145,"TuT",20,-800,TRUE,FALSE,TRUE,1.65,"young",19,160,51,"f"
15,"LEG CURL",2,"TuT",86780,86800,86900,87500,86790,87200,0.005,-410,86995,"TuT",-20,-600,TRUE,FALSE,TRUE,0.47,"young",19,160,51,"f"
15,"ABDUCTOR",1,"Con01",1340,1320,1600,1600,1330,1600,0.203,-270,1465,"Con",20,0,FALSE,FALSE,FALSE,16.88,"young",19,160,51,"f"
15,"ABDUCTOR",1,"Con02",1040,1040,1200,1350,1040,1275,0.226,-235,1157.5,"Con",0,-150,FALSE,FALSE,FALSE,18.43,"young",19,160,51,"f"
15,"ABDUCTOR",1,"Con03",960,1000,1150,1150,980,1150,0.173,-170,1065,"Con",-40,0,FALSE,TRUE,FALSE,14.78,"young",19,160,51,"f"
15,"ABDUCTOR",1,"Con04",920,940,1050,1100,930,1075,0.156,-145,1002.5,"Con",-20,-50,FALSE,FALSE,FALSE,13.49,"young",19,160,51,"f"
15,"ABDUCTOR",1,"Con05",940,960,1250,1250,950,1250,0.316,-300,1100,"Con",-20,0,TRUE,FALSE,FALSE,24,"young",19,160,51,"f"
15,"ABDUCTOR",1,"Con06",1160,1160,1400,1400,1160,1400,0.207,-240,1280,"Con",0,0,FALSE,FALSE,FALSE,17.14,"young",19,160,51,"f"
15,"ABDUCTOR",1,"Con07",980,1000,1200,1250,990,1225,0.237,-235,1107.5,"Con",-20,-50,FALSE,FALSE,FALSE,19.18,"young",19,160,51,"f"
15,"ABDUCTOR",1,"Con08",840,840,1200,1100,840,1150,0.369,-310,995,"Con",0,100,TRUE,FALSE,FALSE,26.96,"young",19,160,51,"f"
15,"ABDUCTOR",1,"Con09",880,900,1800,1700,890,1750,0.966,-860,1320,"Con",-20,100,TRUE,FALSE,FALSE,49.14,"young",19,160,51,"f"
15,"ABDUCTOR",1,"Con10",1140,1140,2000,1450,1140,1725,0.513,-585,1432.5,"Con",0,550,TRUE,FALSE,TRUE,33.91,"young",19,160,51,"f"
15,"ABDUCTOR",2,"Con01",1220,1180,1400,1400,1200,1400,0.167,-200,1300,"Con",40,0,FALSE,TRUE,FALSE,14.29,"young",19,160,51,"f"
15,"ABDUCTOR",2,"Con02",1040,1020,1150,1200,1030,1175,0.141,-145,1102.5,"Con",20,-50,FALSE,FALSE,FALSE,12.34,"young",19,160,51,"f"
15,"ABDUCTOR",2,"Con03",920,920,1100,1100,920,1100,0.196,-180,1010,"Con",0,0,FALSE,FALSE,FALSE,16.36,"young",19,160,51,"f"
15,"ABDUCTOR",2,"Con04",900,900,1150,1200,900,1175,0.306,-275,1037.5,"Con",0,-50,FALSE,FALSE,FALSE,23.4,"young",19,160,51,"f"
15,"ABDUCTOR",2,"Con05",880,880,1200,1150,880,1175,0.335,-295,1027.5,"Con",0,50,TRUE,FALSE,FALSE,25.11,"young",19,160,51,"f"
15,"ABDUCTOR",2,"Con06",840,840,1050,1000,840,1025,0.22,-185,932.5,"Con",0,50,FALSE,FALSE,FALSE,18.05,"young",19,160,51,"f"
15,"ABDUCTOR",2,"Con07",800,800,950,950,800,950,0.188,-150,875,"Con",0,0,FALSE,FALSE,FALSE,15.79,"young",19,160,51,"f"
15,"ABDUCTOR",2,"Con08",820,800,950,950,810,950,0.173,-140,880,"Con",20,0,FALSE,FALSE,FALSE,14.74,"young",19,160,51,"f"
15,"ABDUCTOR",2,"Con09",820,840,2600,1150,830,1875,1.259,-1045,1352.5,"Con",-20,1450,TRUE,FALSE,TRUE,55.73,"young",19,160,51,"f"
15,"ABDUCTOR",2,"Con10",1040,1040,1800,1850,1040,1825,0.755,-785,1432.5,"Con",0,-50,TRUE,FALSE,FALSE,43.01,"young",19,160,51,"f"
15,"ABDUCTOR",1,"Ecc01",5940,5960,5700,5600,5950,5650,0.05,300,5800,"Ecc",-20,100,FALSE,FALSE,FALSE,5.31,"young",19,160,51,"f"
15,"ABDUCTOR",1,"Ecc02",6200,6180,6000,6000,6190,6000,0.031,190,6095,"Ecc",20,0,FALSE,FALSE,FALSE,3.17,"young",19,160,51,"f"
15,"ABDUCTOR",1,"Ecc03",5400,5380,5300,5200,5390,5250,0.026,140,5320,"Ecc",20,100,FALSE,FALSE,FALSE,2.67,"young",19,160,51,"f"
15,"ABDUCTOR",1,"Ecc04",5600,5560,5300,5350,5580,5325,0.046,255,5452.5,"Ecc",40,-50,FALSE,TRUE,FALSE,4.79,"young",19,160,51,"f"
15,"ABDUCTOR",1,"Ecc05",5620,5600,5350,5350,5610,5350,0.046,260,5480,"Ecc",20,0,FALSE,FALSE,FALSE,4.86,"young",19,160,51,"f"
15,"ABDUCTOR",1,"Ecc06",5040,5040,4850,4750,5040,4800,0.048,240,4920,"Ecc",0,100,FALSE,FALSE,FALSE,5,"young",19,160,51,"f"
15,"ABDUCTOR",1,"Ecc07",4640,4620,4300,4400,4630,4350,0.06,280,4490,"Ecc",20,-100,FALSE,FALSE,FALSE,6.44,"young",19,160,51,"f"
15,"ABDUCTOR",1,"Ecc08",4500,4480,3550,3650,4490,3600,0.198,890,4045,"Ecc",20,-100,TRUE,FALSE,FALSE,24.72,"young",19,160,51,"f"
15,"ABDUCTOR",1,"Ecc09",4520,4520,3700,4250,4520,3975,0.121,545,4247.5,"Ecc",0,-550,TRUE,FALSE,TRUE,13.71,"young",19,160,51,"f"
15,"ABDUCTOR",1,"Ecc10",2680,2700,800,2650,2690,1725,0.359,965,2207.5,"Ecc",-20,-1850,TRUE,FALSE,TRUE,55.94,"young",19,160,51,"f"
15,"ABDUCTOR",2,"Ecc01",4680,4720,4600,4550,4700,4575,0.027,125,4637.5,"Ecc",-40,50,FALSE,TRUE,FALSE,2.73,"young",19,160,51,"f"
15,"ABDUCTOR",2,"Ecc02",4960,4980,4800,4750,4970,4775,0.039,195,4872.5,"Ecc",-20,50,FALSE,FALSE,FALSE,4.08,"young",19,160,51,"f"
15,"ABDUCTOR",2,"Ecc03",5300,5280,5050,5050,5290,5050,0.045,240,5170,"Ecc",20,0,FALSE,FALSE,FALSE,4.75,"young",19,160,51,"f"
15,"ABDUCTOR",2,"Ecc04",4620,4620,4350,4350,4620,4350,0.058,270,4485,"Ecc",0,0,FALSE,FALSE,FALSE,6.21,"young",19,160,51,"f"
15,"ABDUCTOR",2,"Ecc05",4680,4700,4450,4500,4690,4475,0.046,215,4582.5,"Ecc",-20,-50,FALSE,FALSE,FALSE,4.8,"young",19,160,51,"f"
15,"ABDUCTOR",2,"Ecc06",5300,5280,5100,5100,5290,5100,0.036,190,5195,"Ecc",20,0,FALSE,FALSE,FALSE,3.73,"young",19,160,51,"f"
15,"ABDUCTOR",2,"Ecc07",4580,4580,4450,4450,4580,4450,0.028,130,4515,"Ecc",0,0,FALSE,FALSE,FALSE,2.92,"young",19,160,51,"f"
15,"ABDUCTOR",2,"Ecc08",4340,4360,2650,4050,4350,3350,0.23,1000,3850,"Ecc",-20,-1400,TRUE,FALSE,TRUE,29.85,"young",19,160,51,"f"
15,"ABDUCTOR",2,"Ecc09",3780,3780,2950,3000,3780,2975,0.213,805,3377.5,"Ecc",0,-50,TRUE,FALSE,FALSE,27.06,"young",19,160,51,"f"
15,"ABDUCTOR",2,"Ecc10",2340,2300,2300,2300,2320,2300,0.009,20,2310,"Ecc",40,0,FALSE,TRUE,FALSE,0.87,"young",19,160,51,"f"
15,"ABDUCTOR",1,"Rep01",7280,7280,7300,7200,7280,7250,0.004,30,7265,"Rep",0,100,FALSE,FALSE,FALSE,0.41,"young",19,160,51,"f"
15,"ABDUCTOR",1,"Rep02",7240,7220,7200,7350,7230,7275,0.006,-45,7252.5,"Rep",20,-150,FALSE,FALSE,FALSE,0.62,"young",19,160,51,"f"
15,"ABDUCTOR",1,"Rep03",6360,6380,6450,6350,6370,6400,0.005,-30,6385,"Rep",-20,100,FALSE,FALSE,FALSE,0.47,"young",19,160,51,"f"
15,"ABDUCTOR",1,"Rep04",6520,6500,6350,6450,6510,6400,0.017,110,6455,"Rep",20,-100,FALSE,FALSE,FALSE,1.72,"young",19,160,51,"f"
15,"ABDUCTOR",1,"Rep05",6560,6560,6600,6600,6560,6600,0.006,-40,6580,"Rep",0,0,FALSE,FALSE,FALSE,0.61,"young",19,160,51,"f"
15,"ABDUCTOR",1,"Rep06",6200,6200,6250,6150,6200,6200,0,0,6200,"Rep",0,100,FALSE,FALSE,FALSE,0,"young",19,160,51,"f"
15,"ABDUCTOR",1,"Rep07",5620,5620,5500,5650,5620,5575,0.008,45,5597.5,"Rep",0,-150,FALSE,FALSE,FALSE,0.81,"young",19,160,51,"f"
15,"ABDUCTOR",1,"Rep08",5340,5320,4750,4750,5330,4750,0.109,580,5040,"Rep",20,0,TRUE,FALSE,FALSE,12.21,"young",19,160,51,"f"
15,"ABDUCTOR",1,"Rep09",5400,5420,5500,5950,5410,5725,0.058,-315,5567.5,"Rep",-20,-450,TRUE,FALSE,TRUE,5.5,"young",19,160,51,"f"
15,"ABDUCTOR",1,"Rep10",3820,3840,2800,4100,3830,3450,0.099,380,3640,"Rep",-20,-1300,TRUE,FALSE,TRUE,11.01,"young",19,160,51,"f"
15,"ABDUCTOR",2,"Rep01",5900,5900,6000,5950,5900,5975,0.013,-75,5937.5,"Rep",0,50,FALSE,FALSE,FALSE,1.26,"young",19,160,51,"f"
15,"ABDUCTOR",2,"Rep02",6000,6000,5950,5950,6000,5950,0.008,50,5975,"Rep",0,0,FALSE,FALSE,FALSE,0.84,"young",19,160,51,"f"
15,"ABDUCTOR",2,"Rep03",6220,6200,6150,6150,6210,6150,0.01,60,6180,"Rep",20,0,FALSE,FALSE,FALSE,0.98,"young",19,160,51,"f"
15,"ABDUCTOR",2,"Rep04",5520,5520,5500,5550,5520,5525,0.001,-5,5522.5,"Rep",0,-50,FALSE,FALSE,FALSE,0.09,"young",19,160,51,"f"
15,"ABDUCTOR",2,"Rep05",5560,5580,5650,5650,5570,5650,0.014,-80,5610,"Rep",-20,0,FALSE,FALSE,FALSE,1.42,"young",19,160,51,"f"
15,"ABDUCTOR",2,"Rep06",6140,6120,6150,6100,6130,6125,0.001,5,6127.5,"Rep",20,50,FALSE,FALSE,FALSE,0.08,"young",19,160,51,"f"
15,"ABDUCTOR",2,"Rep07",5380,5380,5400,5400,5380,5400,0.004,-20,5390,"Rep",0,0,FALSE,FALSE,FALSE,0.37,"young",19,160,51,"f"
15,"ABDUCTOR",2,"Rep08",5160,5160,3600,5000,5160,4300,0.167,860,4730,"Rep",0,-1400,TRUE,FALSE,TRUE,20,"young",19,160,51,"f"
15,"ABDUCTOR",2,"Rep09",4600,4620,5550,4150,4610,4850,0.052,-240,4730,"Rep",-20,1400,FALSE,FALSE,TRUE,4.95,"young",19,160,51,"f"
15,"ABDUCTOR",2,"Rep10",3380,3340,4100,4150,3360,4125,0.228,-765,3742.5,"Rep",40,-50,TRUE,FALSE,FALSE,18.55,"young",19,160,51,"f"
15,"ABDUCTOR",1,"TuT",60340,60340,58700,60550,60340,59625,0.012,715,59982.5,"TuT",0,-1850,TRUE,FALSE,TRUE,1.2,"young",19,160,51,"f"
15,"ABDUCTOR",2,"TuT",53860,53820,54050,54050,53840,54050,0.004,-210,53945,"TuT",40,0,FALSE,TRUE,FALSE,0.39,"young",19,160,51,"f"
15,"ADDUCTOR",1,"Con01",1760,1780,2500,2500,1770,2500,0.412,-730,2135,"Con",-20,0,TRUE,FALSE,FALSE,29.2,"young",19,160,51,"f"
15,"ADDUCTOR",1,"Con02",1220,1240,1750,1900,1230,1825,0.484,-595,1527.5,"Con",-20,-150,TRUE,FALSE,FALSE,32.6,"young",19,160,51,"f"
15,"ADDUCTOR",1,"Con03",1140,1160,2050,2050,1150,2050,0.783,-900,1600,"Con",-20,0,TRUE,FALSE,FALSE,43.9,"young",19,160,51,"f"
15,"ADDUCTOR",1,"Con04",1320,1340,1850,1900,1330,1875,0.41,-545,1602.5,"Con",-20,-50,FALSE,FALSE,FALSE,29.07,"young",19,160,51,"f"
15,"ADDUCTOR",1,"Con05",1400,1420,1000,1050,1410,1025,0.273,385,1217.5,"Con",-20,-50,FALSE,FALSE,FALSE,37.56,"young",19,160,51,"f"
15,"ADDUCTOR",1,"Con06",1420,1400,2400,2450,1410,2425,0.72,-1015,1917.5,"Con",20,-50,TRUE,FALSE,FALSE,41.86,"young",19,160,51,"f"
15,"ADDUCTOR",1,"Con07",1260,1260,2350,2300,1260,2325,0.845,-1065,1792.5,"Con",0,50,TRUE,FALSE,FALSE,45.81,"young",19,160,51,"f"
15,"ADDUCTOR",1,"Con08",1400,1420,4250,2550,1410,3400,1.411,-1990,2405,"Con",-20,1700,TRUE,FALSE,TRUE,58.53,"young",19,160,51,"f"
15,"ADDUCTOR",1,"Con09",1500,1500,3700,1750,1500,2725,0.817,-1225,2112.5,"Con",0,1950,TRUE,FALSE,TRUE,44.95,"young",19,160,51,"f"
15,"ADDUCTOR",1,"Con10",1280,1300,1800,1700,1290,1750,0.357,-460,1520,"Con",-20,100,FALSE,FALSE,FALSE,26.29,"young",19,160,51,"f"
15,"ADDUCTOR",2,"Con01",1760,1760,3000,2150,1760,2575,0.463,-815,2167.5,"Con",0,850,TRUE,FALSE,TRUE,31.65,"young",19,160,51,"f"
15,"ADDUCTOR",2,"Con02",1240,1260,1600,1100,1250,1350,0.08,-100,1300,"Con",-20,500,FALSE,FALSE,TRUE,7.41,"young",19,160,51,"f"
15,"ADDUCTOR",2,"Con03",1360,1380,2100,2550,1370,2325,0.697,-955,1847.5,"Con",-20,-450,TRUE,FALSE,TRUE,41.08,"young",19,160,51,"f"
15,"ADDUCTOR",2,"Con04",1300,1340,2150,3750,1320,2950,1.235,-1630,2135,"Con",-40,-1600,TRUE,TRUE,TRUE,55.25,"young",19,160,51,"f"
15,"ADDUCTOR",2,"Con05",1500,1500,1700,2650,1500,2175,0.45,-675,1837.5,"Con",0,-950,TRUE,FALSE,TRUE,31.03,"young",19,160,51,"f"
15,"ADDUCTOR",2,"Con06",1220,1240,1900,1650,1230,1775,0.443,-545,1502.5,"Con",-20,250,FALSE,FALSE,FALSE,30.7,"young",19,160,51,"f"
15,"ADDUCTOR",2,"Con07",1240,1260,2350,1650,1250,2000,0.6,-750,1625,"Con",-20,700,TRUE,FALSE,TRUE,37.5,"young",19,160,51,"f"
15,"ADDUCTOR",2,"Con08",1400,1440,2700,1550,1420,2125,0.496,-705,1772.5,"Con",-40,1150,TRUE,TRUE,TRUE,33.18,"young",19,160,51,"f"
15,"ADDUCTOR",2,"Con09",1400,1400,1900,2000,1400,1950,0.393,-550,1675,"Con",0,-100,FALSE,FALSE,FALSE,28.21,"young",19,160,51,"f"
15,"ADDUCTOR",2,"Con10",1280,1300,2100,2200,1290,2150,0.667,-860,1720,"Con",-20,-100,TRUE,FALSE,FALSE,40,"young",19,160,51,"f"
15,"ADDUCTOR",1,"Ecc01",3880,3880,3200,3050,3880,3125,0.195,755,3502.5,"Ecc",0,150,TRUE,FALSE,FALSE,24.16,"young",19,160,51,"f"
15,"ADDUCTOR",1,"Ecc02",4140,4100,3650,3500,4120,3575,0.132,545,3847.5,"Ecc",40,150,FALSE,TRUE,FALSE,15.24,"young",19,160,51,"f"
15,"ADDUCTOR",1,"Ecc03",4420,4380,3400,3500,4400,3450,0.216,950,3925,"Ecc",40,-100,TRUE,TRUE,FALSE,27.54,"young",19,160,51,"f"
15,"ADDUCTOR",1,"Ecc04",4280,4280,3950,3900,4280,3925,0.083,355,4102.5,"Ecc",0,50,FALSE,FALSE,FALSE,9.04,"young",19,160,51,"f"
15,"ADDUCTOR",1,"Ecc05",4760,4760,5050,4950,4760,5000,0.05,-240,4880,"Ecc",0,100,FALSE,FALSE,FALSE,4.8,"young",19,160,51,"f"
15,"ADDUCTOR",1,"Ecc06",4580,4600,3550,3500,4590,3525,0.232,1065,4057.5,"Ecc",-20,50,TRUE,FALSE,FALSE,30.21,"young",19,160,51,"f"
15,"ADDUCTOR",1,"Ecc07",4480,4460,1700,3350,4470,2525,0.435,1945,3497.5,"Ecc",20,-1650,TRUE,FALSE,TRUE,77.03,"young",19,160,51,"f"
15,"ADDUCTOR",1,"Ecc08",4460,4460,1600,3400,4460,2500,0.439,1960,3480,"Ecc",0,-1800,TRUE,FALSE,TRUE,78.4,"young",19,160,51,"f"
15,"ADDUCTOR",1,"Ecc09",4100,4080,3750,4050,4090,3900,0.046,190,3995,"Ecc",20,-300,FALSE,FALSE,FALSE,4.87,"young",19,160,51,"f"
15,"ADDUCTOR",1,"Ecc10",2920,2920,2400,2400,2920,2400,0.178,520,2660,"Ecc",0,0,FALSE,FALSE,FALSE,21.67,"young",19,160,51,"f"
15,"ADDUCTOR",2,"Ecc01",4040,4040,3100,3750,4040,3425,0.152,615,3732.5,"Ecc",0,-650,TRUE,FALSE,TRUE,17.96,"young",19,160,51,"f"
15,"ADDUCTOR",2,"Ecc02",3600,3580,3300,3650,3590,3475,0.032,115,3532.5,"Ecc",20,-350,FALSE,FALSE,TRUE,3.31,"young",19,160,51,"f"
15,"ADDUCTOR",2,"Ecc03",3820,3780,2950,1150,3800,2050,0.461,1750,2925,"Ecc",40,1800,TRUE,TRUE,TRUE,85.37,"young",19,160,51,"f"
15,"ADDUCTOR",2,"Ecc04",3560,3560,2750,2050,3560,2400,0.326,1160,2980,"Ecc",0,700,TRUE,FALSE,TRUE,48.33,"young",19,160,51,"f"
15,"ADDUCTOR",2,"Ecc05",4000,3980,3800,3450,3990,3625,0.091,365,3807.5,"Ecc",20,350,FALSE,FALSE,TRUE,10.07,"young",19,160,51,"f"
15,"ADDUCTOR",2,"Ecc06",3580,3560,2850,3150,3570,3000,0.16,570,3285,"Ecc",20,-300,TRUE,FALSE,FALSE,19,"young",19,160,51,"f"
15,"ADDUCTOR",2,"Ecc07",3920,3880,2200,3500,3900,2850,0.269,1050,3375,"Ecc",40,-1300,TRUE,TRUE,TRUE,36.84,"young",19,160,51,"f"
15,"ADDUCTOR",2,"Ecc08",3940,3940,3350,3750,3940,3550,0.099,390,3745,"Ecc",0,-400,FALSE,FALSE,TRUE,10.99,"young",19,160,51,"f"
15,"ADDUCTOR",2,"Ecc09",3720,3700,3200,3050,3710,3125,0.158,585,3417.5,"Ecc",20,150,TRUE,FALSE,FALSE,18.72,"young",19,160,51,"f"
15,"ADDUCTOR",2,"Ecc10",2460,2460,1650,1700,2460,1675,0.319,785,2067.5,"Ecc",0,-50,TRUE,FALSE,FALSE,46.87,"young",19,160,51,"f"
15,"ADDUCTOR",1,"Rep01",5640,5660,5700,5550,5650,5625,0.004,25,5637.5,"Rep",-20,150,FALSE,FALSE,FALSE,0.44,"young",19,160,51,"f"
15,"ADDUCTOR",1,"Rep02",5360,5340,5400,5400,5350,5400,0.009,-50,5375,"Rep",20,0,FALSE,FALSE,FALSE,0.93,"young",19,160,51,"f"
15,"ADDUCTOR",1,"Rep03",5560,5540,5450,5550,5550,5500,0.009,50,5525,"Rep",20,-100,FALSE,FALSE,FALSE,0.91,"young",19,160,51,"f"
15,"ADDUCTOR",1,"Rep04",5600,5620,5800,5800,5610,5800,0.034,-190,5705,"Rep",-20,0,FALSE,FALSE,FALSE,3.28,"young",19,160,51,"f"
15,"ADDUCTOR",1,"Rep05",6160,6180,6050,6000,6170,6025,0.024,145,6097.5,"Rep",-20,50,FALSE,FALSE,FALSE,2.41,"young",19,160,51,"f"
15,"ADDUCTOR",1,"Rep06",6000,6000,5950,5950,6000,5950,0.008,50,5975,"Rep",0,0,FALSE,FALSE,FALSE,0.84,"young",19,160,51,"f"
15,"ADDUCTOR",1,"Rep07",5740,5720,4050,5650,5730,4850,0.154,880,5290,"Rep",20,-1600,TRUE,FALSE,TRUE,18.14,"young",19,160,51,"f"
15,"ADDUCTOR",1,"Rep08",5860,5880,5850,5950,5870,5900,0.005,-30,5885,"Rep",-20,-100,FALSE,FALSE,FALSE,0.51,"young",19,160,51,"f"
15,"ADDUCTOR",1,"Rep09",5600,5580,7450,5800,5590,6625,0.185,-1035,6107.5,"Rep",20,1650,TRUE,FALSE,TRUE,15.62,"young",19,160,51,"f"
15,"ADDUCTOR",1,"Rep10",4200,4220,4200,4100,4210,4150,0.014,60,4180,"Rep",-20,100,FALSE,FALSE,FALSE,1.45,"young",19,160,51,"f"
15,"ADDUCTOR",2,"Rep01",5800,5800,6100,5900,5800,6000,0.034,-200,5900,"Rep",0,200,FALSE,FALSE,FALSE,3.33,"young",19,160,51,"f"
15,"ADDUCTOR",2,"Rep02",4840,4840,4900,4750,4840,4825,0.003,15,4832.5,"Rep",0,150,FALSE,FALSE,FALSE,0.31,"young",19,160,51,"f"
15,"ADDUCTOR",2,"Rep03",5180,5160,5050,3700,5170,4375,0.154,795,4772.5,"Rep",20,1350,TRUE,FALSE,TRUE,18.17,"young",19,160,51,"f"
15,"ADDUCTOR",2,"Rep04",4860,4900,4900,5800,4880,5350,0.096,-470,5115,"Rep",-40,-900,TRUE,FALSE,TRUE,8.79,"young",19,160,51,"f"
15,"ADDUCTOR",2,"Rep05",5500,5480,5500,6100,5490,5800,0.056,-310,5645,"Rep",20,-600,FALSE,FALSE,TRUE,5.34,"young",19,160,51,"f"
15,"ADDUCTOR",2,"Rep06",4800,4800,4750,4800,4800,4775,0.005,25,4787.5,"Rep",0,-50,FALSE,FALSE,FALSE,0.52,"young",19,160,51,"f"
15,"ADDUCTOR",2,"Rep07",5160,5140,4550,5150,5150,4850,0.058,300,5000,"Rep",20,-600,FALSE,FALSE,TRUE,6.19,"young",19,160,51,"f"
15,"ADDUCTOR",2,"Rep08",5340,5380,6050,5300,5360,5675,0.059,-315,5517.5,"Rep",-40,750,FALSE,FALSE,TRUE,5.55,"young",19,160,51,"f"
15,"ADDUCTOR",2,"Rep09",5120,5100,5100,5050,5110,5075,0.007,35,5092.5,"Rep",20,50,FALSE,FALSE,FALSE,0.69,"young",19,160,51,"f"
15,"ADDUCTOR",2,"Rep10",3740,3760,3750,3900,3750,3825,0.02,-75,3787.5,"Rep",-20,-150,FALSE,FALSE,FALSE,1.96,"young",19,160,51,"f"
15,"ADDUCTOR",1,"TuT",55720,55740,55900,55750,55730,55825,0.002,-95,55777.5,"TuT",-20,150,FALSE,FALSE,FALSE,0.17,"young",19,160,51,"f"
15,"ADDUCTOR",2,"TuT",50340,50360,50650,50450,50350,50550,0.004,-200,50450,"TuT",-20,200,FALSE,FALSE,FALSE,0.4,"young",19,160,51,"f"
15,"LOWER BACK",1,"Con01",1740,1780,1900,2350,1760,2125,0.207,-365,1942.5,"Con",-40,-450,TRUE,TRUE,TRUE,17.18,"young",19,160,51,"f"
15,"LOWER BACK",1,"Con02",1840,1880,1950,1850,1860,1900,0.022,-40,1880,"Con",-40,100,FALSE,TRUE,FALSE,2.11,"young",19,160,51,"f"
15,"LOWER BACK",1,"Con03",2280,2340,2550,2450,2310,2500,0.082,-190,2405,"Con",-60,100,TRUE,TRUE,FALSE,7.6,"young",19,160,51,"f"
15,"LOWER BACK",1,"Con04",2320,2320,2500,2500,2320,2500,0.078,-180,2410,"Con",0,0,FALSE,FALSE,FALSE,7.2,"young",19,160,51,"f"
15,"LOWER BACK",1,"Con05",1960,2000,2100,2200,1980,2150,0.086,-170,2065,"Con",-40,-100,FALSE,TRUE,FALSE,7.91,"young",19,160,51,"f"
15,"LOWER BACK",1,"Con06",2060,2080,2150,2200,2070,2175,0.051,-105,2122.5,"Con",-20,-50,FALSE,FALSE,FALSE,4.83,"young",19,160,51,"f"
15,"LOWER BACK",1,"Con07",2020,2000,2200,2200,2010,2200,0.095,-190,2105,"Con",20,0,TRUE,FALSE,FALSE,8.64,"young",19,160,51,"f"
15,"LOWER BACK",1,"Con08",2260,2280,2500,2550,2270,2525,0.112,-255,2397.5,"Con",-20,-50,TRUE,FALSE,FALSE,10.1,"young",19,160,51,"f"
15,"LOWER BACK",1,"Con09",2060,2080,2550,2350,2070,2450,0.184,-380,2260,"Con",-20,200,TRUE,FALSE,TRUE,15.51,"young",19,160,51,"f"
15,"LOWER BACK",1,"Con10",2620,2640,3050,3200,2630,3125,0.188,-495,2877.5,"Con",-20,-150,TRUE,FALSE,FALSE,15.84,"young",19,160,51,"f"
15,"LOWER BACK",2,"Con01",1900,1940,2650,2400,1920,2525,0.315,-605,2222.5,"Con",-40,250,TRUE,TRUE,TRUE,23.96,"young",19,160,51,"f"
15,"LOWER BACK",2,"Con02",2140,2160,2250,2250,2150,2250,0.047,-100,2200,"Con",-20,0,FALSE,FALSE,FALSE,4.44,"young",19,160,51,"f"
15,"LOWER BACK",2,"Con03",2060,2060,2100,2050,2060,2075,0.007,-15,2067.5,"Con",0,50,FALSE,FALSE,FALSE,0.72,"young",19,160,51,"f"
15,"LOWER BACK",2,"Con04",1940,1980,2100,2000,1960,2050,0.046,-90,2005,"Con",-40,100,FALSE,TRUE,FALSE,4.39,"young",19,160,51,"f"
15,"LOWER BACK",2,"Con05",1860,1860,2550,2700,1860,2625,0.411,-765,2242.5,"Con",0,-150,TRUE,FALSE,FALSE,29.14,"young",19,160,51,"f"
15,"LOWER BACK",2,"Con06",1920,1940,2150,2150,1930,2150,0.114,-220,2040,"Con",-20,0,TRUE,FALSE,FALSE,10.23,"young",19,160,51,"f"
15,"LOWER BACK",2,"Con07",2080,2100,2400,2500,2090,2450,0.172,-360,2270,"Con",-20,-100,TRUE,FALSE,FALSE,14.69,"young",19,160,51,"f"
15,"LOWER BACK",2,"Con08",2120,2100,2350,2550,2110,2450,0.161,-340,2280,"Con",20,-200,TRUE,FALSE,TRUE,13.88,"young",19,160,51,"f"
15,"LOWER BACK",2,"Con09",2000,2000,2400,2900,2000,2650,0.325,-650,2325,"Con",0,-500,TRUE,FALSE,TRUE,24.53,"young",19,160,51,"f"
15,"LOWER BACK",2,"Con10",2180,2160,2450,2550,2170,2500,0.152,-330,2335,"Con",20,-100,TRUE,FALSE,FALSE,13.2,"young",19,160,51,"f"
15,"LOWER BACK",1,"Ecc01",5740,5720,5600,5700,5730,5650,0.014,80,5690,"Ecc",20,-100,FALSE,FALSE,FALSE,1.42,"young",19,160,51,"f"
15,"LOWER BACK",1,"Ecc02",5360,5320,5200,5250,5340,5225,0.022,115,5282.5,"Ecc",40,-50,FALSE,FALSE,FALSE,2.2,"young",19,160,51,"f"
15,"LOWER BACK",1,"Ecc03",5620,5560,5300,5450,5590,5375,0.038,215,5482.5,"Ecc",60,-150,TRUE,FALSE,FALSE,4,"young",19,160,51,"f"
15,"LOWER BACK",1,"Ecc04",5080,5080,4950,4850,5080,4900,0.035,180,4990,"Ecc",0,100,TRUE,FALSE,FALSE,3.67,"young",19,160,51,"f"
15,"LOWER BACK",1,"Ecc05",4780,4740,4700,4600,4760,4650,0.023,110,4705,"Ecc",40,100,FALSE,FALSE,FALSE,2.37,"young",19,160,51,"f"
15,"LOWER BACK",1,"Ecc06",4720,4700,4500,4550,4710,4525,0.039,185,4617.5,"Ecc",20,-50,TRUE,FALSE,FALSE,4.09,"young",19,160,51,"f"
15,"LOWER BACK",1,"Ecc07",5780,5800,5650,5550,5790,5600,0.033,190,5695,"Ecc",-20,100,TRUE,FALSE,FALSE,3.39,"young",19,160,51,"f"
15,"LOWER BACK",1,"Ecc08",5120,5120,4700,4850,5120,4775,0.067,345,4947.5,"Ecc",0,-150,TRUE,FALSE,FALSE,7.23,"young",19,160,51,"f"
15,"LOWER BACK",1,"Ecc09",5340,5300,4900,4950,5320,4925,0.074,395,5122.5,"Ecc",40,-50,TRUE,FALSE,FALSE,8.02,"young",19,160,51,"f"
15,"LOWER BACK",1,"Ecc10",3200,3220,3100,2950,3210,3025,0.058,185,3117.5,"Ecc",-20,150,TRUE,FALSE,FALSE,6.12,"young",19,160,51,"f"
15,"LOWER BACK",2,"Ecc01",5460,5460,5300,5250,5460,5275,0.034,185,5367.5,"Ecc",0,50,TRUE,FALSE,FALSE,3.51,"young",19,160,51,"f"
15,"LOWER BACK",2,"Ecc02",6180,6180,6100,6150,6180,6125,0.009,55,6152.5,"Ecc",0,-50,FALSE,FALSE,FALSE,0.9,"young",19,160,51,"f"
15,"LOWER BACK",2,"Ecc03",5580,5560,5450,5550,5570,5500,0.013,70,5535,"Ecc",20,-100,FALSE,FALSE,FALSE,1.27,"young",19,160,51,"f"
15,"LOWER BACK",2,"Ecc04",5260,5220,5100,5100,5240,5100,0.027,140,5170,"Ecc",40,0,FALSE,FALSE,FALSE,2.75,"young",19,160,51,"f"
15,"LOWER BACK",2,"Ecc05",5120,5120,4400,4250,5120,4325,0.155,795,4722.5,"Ecc",0,150,TRUE,FALSE,FALSE,18.38,"young",19,160,51,"f"
15,"LOWER BACK",2,"Ecc06",4380,4380,4100,4100,4380,4100,0.064,280,4240,"Ecc",0,0,TRUE,FALSE,FALSE,6.83,"young",19,160,51,"f"
15,"LOWER BACK",2,"Ecc07",4980,4940,4700,4500,4960,4600,0.073,360,4780,"Ecc",40,200,TRUE,FALSE,TRUE,7.83,"young",19,160,51,"f"
15,"LOWER BACK",2,"Ecc08",4440,4460,4200,4100,4450,4150,0.067,300,4300,"Ecc",-20,100,TRUE,FALSE,FALSE,7.23,"young",19,160,51,"f"
15,"LOWER BACK",2,"Ecc09",4500,4520,4100,3550,4510,3825,0.152,685,4167.5,"Ecc",-20,550,TRUE,FALSE,TRUE,17.91,"young",19,160,51,"f"
15,"LOWER BACK",2,"Ecc10",3460,3460,3400,3300,3460,3350,0.032,110,3405,"Ecc",0,100,FALSE,FALSE,FALSE,3.28,"young",19,160,51,"f"
15,"LOWER BACK",1,"Rep01",7480,7500,7500,8050,7490,7775,0.038,-285,7632.5,"Rep",-20,-550,TRUE,FALSE,TRUE,3.67,"young",19,160,51,"f"
15,"LOWER BACK",1,"Rep02",7200,7200,7150,7100,7200,7125,0.01,75,7162.5,"Rep",0,50,FALSE,FALSE,FALSE,1.05,"young",19,160,51,"f"
15,"LOWER BACK",1,"Rep03",7900,7900,7850,7900,7900,7875,0.003,25,7887.5,"Rep",0,-50,FALSE,FALSE,FALSE,0.32,"young",19,160,51,"f"
15,"LOWER BACK",1,"Rep04",7400,7400,7450,7350,7400,7400,0,0,7400,"Rep",0,100,FALSE,FALSE,FALSE,0,"young",19,160,51,"f"
15,"LOWER BACK",1,"Rep05",6740,6740,6800,6800,6740,6800,0.009,-60,6770,"Rep",0,0,FALSE,FALSE,FALSE,0.88,"young",19,160,51,"f"
15,"LOWER BACK",1,"Rep06",6780,6780,6650,6750,6780,6700,0.012,80,6740,"Rep",0,-100,FALSE,FALSE,FALSE,1.19,"young",19,160,51,"f"
15,"LOWER BACK",1,"Rep07",7800,7800,7850,7750,7800,7800,0,0,7800,"Rep",0,100,FALSE,FALSE,FALSE,0,"young",19,160,51,"f"
15,"LOWER BACK",1,"Rep08",7380,7400,7200,7400,7390,7300,0.012,90,7345,"Rep",-20,-200,FALSE,FALSE,TRUE,1.23,"young",19,160,51,"f"
15,"LOWER BACK",1,"Rep09",7400,7380,7450,7300,7390,7375,0.002,15,7382.5,"Rep",20,150,FALSE,FALSE,FALSE,0.2,"young",19,160,51,"f"
15,"LOWER BACK",1,"Rep10",5820,5860,6150,6150,5840,6150,0.053,-310,5995,"Rep",-40,0,TRUE,FALSE,FALSE,5.04,"young",19,160,51,"f"
15,"LOWER BACK",2,"Rep01",7360,7400,7950,7650,7380,7800,0.057,-420,7590,"Rep",-40,300,TRUE,FALSE,TRUE,5.38,"young",19,160,51,"f"
15,"LOWER BACK",2,"Rep02",8320,8340,8350,8400,8330,8375,0.005,-45,8352.5,"Rep",-20,-50,FALSE,FALSE,FALSE,0.54,"young",19,160,51,"f"
15,"LOWER BACK",2,"Rep03",7640,7620,7550,7600,7630,7575,0.007,55,7602.5,"Rep",20,-50,FALSE,FALSE,FALSE,0.73,"young",19,160,51,"f"
15,"LOWER BACK",2,"Rep04",7200,7200,7200,7100,7200,7150,0.007,50,7175,"Rep",0,100,FALSE,FALSE,FALSE,0.7,"young",19,160,51,"f"
15,"LOWER BACK",2,"Rep05",6980,6980,6950,6950,6980,6950,0.004,30,6965,"Rep",0,0,FALSE,FALSE,FALSE,0.43,"young",19,160,51,"f"
15,"LOWER BACK",2,"Rep06",6300,6320,6250,6250,6310,6250,0.01,60,6280,"Rep",-20,0,FALSE,FALSE,FALSE,0.96,"young",19,160,51,"f"
15,"LOWER BACK",2,"Rep07",7060,7040,7100,7000,7050,7050,0,0,7050,"Rep",20,100,FALSE,FALSE,FALSE,0,"young",19,160,51,"f"
15,"LOWER BACK",2,"Rep08",6560,6560,6550,6650,6560,6600,0.006,-40,6580,"Rep",0,-100,FALSE,FALSE,FALSE,0.61,"young",19,160,51,"f"
15,"LOWER BACK",2,"Rep09",6500,6520,6500,6450,6510,6475,0.005,35,6492.5,"Rep",-20,50,FALSE,FALSE,FALSE,0.54,"young",19,160,51,"f"
15,"LOWER BACK",2,"Rep10",5640,5620,5850,5850,5630,5850,0.039,-220,5740,"Rep",20,0,TRUE,FALSE,FALSE,3.76,"young",19,160,51,"f"
15,"LOWER BACK",1,"TuT",71900,71960,72050,72550,71930,72300,0.005,-370,72115,"TuT",-60,-500,TRUE,FALSE,TRUE,0.51,"young",19,160,51,"f"
15,"LOWER BACK",2,"TuT",69560,69600,70250,69900,69580,70075,0.007,-495,69827.5,"TuT",-40,350,TRUE,FALSE,TRUE,0.71,"young",19,160,51,"f"
15,"TOTAL ABDOMINAL",1,"Con01",2280,2280,2700,2950,2280,2825,0.239,-545,2552.5,"Con",0,-250,TRUE,FALSE,TRUE,19.29,"young",19,160,51,"f"
15,"TOTAL ABDOMINAL",1,"Con02",2700,2720,2800,2750,2710,2775,0.024,-65,2742.5,"Con",-20,50,FALSE,FALSE,FALSE,2.34,"young",19,160,51,"f"
15,"TOTAL ABDOMINAL",1,"Con03",2440,2440,2400,2500,2440,2450,0.004,-10,2445,"Con",0,-100,FALSE,FALSE,FALSE,0.41,"young",19,160,51,"f"
15,"TOTAL ABDOMINAL",1,"Con04",2040,2020,2050,2050,2030,2050,0.01,-20,2040,"Con",20,0,FALSE,FALSE,FALSE,0.98,"young",19,160,51,"f"
15,"TOTAL ABDOMINAL",1,"Con05",2040,2060,2150,2250,2050,2200,0.073,-150,2125,"Con",-20,-100,TRUE,FALSE,FALSE,6.82,"young",19,160,51,"f"
15,"TOTAL ABDOMINAL",1,"Con06",2280,2300,2450,2400,2290,2425,0.059,-135,2357.5,"Con",-20,50,FALSE,FALSE,FALSE,5.57,"young",19,160,51,"f"
15,"TOTAL ABDOMINAL",1,"Con07",2300,2340,3650,2650,2320,3150,0.358,-830,2735,"Con",-40,1000,TRUE,TRUE,TRUE,26.35,"young",19,160,51,"f"
15,"TOTAL ABDOMINAL",1,"Con08",2220,2220,3300,3100,2220,3200,0.441,-980,2710,"Con",0,200,TRUE,FALSE,TRUE,30.63,"young",19,160,51,"f"
15,"TOTAL ABDOMINAL",1,"Con09",2400,2440,2950,3100,2420,3025,0.25,-605,2722.5,"Con",-40,-150,TRUE,TRUE,FALSE,20,"young",19,160,51,"f"
15,"TOTAL ABDOMINAL",1,"Con10",2400,2480,2900,3100,2440,3000,0.23,-560,2720,"Con",-80,-200,TRUE,TRUE,TRUE,18.67,"young",19,160,51,"f"
15,"TOTAL ABDOMINAL",2,"Con01",2380,2420,3150,2550,2400,2850,0.188,-450,2625,"Con",-40,600,TRUE,TRUE,TRUE,15.79,"young",19,160,51,"f"
15,"TOTAL ABDOMINAL",2,"Con02",2240,2240,2350,2300,2240,2325,0.038,-85,2282.5,"Con",0,50,FALSE,FALSE,FALSE,3.66,"young",19,160,51,"f"
15,"TOTAL ABDOMINAL",2,"Con03",2100,2120,2250,2300,2110,2275,0.078,-165,2192.5,"Con",-20,-50,TRUE,FALSE,FALSE,7.25,"young",19,160,51,"f"
15,"TOTAL ABDOMINAL",2,"Con04",2220,2160,2250,2350,2190,2300,0.05,-110,2245,"Con",60,-100,FALSE,TRUE,FALSE,4.78,"young",19,160,51,"f"
15,"TOTAL ABDOMINAL",2,"Con05",2600,2600,3000,2800,2600,2900,0.115,-300,2750,"Con",0,200,TRUE,FALSE,TRUE,10.34,"young",19,160,51,"f"
15,"TOTAL ABDOMINAL",2,"Con06",1940,1920,2100,2050,1930,2075,0.075,-145,2002.5,"Con",20,50,TRUE,FALSE,FALSE,6.99,"young",19,160,51,"f"
15,"TOTAL ABDOMINAL",2,"Con07",2160,2200,2550,2500,2180,2525,0.158,-345,2352.5,"Con",-40,50,TRUE,TRUE,FALSE,13.66,"young",19,160,51,"f"
15,"TOTAL ABDOMINAL",2,"Con08",2660,2620,2900,2800,2640,2850,0.08,-210,2745,"Con",40,100,TRUE,TRUE,FALSE,7.37,"young",19,160,51,"f"
15,"TOTAL ABDOMINAL",2,"Con09",2460,2480,2700,2750,2470,2725,0.103,-255,2597.5,"Con",-20,-50,TRUE,FALSE,FALSE,9.36,"young",19,160,51,"f"
15,"TOTAL ABDOMINAL",2,"Con10",2040,2060,2550,2800,2050,2675,0.305,-625,2362.5,"Con",-20,-250,TRUE,FALSE,TRUE,23.36,"young",19,160,51,"f"
15,"TOTAL ABDOMINAL",1,"Ecc01",3440,3480,3300,3250,3460,3275,0.053,185,3367.5,"Ecc",-40,50,TRUE,TRUE,FALSE,5.65,"young",19,160,51,"f"
15,"TOTAL ABDOMINAL",1,"Ecc02",5140,5140,5100,5150,5140,5125,0.003,15,5132.5,"Ecc",0,-50,FALSE,FALSE,FALSE,0.29,"young",19,160,51,"f"
15,"TOTAL ABDOMINAL",1,"Ecc03",4540,4520,4550,4450,4530,4500,0.007,30,4515,"Ecc",20,100,FALSE,FALSE,FALSE,0.67,"young",19,160,51,"f"
15,"TOTAL ABDOMINAL",1,"Ecc04",4960,4980,4950,4900,4970,4925,0.009,45,4947.5,"Ecc",-20,50,FALSE,FALSE,FALSE,0.91,"young",19,160,51,"f"
15,"TOTAL ABDOMINAL",1,"Ecc05",4980,4980,4800,4800,4980,4800,0.036,180,4890,"Ecc",0,0,TRUE,FALSE,FALSE,3.75,"young",19,160,51,"f"
15,"TOTAL ABDOMINAL",1,"Ecc06",4480,4440,4200,4250,4460,4225,0.053,235,4342.5,"Ecc",40,-50,TRUE,TRUE,FALSE,5.56,"young",19,160,51,"f"
15,"TOTAL ABDOMINAL",1,"Ecc07",4860,4820,3300,4450,4840,3875,0.199,965,4357.5,"Ecc",40,-1150,TRUE,TRUE,TRUE,24.9,"young",19,160,51,"f"
15,"TOTAL ABDOMINAL",1,"Ecc08",4460,4460,3550,3550,4460,3550,0.204,910,4005,"Ecc",0,0,TRUE,FALSE,FALSE,25.63,"young",19,160,51,"f"
15,"TOTAL ABDOMINAL",1,"Ecc09",4120,4060,3550,3250,4090,3400,0.169,690,3745,"Ecc",60,300,TRUE,TRUE,TRUE,20.29,"young",19,160,51,"f"
15,"TOTAL ABDOMINAL",1,"Ecc10",3180,3180,3200,2950,3180,3075,0.033,105,3127.5,"Ecc",0,250,FALSE,FALSE,TRUE,3.41,"young",19,160,51,"f"
15,"TOTAL ABDOMINAL",2,"Ecc01",3100,3060,3100,3050,3080,3075,0.002,5,3077.5,"Ecc",40,50,FALSE,TRUE,FALSE,0.16,"young",19,160,51,"f"
15,"TOTAL ABDOMINAL",2,"Ecc02",3900,3900,3750,3800,3900,3775,0.032,125,3837.5,"Ecc",0,-50,FALSE,FALSE,FALSE,3.31,"young",19,160,51,"f"
15,"TOTAL ABDOMINAL",2,"Ecc03",4340,4340,4250,4100,4340,4175,0.038,165,4257.5,"Ecc",0,150,TRUE,FALSE,FALSE,3.95,"young",19,160,51,"f"
15,"TOTAL ABDOMINAL",2,"Ecc04",3840,3900,3700,3750,3870,3725,0.037,145,3797.5,"Ecc",-60,-50,TRUE,TRUE,FALSE,3.89,"young",19,160,51,"f"
15,"TOTAL ABDOMINAL",2,"Ecc05",4420,4420,4050,4250,4420,4150,0.061,270,4285,"Ecc",0,-200,TRUE,FALSE,TRUE,6.51,"young",19,160,51,"f"
15,"TOTAL ABDOMINAL",2,"Ecc06",4240,4240,4000,4000,4240,4000,0.057,240,4120,"Ecc",0,0,TRUE,FALSE,FALSE,6,"young",19,160,51,"f"
15,"TOTAL ABDOMINAL",2,"Ecc07",4880,4880,4550,4650,4880,4600,0.057,280,4740,"Ecc",0,-100,TRUE,FALSE,FALSE,6.09,"young",19,160,51,"f"
15,"TOTAL ABDOMINAL",2,"Ecc08",5260,5280,5000,5050,5270,5025,0.046,245,5147.5,"Ecc",-20,-50,TRUE,FALSE,FALSE,4.88,"young",19,160,51,"f"
15,"TOTAL ABDOMINAL",2,"Ecc09",4400,4360,4050,3750,4380,3900,0.11,480,4140,"Ecc",40,300,TRUE,TRUE,TRUE,12.31,"young",19,160,51,"f"
15,"TOTAL ABDOMINAL",2,"Ecc10",3500,3500,3300,3300,3500,3300,0.057,200,3400,"Ecc",0,0,TRUE,FALSE,FALSE,6.06,"young",19,160,51,"f"
15,"TOTAL ABDOMINAL",1,"Rep01",5720,5760,6000,6200,5740,6100,0.063,-360,5920,"Rep",-40,-200,TRUE,FALSE,TRUE,5.9,"young",19,160,51,"f"
15,"TOTAL ABDOMINAL",1,"Rep02",7840,7860,7900,7900,7850,7900,0.006,-50,7875,"Rep",-20,0,FALSE,FALSE,FALSE,0.63,"young",19,160,51,"f"
15,"TOTAL ABDOMINAL",1,"Rep03",6980,6960,6950,6950,6970,6950,0.003,20,6960,"Rep",20,0,FALSE,FALSE,FALSE,0.29,"young",19,160,51,"f"
15,"TOTAL ABDOMINAL",1,"Rep04",7000,7000,7000,6950,7000,6975,0.004,25,6987.5,"Rep",0,50,FALSE,FALSE,FALSE,0.36,"young",19,160,51,"f"
15,"TOTAL ABDOMINAL",1,"Rep05",7020,7040,6950,7050,7030,7000,0.004,30,7015,"Rep",-20,-100,FALSE,FALSE,FALSE,0.43,"young",19,160,51,"f"
15,"TOTAL ABDOMINAL",1,"Rep06",6760,6740,6650,6650,6750,6650,0.015,100,6700,"Rep",20,0,FALSE,FALSE,FALSE,1.5,"young",19,160,51,"f"
15,"TOTAL ABDOMINAL",1,"Rep07",7160,7160,6950,7100,7160,7025,0.019,135,7092.5,"Rep",0,-150,TRUE,FALSE,FALSE,1.92,"young",19,160,51,"f"
15,"TOTAL ABDOMINAL",1,"Rep08",6680,6680,6850,6650,6680,6750,0.01,-70,6715,"Rep",0,200,FALSE,FALSE,TRUE,1.04,"young",19,160,51,"f"
15,"TOTAL ABDOMINAL",1,"Rep09",6520,6500,6500,6350,6510,6425,0.013,85,6467.5,"Rep",20,150,FALSE,FALSE,FALSE,1.32,"young",19,160,51,"f"
15,"TOTAL ABDOMINAL",1,"Rep10",5580,5660,6100,6050,5620,6075,0.081,-455,5847.5,"Rep",-80,50,TRUE,TRUE,FALSE,7.49,"young",19,160,51,"f"
15,"TOTAL ABDOMINAL",2,"Rep01",5480,5480,6250,5600,5480,5925,0.081,-445,5702.5,"Rep",0,650,TRUE,FALSE,TRUE,7.51,"young",19,160,51,"f"
15,"TOTAL ABDOMINAL",2,"Rep02",6140,6140,6100,6100,6140,6100,0.007,40,6120,"Rep",0,0,FALSE,FALSE,FALSE,0.66,"young",19,160,51,"f"
15,"TOTAL ABDOMINAL",2,"Rep03",6440,6460,6500,6400,6450,6450,0,0,6450,"Rep",-20,100,FALSE,FALSE,FALSE,0,"young",19,160,51,"f"
15,"TOTAL ABDOMINAL",2,"Rep04",6060,6060,5950,6100,6060,6025,0.006,35,6042.5,"Rep",0,-150,FALSE,FALSE,FALSE,0.58,"young",19,160,51,"f"
15,"TOTAL ABDOMINAL",2,"Rep05",7020,7020,7050,7050,7020,7050,0.004,-30,7035,"Rep",0,0,FALSE,FALSE,FALSE,0.43,"young",19,160,51,"f"
15,"TOTAL ABDOMINAL",2,"Rep06",6180,6160,6100,6050,6170,6075,0.015,95,6122.5,"Rep",20,50,FALSE,FALSE,FALSE,1.56,"young",19,160,51,"f"
15,"TOTAL ABDOMINAL",2,"Rep07",7040,7080,7100,7150,7060,7125,0.009,-65,7092.5,"Rep",-40,-50,FALSE,FALSE,FALSE,0.91,"young",19,160,51,"f"
15,"TOTAL ABDOMINAL",2,"Rep08",7920,7900,7900,7850,7910,7875,0.004,35,7892.5,"Rep",20,50,FALSE,FALSE,FALSE,0.44,"young",19,160,51,"f"
15,"TOTAL ABDOMINAL",2,"Rep09",6860,6840,6750,6500,6850,6625,0.033,225,6737.5,"Rep",20,250,TRUE,FALSE,TRUE,3.4,"young",19,160,51,"f"
15,"TOTAL ABDOMINAL",2,"Rep10",5540,5560,5850,6100,5550,5975,0.077,-425,5762.5,"Rep",-20,-250,TRUE,FALSE,TRUE,7.11,"young",19,160,51,"f"
15,"TOTAL ABDOMINAL",1,"TuT",67260,67360,67850,67850,67310,67850,0.008,-540,67580,"TuT",-100,0,TRUE,TRUE,FALSE,0.8,"young",19,160,51,"f"
15,"TOTAL ABDOMINAL",2,"TuT",64680,64700,65550,64900,64690,65225,0.008,-535,64957.5,"TuT",-20,650,TRUE,FALSE,TRUE,0.82,"young",19,160,51,"f"
15,"VERTICAL TRACTION",1,"Con01",2480,2500,2650,5500,2490,4075,0.637,-1585,3282.5,"Con",-20,-2850,TRUE,FALSE,TRUE,38.9,"young",19,160,51,"f"
15,"VERTICAL TRACTION",1,"Con02",1800,1860,2050,2600,1830,2325,0.27,-495,2077.5,"Con",-60,-550,TRUE,FALSE,TRUE,21.29,"young",19,160,51,"f"
15,"VERTICAL TRACTION",1,"Con03",1840,1840,1950,2050,1840,2000,0.087,-160,1920,"Con",0,-100,FALSE,FALSE,FALSE,8,"young",19,160,51,"f"
15,"VERTICAL TRACTION",1,"Con04",1720,1700,1850,2050,1710,1950,0.14,-240,1830,"Con",20,-200,FALSE,FALSE,TRUE,12.31,"young",19,160,51,"f"
15,"VERTICAL TRACTION",1,"Con05",1640,1620,1850,2000,1630,1925,0.181,-295,1777.5,"Con",20,-150,TRUE,FALSE,FALSE,15.32,"young",19,160,51,"f"
15,"VERTICAL TRACTION",1,"Con06",1820,1820,2250,1850,1820,2050,0.126,-230,1935,"Con",0,400,FALSE,FALSE,TRUE,11.22,"young",19,160,51,"f"
15,"VERTICAL TRACTION",1,"Con07",1980,1980,2250,2050,1980,2150,0.086,-170,2065,"Con",0,200,FALSE,FALSE,TRUE,7.91,"young",19,160,51,"f"
15,"VERTICAL TRACTION",1,"Con08",1740,1760,3250,2250,1750,2750,0.571,-1000,2250,"Con",-20,1000,TRUE,FALSE,TRUE,36.36,"young",19,160,51,"f"
15,"VERTICAL TRACTION",1,"Con09",1860,1860,3500,2050,1860,2775,0.492,-915,2317.5,"Con",0,1450,TRUE,FALSE,TRUE,32.97,"young",19,160,51,"f"
15,"VERTICAL TRACTION",1,"Con10",2000,2040,2600,2250,2020,2425,0.2,-405,2222.5,"Con",-40,350,TRUE,FALSE,TRUE,16.7,"young",19,160,51,"f"
15,"VERTICAL TRACTION",2,"Con01",2440,2460,850,3600,2450,2225,0.092,225,2337.5,"Con",-20,-2750,FALSE,FALSE,TRUE,10.11,"young",19,160,51,"f"
15,"VERTICAL TRACTION",2,"Con02",1700,1700,2650,2650,1700,2650,0.559,-950,2175,"Con",0,0,TRUE,FALSE,FALSE,35.85,"young",19,160,51,"f"
15,"VERTICAL TRACTION",2,"Con03",2020,2040,1850,1900,2030,1875,0.076,155,1952.5,"Con",-20,-50,FALSE,FALSE,FALSE,8.27,"young",19,160,51,"f"
15,"VERTICAL TRACTION",2,"Con04",1900,1940,2050,2050,1920,2050,0.068,-130,1985,"Con",-40,0,FALSE,FALSE,FALSE,6.34,"young",19,160,51,"f"
15,"VERTICAL TRACTION",2,"Con05",1660,1680,2150,2000,1670,2075,0.243,-405,1872.5,"Con",-20,150,TRUE,FALSE,FALSE,19.52,"young",19,160,51,"f"
15,"VERTICAL TRACTION",2,"Con06",1820,1840,1850,1800,1830,1825,0.003,5,1827.5,"Con",-20,50,FALSE,FALSE,FALSE,0.27,"young",19,160,51,"f"
15,"VERTICAL TRACTION",2,"Con07",1620,1620,2000,2050,1620,2025,0.25,-405,1822.5,"Con",0,-50,TRUE,FALSE,FALSE,20,"young",19,160,51,"f"
15,"VERTICAL TRACTION",2,"Con08",1640,1660,1900,3000,1650,2450,0.485,-800,2050,"Con",-20,-1100,TRUE,FALSE,TRUE,32.65,"young",19,160,51,"f"
15,"VERTICAL TRACTION",2,"Con09",1620,1640,3200,3550,1630,3375,1.071,-1745,2502.5,"Con",-20,-350,TRUE,FALSE,TRUE,51.7,"young",19,160,51,"f"
15,"VERTICAL TRACTION",2,"Con10",1740,1780,3250,3400,1760,3325,0.889,-1565,2542.5,"Con",-40,-150,TRUE,FALSE,FALSE,47.07,"young",19,160,51,"f"
15,"VERTICAL TRACTION",1,"Ecc01",5900,5860,5700,2850,5880,4275,0.273,1605,5077.5,"Ecc",40,2850,TRUE,FALSE,TRUE,37.54,"young",19,160,51,"f"
15,"VERTICAL TRACTION",1,"Ecc02",5980,5960,5800,5750,5970,5775,0.033,195,5872.5,"Ecc",20,50,FALSE,FALSE,FALSE,3.38,"young",19,160,51,"f"
15,"VERTICAL TRACTION",1,"Ecc03",6160,6160,6050,5750,6160,5900,0.042,260,6030,"Ecc",0,300,FALSE,FALSE,TRUE,4.41,"young",19,160,51,"f"
15,"VERTICAL TRACTION",1,"Ecc04",5820,5840,5650,5950,5830,5800,0.005,30,5815,"Ecc",-20,-300,FALSE,FALSE,TRUE,0.52,"young",19,160,51,"f"
15,"VERTICAL TRACTION",1,"Ecc05",6380,6380,6050,5550,6380,5800,0.091,580,6090,"Ecc",0,500,TRUE,FALSE,TRUE,10,"young",19,160,51,"f"
15,"VERTICAL TRACTION",1,"Ecc06",6220,6240,5850,6150,6230,6000,0.037,230,6115,"Ecc",-20,-300,FALSE,FALSE,TRUE,3.83,"young",19,160,51,"f"
15,"VERTICAL TRACTION",1,"Ecc07",5940,5940,5700,6000,5940,5850,0.015,90,5895,"Ecc",0,-300,FALSE,FALSE,TRUE,1.54,"young",19,160,51,"f"
15,"VERTICAL TRACTION",1,"Ecc08",6580,6560,4900,5600,6570,5250,0.201,1320,5910,"Ecc",20,-700,TRUE,FALSE,TRUE,25.14,"young",19,160,51,"f"
15,"VERTICAL TRACTION",1,"Ecc09",6000,5940,4250,6300,5970,5275,0.116,695,5622.5,"Ecc",60,-2050,TRUE,FALSE,TRUE,13.18,"young",19,160,51,"f"
15,"VERTICAL TRACTION",1,"Ecc10",5940,5960,5800,5450,5950,5625,0.055,325,5787.5,"Ecc",-20,350,TRUE,FALSE,TRUE,5.78,"young",19,160,51,"f"
15,"VERTICAL TRACTION",2,"Ecc01",5520,5500,8800,6600,5510,7700,0.397,-2190,6605,"Ecc",20,2200,TRUE,FALSE,TRUE,28.44,"young",19,160,51,"f"
15,"VERTICAL TRACTION",2,"Ecc02",6480,6500,5400,5300,6490,5350,0.176,1140,5920,"Ecc",-20,100,TRUE,FALSE,FALSE,21.31,"young",19,160,51,"f"
15,"VERTICAL TRACTION",2,"Ecc03",6380,6340,6400,6400,6360,6400,0.006,-40,6380,"Ecc",40,0,FALSE,FALSE,FALSE,0.62,"young",19,160,51,"f"
15,"VERTICAL TRACTION",2,"Ecc04",5740,5720,6250,6300,5730,6275,0.095,-545,6002.5,"Ecc",20,-50,TRUE,FALSE,FALSE,8.69,"young",19,160,51,"f"
15,"VERTICAL TRACTION",2,"Ecc05",5740,5720,5500,5650,5730,5575,0.027,155,5652.5,"Ecc",20,-150,FALSE,FALSE,FALSE,2.78,"young",19,160,51,"f"
15,"VERTICAL TRACTION",2,"Ecc06",5820,5820,5550,5550,5820,5550,0.046,270,5685,"Ecc",0,0,TRUE,FALSE,FALSE,4.86,"young",19,160,51,"f"
15,"VERTICAL TRACTION",2,"Ecc07",6180,6160,5600,5450,6170,5525,0.105,645,5847.5,"Ecc",20,150,TRUE,FALSE,FALSE,11.67,"young",19,160,51,"f"
15,"VERTICAL TRACTION",2,"Ecc08",6480,6460,5850,4500,6470,5175,0.2,1295,5822.5,"Ecc",20,1350,TRUE,FALSE,TRUE,25.02,"young",19,160,51,"f"
15,"VERTICAL TRACTION",2,"Ecc09",6300,6280,4750,4650,6290,4700,0.253,1590,5495,"Ecc",20,100,TRUE,FALSE,FALSE,33.83,"young",19,160,51,"f"
15,"VERTICAL TRACTION",2,"Ecc10",5360,5340,4800,4000,5350,4400,0.178,950,4875,"Ecc",20,800,TRUE,FALSE,TRUE,21.59,"young",19,160,51,"f"
15,"VERTICAL TRACTION",1,"Rep01",8380,8360,8350,8350,8370,8350,0.002,20,8360,"Rep",20,0,FALSE,FALSE,FALSE,0.24,"young",19,160,51,"f"
15,"VERTICAL TRACTION",1,"Rep02",7780,7820,7850,8350,7800,8100,0.038,-300,7950,"Rep",-40,-500,TRUE,FALSE,TRUE,3.7,"young",19,160,51,"f"
15,"VERTICAL TRACTION",1,"Rep03",8000,8000,8000,7800,8000,7900,0.012,100,7950,"Rep",0,200,FALSE,FALSE,TRUE,1.27,"young",19,160,51,"f"
15,"VERTICAL TRACTION",1,"Rep04",7540,7540,7500,8000,7540,7750,0.028,-210,7645,"Rep",0,-500,TRUE,FALSE,TRUE,2.71,"young",19,160,51,"f"
15,"VERTICAL TRACTION",1,"Rep05",8020,8000,7900,7550,8010,7725,0.036,285,7867.5,"Rep",20,350,TRUE,FALSE,TRUE,3.69,"young",19,160,51,"f"
15,"VERTICAL TRACTION",1,"Rep06",8040,8060,8100,8000,8050,8050,0,0,8050,"Rep",-20,100,FALSE,FALSE,FALSE,0,"young",19,160,51,"f"
15,"VERTICAL TRACTION",1,"Rep07",7920,7920,7950,8050,7920,8000,0.01,-80,7960,"Rep",0,-100,FALSE,FALSE,FALSE,1,"young",19,160,51,"f"
15,"VERTICAL TRACTION",1,"Rep08",8320,8320,8150,7850,8320,8000,0.038,320,8160,"Rep",0,300,TRUE,FALSE,TRUE,4,"young",19,160,51,"f"
15,"VERTICAL TRACTION",1,"Rep09",7860,7800,7750,8350,7830,8050,0.028,-220,7940,"Rep",60,-600,TRUE,FALSE,TRUE,2.73,"young",19,160,51,"f"
15,"VERTICAL TRACTION",1,"Rep10",7940,8000,8400,7700,7970,8050,0.01,-80,8010,"Rep",-60,700,FALSE,FALSE,TRUE,0.99,"young",19,160,51,"f"
15,"VERTICAL TRACTION",2,"Rep01",7960,7960,9650,10200,7960,9925,0.247,-1965,8942.5,"Rep",0,-550,TRUE,FALSE,TRUE,19.8,"young",19,160,51,"f"
15,"VERTICAL TRACTION",2,"Rep02",8180,8200,8050,7950,8190,8000,0.023,190,8095,"Rep",-20,100,TRUE,FALSE,FALSE,2.38,"young",19,160,51,"f"
15,"VERTICAL TRACTION",2,"Rep03",8400,8380,8250,8300,8390,8275,0.014,115,8332.5,"Rep",20,-50,FALSE,FALSE,FALSE,1.39,"young",19,160,51,"f"
15,"VERTICAL TRACTION",2,"Rep04",7640,7660,8300,8350,7650,8325,0.088,-675,7987.5,"Rep",-20,-50,TRUE,FALSE,FALSE,8.11,"young",19,160,51,"f"
15,"VERTICAL TRACTION",2,"Rep05",7400,7400,7650,7650,7400,7650,0.034,-250,7525,"Rep",0,0,TRUE,FALSE,FALSE,3.27,"young",19,160,51,"f"
15,"VERTICAL TRACTION",2,"Rep06",7640,7660,7400,7350,7650,7375,0.036,275,7512.5,"Rep",-20,50,TRUE,FALSE,FALSE,3.73,"young",19,160,51,"f"
15,"VERTICAL TRACTION",2,"Rep07",7800,7780,7600,7500,7790,7550,0.031,240,7670,"Rep",20,100,TRUE,FALSE,FALSE,3.18,"young",19,160,51,"f"
15,"VERTICAL TRACTION",2,"Rep08",8120,8120,7750,7500,8120,7625,0.061,495,7872.5,"Rep",0,250,TRUE,FALSE,TRUE,6.49,"young",19,160,51,"f"
15,"VERTICAL TRACTION",2,"Rep09",7920,7920,7950,8200,7920,8075,0.02,-155,7997.5,"Rep",0,-250,TRUE,FALSE,TRUE,1.92,"young",19,160,51,"f"
15,"VERTICAL TRACTION",2,"Rep10",7100,7120,8050,7400,7110,7725,0.086,-615,7417.5,"Rep",-20,650,TRUE,FALSE,TRUE,7.96,"young",19,160,51,"f"
15,"VERTICAL TRACTION",1,"TuT",79800,79820,79950,80000,79810,79975,0.002,-165,79892.5,"TuT",-20,-50,FALSE,FALSE,FALSE,0.21,"young",19,160,51,"f"
15,"VERTICAL TRACTION",2,"TuT",78160,78200,80650,80400,78180,80525,0.03,-2345,79352.5,"TuT",-40,250,TRUE,FALSE,FALSE,2.91,"young",19,160,51,"f"
15,"CHEST PRESS",1,"Con01",2360,2400,4150,2750,2380,3450,0.45,-1070,2915,"Con",-40,1400,TRUE,TRUE,TRUE,31.01,"young",19,160,51,"f"
15,"CHEST PRESS",1,"Con02",1880,1940,2200,2000,1910,2100,0.099,-190,2005,"Con",-60,200,FALSE,TRUE,FALSE,9.05,"young",19,160,51,"f"
15,"CHEST PRESS",1,"Con03",1820,1820,2450,3600,1820,3025,0.662,-1205,2422.5,"Con",0,-1150,TRUE,FALSE,TRUE,39.83,"young",19,160,51,"f"
15,"CHEST PRESS",1,"Con04",1740,1760,2100,3400,1750,2750,0.571,-1000,2250,"Con",-20,-1300,TRUE,FALSE,TRUE,36.36,"young",19,160,51,"f"
15,"CHEST PRESS",1,"Con05",1620,1640,2250,1950,1630,2100,0.288,-470,1865,"Con",-20,300,TRUE,FALSE,FALSE,22.38,"young",19,160,51,"f"
15,"CHEST PRESS",1,"Con06",1840,1860,2050,2100,1850,2075,0.122,-225,1962.5,"Con",-20,-50,FALSE,FALSE,FALSE,10.84,"young",19,160,51,"f"
15,"CHEST PRESS",1,"Con07",1740,1800,2800,2050,1770,2425,0.37,-655,2097.5,"Con",-60,750,TRUE,TRUE,TRUE,27.01,"young",19,160,51,"f"
15,"CHEST PRESS",1,"Con08",1620,1640,4000,1900,1630,2950,0.81,-1320,2290,"Con",-20,2100,TRUE,FALSE,TRUE,44.75,"young",19,160,51,"f"
15,"CHEST PRESS",1,"Con09",1700,1700,4000,3700,1700,3850,1.265,-2150,2775,"Con",0,300,TRUE,FALSE,FALSE,55.84,"young",19,160,51,"f"
15,"CHEST PRESS",1,"Con10",1540,1560,3300,2800,1550,3050,0.968,-1500,2300,"Con",-20,500,TRUE,FALSE,TRUE,49.18,"young",19,160,51,"f"
15,"CHEST PRESS",2,"Con01",1800,1840,2750,5700,1820,4225,1.321,-2405,3022.5,"Con",-40,-2950,TRUE,TRUE,TRUE,56.92,"young",19,160,51,"f"
15,"CHEST PRESS",2,"Con02",2020,2020,2250,3200,2020,2725,0.349,-705,2372.5,"Con",0,-950,TRUE,FALSE,TRUE,25.87,"young",19,160,51,"f"
15,"CHEST PRESS",2,"Con03",2020,2020,2250,2300,2020,2275,0.126,-255,2147.5,"Con",0,-50,FALSE,FALSE,FALSE,11.21,"young",19,160,51,"f"
15,"CHEST PRESS",2,"Con04",2160,2140,2450,2300,2150,2375,0.105,-225,2262.5,"Con",20,150,FALSE,FALSE,FALSE,9.47,"young",19,160,51,"f"
15,"CHEST PRESS",2,"Con05",1820,1860,2900,3100,1840,3000,0.63,-1160,2420,"Con",-40,-200,TRUE,TRUE,FALSE,38.67,"young",19,160,51,"f"
15,"CHEST PRESS",2,"Con06",1780,1740,2550,2050,1760,2300,0.307,-540,2030,"Con",40,500,TRUE,TRUE,TRUE,23.48,"young",19,160,51,"f"
15,"CHEST PRESS",2,"Con07",1840,1880,2550,2550,1860,2550,0.371,-690,2205,"Con",-40,0,TRUE,TRUE,FALSE,27.06,"young",19,160,51,"f"
15,"CHEST PRESS",2,"Con08",1920,1920,3750,2350,1920,3050,0.589,-1130,2485,"Con",0,1400,TRUE,FALSE,TRUE,37.05,"young",19,160,51,"f"
15,"CHEST PRESS",2,"Con09",1700,1720,2150,2000,1710,2075,0.213,-365,1892.5,"Con",-20,150,TRUE,FALSE,FALSE,17.59,"young",19,160,51,"f"
15,"CHEST PRESS",2,"Con10",1700,1680,2850,3350,1690,3100,0.834,-1410,2395,"Con",20,-500,TRUE,FALSE,TRUE,45.48,"young",19,160,51,"f"
15,"CHEST PRESS",1,"Ecc01",6100,6040,5250,5850,6070,5550,0.086,520,5810,"Ecc",60,-600,TRUE,TRUE,TRUE,9.37,"young",19,160,51,"f"
15,"CHEST PRESS",1,"Ecc02",6440,6440,5950,6200,6440,6075,0.057,365,6257.5,"Ecc",0,-250,TRUE,FALSE,TRUE,6.01,"young",19,160,51,"f"
15,"CHEST PRESS",1,"Ecc03",7220,7200,6800,5350,7210,6075,0.157,1135,6642.5,"Ecc",20,1450,TRUE,FALSE,TRUE,18.68,"young",19,160,51,"f"
15,"CHEST PRESS",1,"Ecc04",7080,7060,6700,5550,7070,6125,0.134,945,6597.5,"Ecc",20,1150,TRUE,FALSE,TRUE,15.43,"young",19,160,51,"f"
15,"CHEST PRESS",1,"Ecc05",6840,6820,6250,6500,6830,6375,0.067,455,6602.5,"Ecc",20,-250,TRUE,FALSE,TRUE,7.14,"young",19,160,51,"f"
15,"CHEST PRESS",1,"Ecc06",6900,6860,6700,6650,6880,6675,0.03,205,6777.5,"Ecc",40,50,FALSE,TRUE,FALSE,3.07,"young",19,160,51,"f"
15,"CHEST PRESS",1,"Ecc07",6800,6760,5650,6550,6780,6100,0.1,680,6440,"Ecc",40,-900,TRUE,TRUE,TRUE,11.15,"young",19,160,51,"f"
15,"CHEST PRESS",1,"Ecc08",6720,6700,3950,6200,6710,5075,0.244,1635,5892.5,"Ecc",20,-2250,TRUE,FALSE,TRUE,32.22,"young",19,160,51,"f"
15,"CHEST PRESS",1,"Ecc09",6160,6160,3700,4050,6160,3875,0.371,2285,5017.5,"Ecc",0,-350,TRUE,FALSE,TRUE,58.97,"young",19,160,51,"f"
15,"CHEST PRESS",1,"Ecc10",4400,4400,2700,3500,4400,3100,0.295,1300,3750,"Ecc",0,-800,TRUE,FALSE,TRUE,41.94,"young",19,160,51,"f"
15,"CHEST PRESS",2,"Ecc01",5640,5640,5350,4000,5640,4675,0.171,965,5157.5,"Ecc",0,1350,TRUE,FALSE,TRUE,20.64,"young",19,160,51,"f"
15,"CHEST PRESS",2,"Ecc02",5360,5360,5100,4400,5360,4750,0.114,610,5055,"Ecc",0,700,TRUE,FALSE,TRUE,12.84,"young",19,160,51,"f"
15,"CHEST PRESS",2,"Ecc03",6540,6540,6250,6300,6540,6275,0.041,265,6407.5,"Ecc",0,-50,FALSE,FALSE,FALSE,4.22,"young",19,160,51,"f"
15,"CHEST PRESS",2,"Ecc04",5980,5980,5750,5850,5980,5800,0.03,180,5890,"Ecc",0,-100,FALSE,FALSE,FALSE,3.1,"young",19,160,51,"f"
15,"CHEST PRESS",2,"Ecc05",6420,6420,5350,5100,6420,5225,0.186,1195,5822.5,"Ecc",0,250,TRUE,FALSE,TRUE,22.87,"young",19,160,51,"f"
15,"CHEST PRESS",2,"Ecc06",5260,5280,4500,4950,5270,4725,0.103,545,4997.5,"Ecc",-20,-450,TRUE,FALSE,TRUE,11.53,"young",19,160,51,"f"
15,"CHEST PRESS",2,"Ecc07",5560,5520,4600,4800,5540,4700,0.152,840,5120,"Ecc",40,-200,TRUE,TRUE,FALSE,17.87,"young",19,160,51,"f"
15,"CHEST PRESS",2,"Ecc08",6020,6020,4350,5600,6020,4975,0.174,1045,5497.5,"Ecc",0,-1250,TRUE,FALSE,TRUE,21.01,"young",19,160,51,"f"
15,"CHEST PRESS",2,"Ecc09",5300,5320,4800,4450,5310,4625,0.129,685,4967.5,"Ecc",-20,350,TRUE,FALSE,TRUE,14.81,"young",19,160,51,"f"
15,"CHEST PRESS",2,"Ecc10",4140,4140,3250,3250,4140,3250,0.215,890,3695,"Ecc",0,0,TRUE,FALSE,FALSE,27.38,"young",19,160,51,"f"
15,"CHEST PRESS",1,"Rep01",8460,8440,9400,8600,8450,9000,0.065,-550,8725,"Rep",20,800,TRUE,FALSE,TRUE,6.11,"young",19,160,51,"f"
15,"CHEST PRESS",1,"Rep02",8320,8380,8150,8200,8350,8175,0.021,175,8262.5,"Rep",-60,-50,TRUE,FALSE,FALSE,2.14,"young",19,160,51,"f"
15,"CHEST PRESS",1,"Rep03",9040,9020,9250,8950,9030,9100,0.008,-70,9065,"Rep",20,300,FALSE,FALSE,TRUE,0.77,"young",19,160,51,"f"
15,"CHEST PRESS",1,"Rep04",8820,8820,8800,8950,8820,8875,0.006,-55,8847.5,"Rep",0,-150,FALSE,FALSE,FALSE,0.62,"young",19,160,51,"f"
15,"CHEST PRESS",1,"Rep05",8460,8460,8500,8450,8460,8475,0.002,-15,8467.5,"Rep",0,50,FALSE,FALSE,FALSE,0.18,"young",19,160,51,"f"
15,"CHEST PRESS",1,"Rep06",8740,8720,8750,8750,8730,8750,0.002,-20,8740,"Rep",20,0,FALSE,FALSE,FALSE,0.23,"young",19,160,51,"f"
15,"CHEST PRESS",1,"Rep07",8540,8560,8450,8600,8550,8525,0.003,25,8537.5,"Rep",-20,-150,FALSE,FALSE,FALSE,0.29,"young",19,160,51,"f"
15,"CHEST PRESS",1,"Rep08",8340,8340,7950,8100,8340,8025,0.038,315,8182.5,"Rep",0,-150,TRUE,FALSE,FALSE,3.93,"young",19,160,51,"f"
15,"CHEST PRESS",1,"Rep09",7860,7860,7700,7750,7860,7725,0.017,135,7792.5,"Rep",0,-50,FALSE,FALSE,FALSE,1.75,"young",19,160,51,"f"
15,"CHEST PRESS",1,"Rep10",5940,5960,6000,6300,5950,6150,0.034,-200,6050,"Rep",-20,-300,TRUE,FALSE,TRUE,3.25,"young",19,160,51,"f"
15,"CHEST PRESS",2,"Rep01",7440,7480,8100,9700,7460,8900,0.193,-1440,8180,"Rep",-40,-1600,TRUE,FALSE,TRUE,16.18,"young",19,160,51,"f"
15,"CHEST PRESS",2,"Rep02",7380,7380,7350,7600,7380,7475,0.013,-95,7427.5,"Rep",0,-250,FALSE,FALSE,TRUE,1.27,"young",19,160,51,"f"
15,"CHEST PRESS",2,"Rep03",8560,8560,8500,8600,8560,8550,0.001,10,8555,"Rep",0,-100,FALSE,FALSE,FALSE,0.12,"young",19,160,51,"f"
15,"CHEST PRESS",2,"Rep04",8140,8120,8200,8150,8130,8175,0.006,-45,8152.5,"Rep",20,50,FALSE,FALSE,FALSE,0.55,"young",19,160,51,"f"
15,"CHEST PRESS",2,"Rep05",8240,8280,8250,8200,8260,8225,0.004,35,8242.5,"Rep",-40,50,FALSE,FALSE,FALSE,0.43,"young",19,160,51,"f"
15,"CHEST PRESS",2,"Rep06",7040,7020,7050,7000,7030,7025,0.001,5,7027.5,"Rep",20,50,FALSE,FALSE,FALSE,0.07,"young",19,160,51,"f"
15,"CHEST PRESS",2,"Rep07",7400,7400,7150,7350,7400,7250,0.02,150,7325,"Rep",0,-200,TRUE,FALSE,TRUE,2.07,"young",19,160,51,"f"
15,"CHEST PRESS",2,"Rep08",7940,7940,8100,7950,7940,8025,0.011,-85,7982.5,"Rep",0,150,FALSE,FALSE,FALSE,1.06,"young",19,160,51,"f"
15,"CHEST PRESS",2,"Rep09",7000,7040,6950,6450,7020,6700,0.046,320,6860,"Rep",-40,500,TRUE,FALSE,TRUE,4.78,"young",19,160,51,"f"
15,"CHEST PRESS",2,"Rep10",5840,5820,6100,6600,5830,6350,0.089,-520,6090,"Rep",20,-500,TRUE,FALSE,TRUE,8.19,"young",19,160,51,"f"
15,"CHEST PRESS",1,"TuT",82520,82560,82950,82650,82540,82800,0.003,-260,82670,"TuT",-40,300,FALSE,FALSE,FALSE,0.31,"young",19,160,51,"f"
15,"CHEST PRESS",2,"TuT",74980,75040,75750,77600,75010,76675,0.022,-1665,75842.5,"TuT",-60,-1850,FALSE,FALSE,TRUE,2.17,"young",19,160,51,"f"
16,"LEG PRESS",1,"Con01",1300,1280,1600,1500,1290,1550,0.202,-260,1420,"Con",20,100,FALSE,FALSE,FALSE,16.77,"young",48,175,72,"m"
16,"LEG PRESS",1,"Con02",1440,1460,1500,1450,1450,1475,0.017,-25,1462.5,"Con",-20,50,FALSE,FALSE,FALSE,1.69,"young",48,175,72,"m"
16,"LEG PRESS",1,"Con03",1360,1380,1350,1300,1370,1325,0.033,45,1347.5,"Con",-20,50,FALSE,FALSE,FALSE,3.4,"young",48,175,72,"m"
16,"LEG PRESS",1,"Con04",1320,1320,1350,1300,1320,1325,0.004,-5,1322.5,"Con",0,50,FALSE,FALSE,FALSE,0.38,"young",48,175,72,"m"
16,"LEG PRESS",1,"Con05",1300,1260,1300,1350,1280,1325,0.035,-45,1302.5,"Con",40,-50,FALSE,FALSE,FALSE,3.4,"young",48,175,72,"m"
16,"LEG PRESS",1,"Con06",1360,1340,1450,1450,1350,1450,0.074,-100,1400,"Con",20,0,FALSE,FALSE,FALSE,6.9,"young",48,175,72,"m"
16,"LEG PRESS",1,"Con07",1260,1220,1350,1400,1240,1375,0.109,-135,1307.5,"Con",40,-50,FALSE,FALSE,FALSE,9.82,"young",48,175,72,"m"
16,"LEG PRESS",1,"Con08",1180,1200,1400,1400,1190,1400,0.176,-210,1295,"Con",-20,0,FALSE,FALSE,FALSE,15,"young",48,175,72,"m"
16,"LEG PRESS",1,"Con09",1140,1140,1350,1400,1140,1375,0.206,-235,1257.5,"Con",0,-50,FALSE,FALSE,FALSE,17.09,"young",48,175,72,"m"
16,"LEG PRESS",1,"Con10",1220,1240,1550,1500,1230,1525,0.24,-295,1377.5,"Con",-20,50,FALSE,FALSE,FALSE,19.34,"young",48,175,72,"m"
16,"LEG PRESS",2,"Con01",1400,1400,1600,1250,1400,1425,0.018,-25,1412.5,"Con",0,350,FALSE,FALSE,TRUE,1.75,"young",48,175,72,"m"
16,"LEG PRESS",2,"Con02",1200,1180,1200,1200,1190,1200,0.008,-10,1195,"Con",20,0,FALSE,FALSE,FALSE,0.83,"young",48,175,72,"m"
16,"LEG PRESS",2,"Con03",1180,1180,1250,1200,1180,1225,0.038,-45,1202.5,"Con",0,50,FALSE,FALSE,FALSE,3.67,"young",48,175,72,"m"
16,"LEG PRESS",2,"Con04",1160,1120,1250,1200,1140,1225,0.075,-85,1182.5,"Con",40,50,FALSE,FALSE,FALSE,6.94,"young",48,175,72,"m"
16,"LEG PRESS",2,"Con05",1060,1060,1150,1150,1060,1150,0.085,-90,1105,"Con",0,0,FALSE,FALSE,FALSE,7.83,"young",48,175,72,"m"
16,"LEG PRESS",2,"Con06",1200,1180,1300,1300,1190,1300,0.092,-110,1245,"Con",20,0,FALSE,FALSE,FALSE,8.46,"young",48,175,72,"m"
16,"LEG PRESS",2,"Con07",1280,1300,1400,1400,1290,1400,0.085,-110,1345,"Con",-20,0,FALSE,FALSE,FALSE,7.86,"young",48,175,72,"m"
16,"LEG PRESS",2,"Con08",1180,1160,1250,1250,1170,1250,0.068,-80,1210,"Con",20,0,FALSE,FALSE,FALSE,6.4,"young",48,175,72,"m"
16,"LEG PRESS",2,"Con09",1240,1200,1350,1350,1220,1350,0.107,-130,1285,"Con",40,0,FALSE,FALSE,FALSE,9.63,"young",48,175,72,"m"
16,"LEG PRESS",2,"Con10",1280,1280,1450,1450,1280,1450,0.133,-170,1365,"Con",0,0,FALSE,FALSE,FALSE,11.72,"young",48,175,72,"m"
16,"LEG PRESS",1,"Ecc01",2180,2160,2050,2050,2170,2050,0.055,120,2110,"Ecc",20,0,FALSE,FALSE,FALSE,5.85,"young",48,175,72,"m"
16,"LEG PRESS",1,"Ecc02",1900,1880,1850,1900,1890,1875,0.008,15,1882.5,"Ecc",20,-50,FALSE,FALSE,FALSE,0.8,"young",48,175,72,"m"
16,"LEG PRESS",1,"Ecc03",1860,1840,1850,1900,1850,1875,0.014,-25,1862.5,"Ecc",20,-50,FALSE,FALSE,FALSE,1.33,"young",48,175,72,"m"
16,"LEG PRESS",1,"Ecc04",1860,1880,1850,1850,1870,1850,0.011,20,1860,"Ecc",-20,0,FALSE,FALSE,FALSE,1.08,"young",48,175,72,"m"
16,"LEG PRESS",1,"Ecc05",1840,1880,1800,1800,1860,1800,0.032,60,1830,"Ecc",-40,0,FALSE,FALSE,FALSE,3.33,"young",48,175,72,"m"
16,"LEG PRESS",1,"Ecc06",1840,1840,1750,1700,1840,1725,0.062,115,1782.5,"Ecc",0,50,FALSE,FALSE,FALSE,6.67,"young",48,175,72,"m"
16,"LEG PRESS",1,"Ecc07",1860,1900,1750,1750,1880,1750,0.069,130,1815,"Ecc",-40,0,FALSE,FALSE,FALSE,7.43,"young",48,175,72,"m"
16,"LEG PRESS",1,"Ecc08",1940,1920,1700,1650,1930,1675,0.132,255,1802.5,"Ecc",20,50,FALSE,FALSE,FALSE,15.22,"young",48,175,72,"m"
16,"LEG PRESS",1,"Ecc09",2000,2000,1650,1700,2000,1675,0.162,325,1837.5,"Ecc",0,-50,TRUE,FALSE,FALSE,19.4,"young",48,175,72,"m"
16,"LEG PRESS",1,"Ecc10",1740,1740,1700,1700,1740,1700,0.023,40,1720,"Ecc",0,0,FALSE,FALSE,FALSE,2.35,"young",48,175,72,"m"
16,"LEG PRESS",2,"Ecc01",1780,1780,1750,1800,1780,1775,0.003,5,1777.5,"Ecc",0,-50,FALSE,FALSE,FALSE,0.28,"young",48,175,72,"m"
16,"LEG PRESS",2,"Ecc02",1820,1840,1800,1800,1830,1800,0.016,30,1815,"Ecc",-20,0,FALSE,FALSE,FALSE,1.67,"young",48,175,72,"m"
16,"LEG PRESS",2,"Ecc03",1620,1660,1550,1600,1640,1575,0.04,65,1607.5,"Ecc",-40,-50,FALSE,FALSE,FALSE,4.13,"young",48,175,72,"m"
16,"LEG PRESS",2,"Ecc04",1620,1600,1500,1550,1610,1525,0.053,85,1567.5,"Ecc",20,-50,FALSE,FALSE,FALSE,5.57,"young",48,175,72,"m"
16,"LEG PRESS",2,"Ecc05",1960,2000,1850,1850,1980,1850,0.066,130,1915,"Ecc",-40,0,FALSE,FALSE,FALSE,7.03,"young",48,175,72,"m"
16,"LEG PRESS",2,"Ecc06",1760,1760,1650,1650,1760,1650,0.062,110,1705,"Ecc",0,0,FALSE,FALSE,FALSE,6.67,"young",48,175,72,"m"
16,"LEG PRESS",2,"Ecc07",1600,1600,1500,1500,1600,1500,0.062,100,1550,"Ecc",0,0,FALSE,FALSE,FALSE,6.67,"young",48,175,72,"m"
16,"LEG PRESS",2,"Ecc08",1780,1820,1700,1700,1800,1700,0.056,100,1750,"Ecc",-40,0,FALSE,FALSE,FALSE,5.88,"young",48,175,72,"m"
16,"LEG PRESS",2,"Ecc09",1620,1620,1450,1450,1620,1450,0.105,170,1535,"Ecc",0,0,FALSE,FALSE,FALSE,11.72,"young",48,175,72,"m"
16,"LEG PRESS",2,"Ecc10",1540,1560,1550,1550,1550,1550,0,0,1550,"Ecc",-20,0,FALSE,FALSE,FALSE,0,"young",48,175,72,"m"
16,"LEG PRESS",1,"Rep01",3480,3440,3650,3550,3460,3600,0.04,-140,3530,"Rep",40,100,TRUE,FALSE,TRUE,3.89,"young",48,175,72,"m"
16,"LEG PRESS",1,"Rep02",3340,3340,3350,3350,3340,3350,0.003,-10,3345,"Rep",0,0,FALSE,FALSE,FALSE,0.3,"young",48,175,72,"m"
16,"LEG PRESS",1,"Rep03",3220,3220,3200,3200,3220,3200,0.006,20,3210,"Rep",0,0,FALSE,FALSE,FALSE,0.62,"young",48,175,72,"m"
16,"LEG PRESS",1,"Rep04",3180,3200,3200,3150,3190,3175,0.005,15,3182.5,"Rep",-20,50,FALSE,FALSE,FALSE,0.47,"young",48,175,72,"m"
16,"LEG PRESS",1,"Rep05",3140,3140,3100,3150,3140,3125,0.005,15,3132.5,"Rep",0,-50,FALSE,FALSE,FALSE,0.48,"young",48,175,72,"m"
16,"LEG PRESS",1,"Rep06",3200,3180,3200,3150,3190,3175,0.005,15,3182.5,"Rep",20,50,FALSE,FALSE,FALSE,0.47,"young",48,175,72,"m"
16,"LEG PRESS",1,"Rep07",3120,3120,3100,3150,3120,3125,0.002,-5,3122.5,"Rep",0,-50,FALSE,FALSE,FALSE,0.16,"young",48,175,72,"m"
16,"LEG PRESS",1,"Rep08",3120,3120,3100,3050,3120,3075,0.014,45,3097.5,"Rep",0,50,FALSE,FALSE,FALSE,1.46,"young",48,175,72,"m"
16,"LEG PRESS",1,"Rep09",3140,3140,3000,3100,3140,3050,0.029,90,3095,"Rep",0,-100,FALSE,FALSE,TRUE,2.95,"young",48,175,72,"m"
16,"LEG PRESS",1,"Rep10",2960,2980,3250,3200,2970,3225,0.086,-255,3097.5,"Rep",-20,50,TRUE,FALSE,FALSE,7.91,"young",48,175,72,"m"
16,"LEG PRESS",2,"Rep01",3180,3180,3350,3050,3180,3200,0.006,-20,3190,"Rep",0,300,FALSE,FALSE,TRUE,0.62,"young",48,175,72,"m"
16,"LEG PRESS",2,"Rep02",3020,3020,3000,3000,3020,3000,0.007,20,3010,"Rep",0,0,FALSE,FALSE,FALSE,0.67,"young",48,175,72,"m"
16,"LEG PRESS",2,"Rep03",2800,2840,2800,2800,2820,2800,0.007,20,2810,"Rep",-40,0,FALSE,FALSE,FALSE,0.71,"young",48,175,72,"m"
16,"LEG PRESS",2,"Rep04",2780,2720,2750,2750,2750,2750,0,0,2750,"Rep",60,0,FALSE,FALSE,FALSE,0,"young",48,175,72,"m"
16,"LEG PRESS",2,"Rep05",3020,3060,3000,3000,3040,3000,0.013,40,3020,"Rep",-40,0,FALSE,FALSE,FALSE,1.33,"young",48,175,72,"m"
16,"LEG PRESS",2,"Rep06",2960,2940,2950,2950,2950,2950,0,0,2950,"Rep",20,0,FALSE,FALSE,FALSE,0,"young",48,175,72,"m"
16,"LEG PRESS",2,"Rep07",2880,2900,2900,2900,2890,2900,0.003,-10,2895,"Rep",-20,0,FALSE,FALSE,FALSE,0.34,"young",48,175,72,"m"
16,"LEG PRESS",2,"Rep08",2960,2980,2950,2950,2970,2950,0.007,20,2960,"Rep",-20,0,FALSE,FALSE,FALSE,0.68,"young",48,175,72,"m"
16,"LEG PRESS",2,"Rep09",2860,2820,2800,2800,2840,2800,0.014,40,2820,"Rep",40,0,FALSE,FALSE,FALSE,1.43,"young",48,175,72,"m"
16,"LEG PRESS",2,"Rep10",2820,2840,3000,3000,2830,3000,0.06,-170,2915,"Rep",-20,0,TRUE,FALSE,FALSE,5.67,"young",48,175,72,"m"
16,"LEG PRESS",1,"TuT",31900,31880,32150,32050,31890,32100,0.007,-210,31995,"TuT",20,100,FALSE,FALSE,FALSE,0.65,"young",48,175,72,"m"
16,"LEG PRESS",2,"TuT",29280,29300,29500,29200,29290,29350,0.002,-60,29320,"TuT",-20,300,FALSE,FALSE,FALSE,0.2,"young",48,175,72,"m"
16,"LEG EXTENSION",1,"Con01",1240,1260,1400,1300,1250,1350,0.08,-100,1300,"Con",-20,100,FALSE,FALSE,FALSE,7.41,"young",48,175,72,"m"
16,"LEG EXTENSION",1,"Con02",960,980,1050,1000,970,1025,0.057,-55,997.5,"Con",-20,50,FALSE,FALSE,FALSE,5.37,"young",48,175,72,"m"
16,"LEG EXTENSION",1,"Con03",1260,1260,1300,1300,1260,1300,0.032,-40,1280,"Con",0,0,FALSE,FALSE,FALSE,3.08,"young",48,175,72,"m"
16,"LEG EXTENSION",1,"Con04",1080,1080,1100,1150,1080,1125,0.042,-45,1102.5,"Con",0,-50,FALSE,FALSE,FALSE,4,"young",48,175,72,"m"
16,"LEG EXTENSION",1,"Con05",960,1000,1050,1050,980,1050,0.071,-70,1015,"Con",-40,0,FALSE,TRUE,FALSE,6.67,"young",48,175,72,"m"
16,"LEG EXTENSION",1,"Con06",900,920,1000,1000,910,1000,0.099,-90,955,"Con",-20,0,FALSE,FALSE,FALSE,9,"young",48,175,72,"m"
16,"LEG EXTENSION",1,"Con07",900,940,1050,1050,920,1050,0.141,-130,985,"Con",-40,0,FALSE,TRUE,FALSE,12.38,"young",48,175,72,"m"
16,"LEG EXTENSION",1,"Con08",940,940,1050,1050,940,1050,0.117,-110,995,"Con",0,0,FALSE,FALSE,FALSE,10.48,"young",48,175,72,"m"
16,"LEG EXTENSION",1,"Con09",940,960,1100,1100,950,1100,0.158,-150,1025,"Con",-20,0,FALSE,FALSE,FALSE,13.64,"young",48,175,72,"m"
16,"LEG EXTENSION",1,"Con10",1060,1060,1200,1200,1060,1200,0.132,-140,1130,"Con",0,0,FALSE,FALSE,FALSE,11.67,"young",48,175,72,"m"
16,"LEG EXTENSION",2,"Con01",1200,1200,1200,1250,1200,1225,0.021,-25,1212.5,"Con",0,-50,FALSE,FALSE,FALSE,2.04,"young",48,175,72,"m"
16,"LEG EXTENSION",2,"Con02",960,960,1000,1050,960,1025,0.068,-65,992.5,"Con",0,-50,FALSE,FALSE,FALSE,6.34,"young",48,175,72,"m"
16,"LEG EXTENSION",2,"Con03",920,920,1000,950,920,975,0.06,-55,947.5,"Con",0,50,FALSE,FALSE,FALSE,5.64,"young",48,175,72,"m"
16,"LEG EXTENSION",2,"Con04",940,940,1050,1000,940,1025,0.09,-85,982.5,"Con",0,50,FALSE,FALSE,FALSE,8.29,"young",48,175,72,"m"
16,"LEG EXTENSION",2,"Con05",960,1000,1050,1050,980,1050,0.071,-70,1015,"Con",-40,0,FALSE,TRUE,FALSE,6.67,"young",48,175,72,"m"
16,"LEG EXTENSION",2,"Con06",1140,1180,1200,1250,1160,1225,0.056,-65,1192.5,"Con",-40,-50,FALSE,TRUE,FALSE,5.31,"young",48,175,72,"m"
16,"LEG EXTENSION",2,"Con07",960,960,1050,1000,960,1025,0.068,-65,992.5,"Con",0,50,FALSE,FALSE,FALSE,6.34,"young",48,175,72,"m"
16,"LEG EXTENSION",2,"Con08",1000,1000,1100,1100,1000,1100,0.1,-100,1050,"Con",0,0,FALSE,FALSE,FALSE,9.09,"young",48,175,72,"m"
16,"LEG EXTENSION",2,"Con09",940,940,1050,1050,940,1050,0.117,-110,995,"Con",0,0,FALSE,FALSE,FALSE,10.48,"young",48,175,72,"m"
16,"LEG EXTENSION",2,"Con10",1120,1120,1200,1250,1120,1225,0.094,-105,1172.5,"Con",0,-50,FALSE,FALSE,FALSE,8.57,"young",48,175,72,"m"
16,"LEG EXTENSION",1,"Ecc01",1760,1760,1700,1750,1760,1725,0.02,35,1742.5,"Ecc",0,-50,FALSE,FALSE,FALSE,2.03,"young",48,175,72,"m"
16,"LEG EXTENSION",1,"Ecc02",1920,1900,1850,1850,1910,1850,0.031,60,1880,"Ecc",20,0,FALSE,FALSE,FALSE,3.24,"young",48,175,72,"m"
16,"LEG EXTENSION",1,"Ecc03",1920,1920,1900,1850,1920,1875,0.023,45,1897.5,"Ecc",0,50,FALSE,FALSE,FALSE,2.4,"young",48,175,72,"m"
16,"LEG EXTENSION",1,"Ecc04",1840,1820,1750,1750,1830,1750,0.044,80,1790,"Ecc",20,0,FALSE,FALSE,FALSE,4.57,"young",48,175,72,"m"
16,"LEG EXTENSION",1,"Ecc05",1620,1600,1550,1550,1610,1550,0.037,60,1580,"Ecc",20,0,FALSE,FALSE,FALSE,3.87,"young",48,175,72,"m"
16,"LEG EXTENSION",1,"Ecc06",1540,1500,1400,1400,1520,1400,0.079,120,1460,"Ecc",40,0,FALSE,TRUE,FALSE,8.57,"young",48,175,72,"m"
16,"LEG EXTENSION",1,"Ecc07",1520,1500,1400,1400,1510,1400,0.073,110,1455,"Ecc",20,0,FALSE,FALSE,FALSE,7.86,"young",48,175,72,"m"
16,"LEG EXTENSION",1,"Ecc08",1540,1520,1350,1400,1530,1375,0.101,155,1452.5,"Ecc",20,-50,FALSE,FALSE,FALSE,11.27,"young",48,175,72,"m"
16,"LEG EXTENSION",1,"Ecc09",1520,1520,1400,1350,1520,1375,0.095,145,1447.5,"Ecc",0,50,FALSE,FALSE,FALSE,10.55,"young",48,175,72,"m"
16,"LEG EXTENSION",1,"Ecc10",1660,1640,1700,1700,1650,1700,0.03,-50,1675,"Ecc",20,0,FALSE,FALSE,FALSE,2.94,"young",48,175,72,"m"
16,"LEG EXTENSION",2,"Ecc01",1840,1840,1850,1800,1840,1825,0.008,15,1832.5,"Ecc",0,50,FALSE,FALSE,FALSE,0.82,"young",48,175,72,"m"
16,"LEG EXTENSION",2,"Ecc02",1620,1620,1500,1550,1620,1525,0.059,95,1572.5,"Ecc",0,-50,FALSE,FALSE,FALSE,6.23,"young",48,175,72,"m"
16,"LEG EXTENSION",2,"Ecc03",1700,1700,1600,1650,1700,1625,0.044,75,1662.5,"Ecc",0,-50,FALSE,FALSE,FALSE,4.62,"young",48,175,72,"m"
16,"LEG EXTENSION",2,"Ecc04",1580,1560,1500,1500,1570,1500,0.045,70,1535,"Ecc",20,0,FALSE,FALSE,FALSE,4.67,"young",48,175,72,"m"
16,"LEG EXTENSION",2,"Ecc05",1680,1640,1600,1600,1660,1600,0.036,60,1630,"Ecc",40,0,FALSE,TRUE,FALSE,3.75,"young",48,175,72,"m"
16,"LEG EXTENSION",2,"Ecc06",1640,1620,1550,1550,1630,1550,0.049,80,1590,"Ecc",20,0,FALSE,FALSE,FALSE,5.16,"young",48,175,72,"m"
16,"LEG EXTENSION",2,"Ecc07",1580,1580,1500,1500,1580,1500,0.051,80,1540,"Ecc",0,0,FALSE,FALSE,FALSE,5.33,"young",48,175,72,"m"
16,"LEG EXTENSION",2,"Ecc08",1560,1560,1450,1450,1560,1450,0.071,110,1505,"Ecc",0,0,FALSE,FALSE,FALSE,7.59,"young",48,175,72,"m"
16,"LEG EXTENSION",2,"Ecc09",1460,1460,1350,1350,1460,1350,0.075,110,1405,"Ecc",0,0,FALSE,FALSE,FALSE,8.15,"young",48,175,72,"m"
16,"LEG EXTENSION",2,"Ecc10",1580,1560,1600,1550,1570,1575,0.003,-5,1572.5,"Ecc",20,50,FALSE,FALSE,FALSE,0.32,"young",48,175,72,"m"
16,"LEG EXTENSION",1,"Rep01",3000,3020,3100,3050,3010,3075,0.022,-65,3042.5,"Rep",-20,50,FALSE,FALSE,FALSE,2.11,"young",48,175,72,"m"
16,"LEG EXTENSION",1,"Rep02",2880,2880,2900,2850,2880,2875,0.002,5,2877.5,"Rep",0,50,FALSE,FALSE,FALSE,0.17,"young",48,175,72,"m"
16,"LEG EXTENSION",1,"Rep03",3180,3180,3200,3150,3180,3175,0.002,5,3177.5,"Rep",0,50,FALSE,FALSE,FALSE,0.16,"young",48,175,72,"m"
16,"LEG EXTENSION",1,"Rep04",2920,2900,2850,2900,2910,2875,0.012,35,2892.5,"Rep",20,-50,FALSE,FALSE,FALSE,1.22,"young",48,175,72,"m"
16,"LEG EXTENSION",1,"Rep05",2580,2600,2600,2600,2590,2600,0.004,-10,2595,"Rep",-20,0,FALSE,FALSE,FALSE,0.38,"young",48,175,72,"m"
16,"LEG EXTENSION",1,"Rep06",2440,2420,2400,2400,2430,2400,0.012,30,2415,"Rep",20,0,FALSE,FALSE,FALSE,1.25,"young",48,175,72,"m"
16,"LEG EXTENSION",1,"Rep07",2420,2440,2450,2450,2430,2450,0.008,-20,2440,"Rep",-20,0,FALSE,FALSE,FALSE,0.82,"young",48,175,72,"m"
16,"LEG EXTENSION",1,"Rep08",2480,2460,2400,2450,2470,2425,0.018,45,2447.5,"Rep",20,-50,FALSE,FALSE,FALSE,1.86,"young",48,175,72,"m"
16,"LEG EXTENSION",1,"Rep09",2460,2480,2500,2450,2470,2475,0.002,-5,2472.5,"Rep",-20,50,FALSE,FALSE,FALSE,0.2,"young",48,175,72,"m"
16,"LEG EXTENSION",1,"Rep10",2720,2700,2900,2900,2710,2900,0.07,-190,2805,"Rep",20,0,TRUE,FALSE,FALSE,6.55,"young",48,175,72,"m"
16,"LEG EXTENSION",2,"Rep01",3040,3040,3050,3050,3040,3050,0.003,-10,3045,"Rep",0,0,FALSE,FALSE,FALSE,0.33,"young",48,175,72,"m"
16,"LEG EXTENSION",2,"Rep02",2580,2580,2500,2600,2580,2550,0.012,30,2565,"Rep",0,-100,FALSE,FALSE,FALSE,1.18,"young",48,175,72,"m"
16,"LEG EXTENSION",2,"Rep03",2620,2620,2600,2600,2620,2600,0.008,20,2610,"Rep",0,0,FALSE,FALSE,FALSE,0.77,"young",48,175,72,"m"
16,"LEG EXTENSION",2,"Rep04",2520,2500,2550,2500,2510,2525,0.006,-15,2517.5,"Rep",20,50,FALSE,FALSE,FALSE,0.59,"young",48,175,72,"m"
16,"LEG EXTENSION",2,"Rep05",2640,2640,2650,2650,2640,2650,0.004,-10,2645,"Rep",0,0,FALSE,FALSE,FALSE,0.38,"young",48,175,72,"m"
16,"LEG EXTENSION",2,"Rep06",2780,2800,2750,2800,2790,2775,0.005,15,2782.5,"Rep",-20,-50,FALSE,FALSE,FALSE,0.54,"young",48,175,72,"m"
16,"LEG EXTENSION",2,"Rep07",2540,2540,2550,2500,2540,2525,0.006,15,2532.5,"Rep",0,50,FALSE,FALSE,FALSE,0.59,"young",48,175,72,"m"
16,"LEG EXTENSION",2,"Rep08",2560,2560,2550,2550,2560,2550,0.004,10,2555,"Rep",0,0,FALSE,FALSE,FALSE,0.39,"young",48,175,72,"m"
16,"LEG EXTENSION",2,"Rep09",2400,2400,2400,2400,2400,2400,0,0,2400,"Rep",0,0,FALSE,FALSE,FALSE,0,"young",48,175,72,"m"
16,"LEG EXTENSION",2,"Rep10",2700,2680,2800,2800,2690,2800,0.041,-110,2745,"Rep",20,0,TRUE,FALSE,FALSE,3.93,"young",48,175,72,"m"
16,"LEG EXTENSION",1,"TuT",27080,27080,27300,27200,27080,27250,0.006,-170,27165,"TuT",0,100,FALSE,FALSE,FALSE,0.62,"young",48,175,72,"m"
16,"LEG EXTENSION",2,"TuT",26380,26360,26400,26450,26370,26425,0.002,-55,26397.5,"TuT",20,-50,FALSE,FALSE,FALSE,0.21,"young",48,175,72,"m"
16,"LEG CURL",1,"Con01",1600,1620,1750,1100,1610,1425,0.115,185,1517.5,"Con",-20,650,FALSE,FALSE,TRUE,12.98,"young",48,175,72,"m"
16,"LEG CURL",1,"Con02",1180,1180,1150,1150,1180,1150,0.025,30,1165,"Con",0,0,FALSE,FALSE,FALSE,2.61,"young",48,175,72,"m"
16,"LEG CURL",1,"Con03",1040,1040,1050,1000,1040,1025,0.014,15,1032.5,"Con",0,50,FALSE,FALSE,FALSE,1.46,"young",48,175,72,"m"
16,"LEG CURL",1,"Con04",920,920,950,950,920,950,0.033,-30,935,"Con",0,0,FALSE,FALSE,FALSE,3.16,"young",48,175,72,"m"
16,"LEG CURL",1,"Con05",940,960,1100,1050,950,1075,0.132,-125,1012.5,"Con",-20,50,FALSE,FALSE,FALSE,11.63,"young",48,175,72,"m"
16,"LEG CURL",1,"Con06",960,960,1100,1050,960,1075,0.12,-115,1017.5,"Con",0,50,FALSE,FALSE,FALSE,10.7,"young",48,175,72,"m"
16,"LEG CURL",1,"Con07",1200,1200,1300,1250,1200,1275,0.062,-75,1237.5,"Con",0,50,FALSE,FALSE,FALSE,5.88,"young",48,175,72,"m"
16,"LEG CURL",1,"Con08",980,960,1100,1150,970,1125,0.16,-155,1047.5,"Con",20,-50,FALSE,FALSE,FALSE,13.78,"young",48,175,72,"m"
16,"LEG CURL",1,"Con09",1000,1020,1100,1150,1010,1125,0.114,-115,1067.5,"Con",-20,-50,FALSE,FALSE,FALSE,10.22,"young",48,175,72,"m"
16,"LEG CURL",1,"Con10",1160,1160,1200,1200,1160,1200,0.034,-40,1180,"Con",0,0,FALSE,FALSE,FALSE,3.33,"young",48,175,72,"m"
16,"LEG CURL",2,"Con01",1260,1220,1150,1250,1240,1200,0.032,40,1220,"Con",40,-100,FALSE,FALSE,FALSE,3.33,"young",48,175,72,"m"
16,"LEG CURL",2,"Con02",960,960,950,1000,960,975,0.016,-15,967.5,"Con",0,-50,FALSE,FALSE,FALSE,1.54,"young",48,175,72,"m"
16,"LEG CURL",2,"Con03",1020,1040,1050,1100,1030,1075,0.044,-45,1052.5,"Con",-20,-50,FALSE,FALSE,FALSE,4.19,"young",48,175,72,"m"
16,"LEG CURL",2,"Con04",900,900,1000,950,900,975,0.083,-75,937.5,"Con",0,50,FALSE,FALSE,FALSE,7.69,"young",48,175,72,"m"
16,"LEG CURL",2,"Con05",980,1020,1100,1050,1000,1075,0.075,-75,1037.5,"Con",-40,50,FALSE,FALSE,FALSE,6.98,"young",48,175,72,"m"
16,"LEG CURL",2,"Con06",980,980,1050,1000,980,1025,0.046,-45,1002.5,"Con",0,50,FALSE,FALSE,FALSE,4.39,"young",48,175,72,"m"
16,"LEG CURL",2,"Con07",940,920,950,1000,930,975,0.048,-45,952.5,"Con",20,-50,FALSE,FALSE,FALSE,4.62,"young",48,175,72,"m"
16,"LEG CURL",2,"Con08",880,860,900,950,870,925,0.063,-55,897.5,"Con",20,-50,FALSE,FALSE,FALSE,5.95,"young",48,175,72,"m"
16,"LEG CURL",2,"Con09",860,860,1000,1000,860,1000,0.163,-140,930,"Con",0,0,FALSE,FALSE,FALSE,14,"young",48,175,72,"m"
16,"LEG CURL",2,"Con10",1180,1180,1400,1400,1180,1400,0.186,-220,1290,"Con",0,0,FALSE,FALSE,FALSE,15.71,"young",48,175,72,"m"
16,"LEG CURL",1,"Ecc01",2400,2400,2400,2400,2400,2400,0,0,2400,"Ecc",0,0,FALSE,FALSE,FALSE,0,"young",48,175,72,"m"
16,"LEG CURL",1,"Ecc02",2060,2060,2050,2100,2060,2075,0.007,-15,2067.5,"Ecc",0,-50,FALSE,FALSE,FALSE,0.72,"young",48,175,72,"m"
16,"LEG CURL",1,"Ecc03",2020,2020,2000,2050,2020,2025,0.002,-5,2022.5,"Ecc",0,-50,FALSE,FALSE,FALSE,0.25,"young",48,175,72,"m"
16,"LEG CURL",1,"Ecc04",2020,2020,1900,1900,2020,1900,0.059,120,1960,"Ecc",0,0,FALSE,FALSE,FALSE,6.32,"young",48,175,72,"m"
16,"LEG CURL",1,"Ecc05",1940,1940,1800,1850,1940,1825,0.059,115,1882.5,"Ecc",0,-50,FALSE,FALSE,FALSE,6.3,"young",48,175,72,"m"
16,"LEG CURL",1,"Ecc06",2020,2000,1900,1950,2010,1925,0.042,85,1967.5,"Ecc",20,-50,FALSE,FALSE,FALSE,4.42,"young",48,175,72,"m"
16,"LEG CURL",1,"Ecc07",1840,1860,1700,1700,1850,1700,0.081,150,1775,"Ecc",-20,0,FALSE,FALSE,FALSE,8.82,"young",48,175,72,"m"
16,"LEG CURL",1,"Ecc08",1820,1820,1750,1650,1820,1700,0.066,120,1760,"Ecc",0,100,FALSE,FALSE,FALSE,7.06,"young",48,175,72,"m"
16,"LEG CURL",1,"Ecc09",1700,1680,1650,1650,1690,1650,0.024,40,1670,"Ecc",20,0,FALSE,FALSE,FALSE,2.42,"young",48,175,72,"m"
16,"LEG CURL",1,"Ecc10",2000,1980,2100,2000,1990,2050,0.03,-60,2020,"Ecc",20,100,FALSE,FALSE,FALSE,2.93,"young",48,175,72,"m"
16,"LEG CURL",2,"Ecc01",2360,2360,2400,2350,2360,2375,0.006,-15,2367.5,"Ecc",0,50,FALSE,FALSE,FALSE,0.63,"young",48,175,72,"m"
16,"LEG CURL",2,"Ecc02",1800,1780,1800,1750,1790,1775,0.008,15,1782.5,"Ecc",20,50,FALSE,FALSE,FALSE,0.85,"young",48,175,72,"m"
16,"LEG CURL",2,"Ecc03",1780,1780,1700,1700,1780,1700,0.045,80,1740,"Ecc",0,0,FALSE,FALSE,FALSE,4.71,"young",48,175,72,"m"
16,"LEG CURL",2,"Ecc04",1820,1800,1700,1750,1810,1725,0.047,85,1767.5,"Ecc",20,-50,FALSE,FALSE,FALSE,4.93,"young",48,175,72,"m"
16,"LEG CURL",2,"Ecc05",1880,1860,1800,1850,1870,1825,0.024,45,1847.5,"Ecc",20,-50,FALSE,FALSE,FALSE,2.47,"young",48,175,72,"m"
16,"LEG CURL",2,"Ecc06",1960,1980,1900,1900,1970,1900,0.036,70,1935,"Ecc",-20,0,FALSE,FALSE,FALSE,3.68,"young",48,175,72,"m"
16,"LEG CURL",2,"Ecc07",1800,1820,1800,1750,1810,1775,0.019,35,1792.5,"Ecc",-20,50,FALSE,FALSE,FALSE,1.97,"young",48,175,72,"m"
16,"LEG CURL",2,"Ecc08",1800,1800,1700,1700,1800,1700,0.056,100,1750,"Ecc",0,0,FALSE,FALSE,FALSE,5.88,"young",48,175,72,"m"
16,"LEG CURL",2,"Ecc09",2000,2000,1800,1750,2000,1775,0.112,225,1887.5,"Ecc",0,50,FALSE,FALSE,FALSE,12.68,"young",48,175,72,"m"
16,"LEG CURL",2,"Ecc10",1700,1680,1700,1650,1690,1675,0.009,15,1682.5,"Ecc",20,50,FALSE,FALSE,FALSE,0.9,"young",48,175,72,"m"
16,"LEG CURL",1,"Rep01",4000,4020,4150,3500,4010,3825,0.046,185,3917.5,"Rep",-20,650,TRUE,FALSE,TRUE,4.84,"young",48,175,72,"m"
16,"LEG CURL",1,"Rep02",3240,3240,3200,3250,3240,3225,0.005,15,3232.5,"Rep",0,-50,FALSE,FALSE,FALSE,0.47,"young",48,175,72,"m"
16,"LEG CURL",1,"Rep03",3060,3060,3050,3050,3060,3050,0.003,10,3055,"Rep",0,0,FALSE,FALSE,FALSE,0.33,"young",48,175,72,"m"
16,"LEG CURL",1,"Rep04",2940,2940,2850,2850,2940,2850,0.031,90,2895,"Rep",0,0,FALSE,FALSE,FALSE,3.16,"young",48,175,72,"m"
16,"LEG CURL",1,"Rep05",2880,2900,2900,2900,2890,2900,0.003,-10,2895,"Rep",-20,0,FALSE,FALSE,FALSE,0.34,"young",48,175,72,"m"
16,"LEG CURL",1,"Rep06",2980,2960,3000,3000,2970,3000,0.01,-30,2985,"Rep",20,0,FALSE,FALSE,FALSE,1,"young",48,175,72,"m"
16,"LEG CURL",1,"Rep07",3040,3060,3000,2950,3050,2975,0.025,75,3012.5,"Rep",-20,50,FALSE,FALSE,FALSE,2.52,"young",48,175,72,"m"
16,"LEG CURL",1,"Rep08",2800,2780,2850,2800,2790,2825,0.013,-35,2807.5,"Rep",20,50,FALSE,FALSE,FALSE,1.24,"young",48,175,72,"m"
16,"LEG CURL",1,"Rep09",2700,2700,2750,2800,2700,2775,0.028,-75,2737.5,"Rep",0,-50,FALSE,FALSE,FALSE,2.7,"young",48,175,72,"m"
16,"LEG CURL",1,"Rep10",3160,3140,3300,3200,3150,3250,0.032,-100,3200,"Rep",20,100,FALSE,FALSE,FALSE,3.08,"young",48,175,72,"m"
16,"LEG CURL",2,"Rep01",3620,3580,3550,3600,3600,3575,0.007,25,3587.5,"Rep",40,-50,FALSE,FALSE,FALSE,0.7,"young",48,175,72,"m"
16,"LEG CURL",2,"Rep02",2760,2740,2750,2750,2750,2750,0,0,2750,"Rep",20,0,FALSE,FALSE,FALSE,0,"young",48,175,72,"m"
16,"LEG CURL",2,"Rep03",2800,2820,2750,2800,2810,2775,0.012,35,2792.5,"Rep",-20,-50,FALSE,FALSE,FALSE,1.26,"young",48,175,72,"m"
16,"LEG CURL",2,"Rep04",2720,2700,2700,2700,2710,2700,0.004,10,2705,"Rep",20,0,FALSE,FALSE,FALSE,0.37,"young",48,175,72,"m"
16,"LEG CURL",2,"Rep05",2860,2880,2900,2900,2870,2900,0.01,-30,2885,"Rep",-20,0,FALSE,FALSE,FALSE,1.03,"young",48,175,72,"m"
16,"LEG CURL",2,"Rep06",2940,2960,2950,2900,2950,2925,0.008,25,2937.5,"Rep",-20,50,FALSE,FALSE,FALSE,0.85,"young",48,175,72,"m"
16,"LEG CURL",2,"Rep07",2740,2740,2750,2750,2740,2750,0.004,-10,2745,"Rep",0,0,FALSE,FALSE,FALSE,0.36,"young",48,175,72,"m"
16,"LEG CURL",2,"Rep08",2680,2660,2600,2650,2670,2625,0.017,45,2647.5,"Rep",20,-50,FALSE,FALSE,FALSE,1.71,"young",48,175,72,"m"
16,"LEG CURL",2,"Rep09",2860,2860,2800,2750,2860,2775,0.03,85,2817.5,"Rep",0,50,FALSE,FALSE,FALSE,3.06,"young",48,175,72,"m"
16,"LEG CURL",2,"Rep10",2880,2860,3100,3050,2870,3075,0.071,-205,2972.5,"Rep",20,50,TRUE,FALSE,FALSE,6.67,"young",48,175,72,"m"
16,"LEG CURL",1,"TuT",30800,30800,31050,30300,30800,30675,0.004,125,30737.5,"TuT",0,750,FALSE,FALSE,TRUE,0.41,"young",48,175,72,"m"
16,"LEG CURL",2,"TuT",28860,28800,28850,28850,28830,28850,0.001,-20,28840,"TuT",60,0,FALSE,TRUE,FALSE,0.07,"young",48,175,72,"m"
16,"ABDUCTOR",1,"Con01",720,720,1050,1200,720,1125,0.562,-405,922.5,"Con",0,-150,TRUE,FALSE,FALSE,36,"young",48,175,72,"m"
16,"ABDUCTOR",1,"Con02",1080,1100,1100,1000,1090,1050,0.037,40,1070,"Con",-20,100,FALSE,FALSE,FALSE,3.81,"young",48,175,72,"m"
16,"ABDUCTOR",1,"Con03",720,700,850,900,710,875,0.232,-165,792.5,"Con",20,-50,FALSE,FALSE,FALSE,18.86,"young",48,175,72,"m"
16,"ABDUCTOR",1,"Con04",840,880,850,900,860,875,0.017,-15,867.5,"Con",-40,-50,FALSE,TRUE,FALSE,1.71,"young",48,175,72,"m"
16,"ABDUCTOR",1,"Con05",640,640,750,750,640,750,0.172,-110,695,"Con",0,0,FALSE,FALSE,FALSE,14.67,"young",48,175,72,"m"
16,"ABDUCTOR",1,"Con06",640,660,750,750,650,750,0.154,-100,700,"Con",-20,0,FALSE,FALSE,FALSE,13.33,"young",48,175,72,"m"
16,"ABDUCTOR",1,"Con07",540,540,800,700,540,750,0.389,-210,645,"Con",0,100,FALSE,FALSE,FALSE,28,"young",48,175,72,"m"
16,"ABDUCTOR",1,"Con08",820,820,1000,1000,820,1000,0.22,-180,910,"Con",0,0,FALSE,FALSE,FALSE,18,"young",48,175,72,"m"
16,"ABDUCTOR",1,"Con09",700,740,1000,950,720,975,0.354,-255,847.5,"Con",-40,50,FALSE,TRUE,FALSE,26.15,"young",48,175,72,"m"
16,"ABDUCTOR",1,"Con10",660,680,1300,1350,670,1325,0.978,-655,997.5,"Con",-20,-50,TRUE,FALSE,FALSE,49.43,"young",48,175,72,"m"
16,"ABDUCTOR",2,"Con01",820,820,750,750,820,750,0.085,70,785,"Con",0,0,FALSE,FALSE,FALSE,9.33,"young",48,175,72,"m"
16,"ABDUCTOR",2,"Con02",580,560,750,700,570,725,0.272,-155,647.5,"Con",20,50,FALSE,FALSE,FALSE,21.38,"young",48,175,72,"m"
16,"ABDUCTOR",2,"Con03",920,920,1400,1950,920,1675,0.821,-755,1297.5,"Con",0,-550,TRUE,FALSE,TRUE,45.07,"young",48,175,72,"m"
16,"ABDUCTOR",2,"Con04",800,800,1000,1700,800,1350,0.688,-550,1075,"Con",0,-700,TRUE,FALSE,TRUE,40.74,"young",48,175,72,"m"
16,"ABDUCTOR",2,"Con05",940,940,1000,1200,940,1100,0.17,-160,1020,"Con",0,-200,FALSE,FALSE,FALSE,14.55,"young",48,175,72,"m"
16,"ABDUCTOR",2,"Con06",720,720,850,850,720,850,0.181,-130,785,"Con",0,0,FALSE,FALSE,FALSE,15.29,"young",48,175,72,"m"
16,"ABDUCTOR",2,"Con07",840,820,950,900,830,925,0.114,-95,877.5,"Con",20,50,FALSE,FALSE,FALSE,10.27,"young",48,175,72,"m"
16,"ABDUCTOR",2,"Con08",700,720,800,700,710,750,0.056,-40,730,"Con",-20,100,FALSE,FALSE,FALSE,5.33,"young",48,175,72,"m"
16,"ABDUCTOR",2,"Con09",820,840,900,850,830,875,0.054,-45,852.5,"Con",-20,50,FALSE,FALSE,FALSE,5.14,"young",48,175,72,"m"
16,"ABDUCTOR",2,"Con10",860,860,1000,950,860,975,0.134,-115,917.5,"Con",0,50,FALSE,FALSE,FALSE,11.79,"young",48,175,72,"m"
16,"ABDUCTOR",1,"Ecc01",1440,1420,1350,1550,1430,1450,0.014,-20,1440,"Ecc",20,-200,FALSE,FALSE,FALSE,1.38,"young",48,175,72,"m"
16,"ABDUCTOR",1,"Ecc02",1780,1780,1650,1600,1780,1625,0.087,155,1702.5,"Ecc",0,50,FALSE,FALSE,FALSE,9.54,"young",48,175,72,"m"
16,"ABDUCTOR",1,"Ecc03",1880,1880,1850,1750,1880,1800,0.043,80,1840,"Ecc",0,100,FALSE,FALSE,FALSE,4.44,"young",48,175,72,"m"
16,"ABDUCTOR",1,"Ecc04",1800,1780,1700,1750,1790,1725,0.036,65,1757.5,"Ecc",20,-50,FALSE,FALSE,FALSE,3.77,"young",48,175,72,"m"
16,"ABDUCTOR",1,"Ecc05",2000,1980,1900,1850,1990,1875,0.058,115,1932.5,"Ecc",20,50,FALSE,FALSE,FALSE,6.13,"young",48,175,72,"m"
16,"ABDUCTOR",1,"Ecc06",1680,1680,1450,1550,1680,1500,0.107,180,1590,"Ecc",0,-100,FALSE,FALSE,FALSE,12,"young",48,175,72,"m"
16,"ABDUCTOR",1,"Ecc07",1920,1920,1700,1750,1920,1725,0.102,195,1822.5,"Ecc",0,-50,FALSE,FALSE,FALSE,11.3,"young",48,175,72,"m"
16,"ABDUCTOR",1,"Ecc08",1860,1840,1600,1650,1850,1625,0.122,225,1737.5,"Ecc",20,-50,FALSE,FALSE,FALSE,13.85,"young",48,175,72,"m"
16,"ABDUCTOR",1,"Ecc09",1760,1720,1150,1050,1740,1100,0.368,640,1420,"Ecc",40,100,TRUE,TRUE,FALSE,58.18,"young",48,175,72,"m"
16,"ABDUCTOR",1,"Ecc10",1740,1700,650,1750,1720,1200,0.302,520,1460,"Ecc",40,-1100,TRUE,TRUE,TRUE,43.33,"young",48,175,72,"m"
16,"ABDUCTOR",2,"Ecc01",1940,1960,1850,1950,1950,1900,0.026,50,1925,"Ecc",-20,-100,FALSE,FALSE,FALSE,2.63,"young",48,175,72,"m"
16,"ABDUCTOR",2,"Ecc02",1660,1660,1200,650,1660,925,0.443,735,1292.5,"Ecc",0,550,TRUE,FALSE,TRUE,79.46,"young",48,175,72,"m"
16,"ABDUCTOR",2,"Ecc03",1900,1920,1600,950,1910,1275,0.332,635,1592.5,"Ecc",-20,650,TRUE,FALSE,TRUE,49.8,"young",48,175,72,"m"
16,"ABDUCTOR",2,"Ecc04",1640,1640,1600,1350,1640,1475,0.101,165,1557.5,"Ecc",0,250,FALSE,FALSE,FALSE,11.19,"young",48,175,72,"m"
16,"ABDUCTOR",2,"Ecc05",2100,2080,1950,1900,2090,1925,0.079,165,2007.5,"Ecc",20,50,FALSE,FALSE,FALSE,8.57,"young",48,175,72,"m"
16,"ABDUCTOR",2,"Ecc06",1880,1900,1750,1850,1890,1800,0.048,90,1845,"Ecc",-20,-100,FALSE,FALSE,FALSE,5,"young",48,175,72,"m"
16,"ABDUCTOR",2,"Ecc07",1860,1860,1800,1850,1860,1825,0.019,35,1842.5,"Ecc",0,-50,FALSE,FALSE,FALSE,1.92,"young",48,175,72,"m"
16,"ABDUCTOR",2,"Ecc08",1760,1720,1650,1700,1740,1675,0.037,65,1707.5,"Ecc",40,-50,FALSE,TRUE,FALSE,3.88,"young",48,175,72,"m"
16,"ABDUCTOR",2,"Ecc09",1920,1920,1800,1850,1920,1825,0.049,95,1872.5,"Ecc",0,-50,FALSE,FALSE,FALSE,5.21,"young",48,175,72,"m"
16,"ABDUCTOR",2,"Ecc10",1560,1560,1550,1600,1560,1575,0.01,-15,1567.5,"Ecc",0,-50,FALSE,FALSE,FALSE,0.95,"young",48,175,72,"m"
16,"ABDUCTOR",1,"Rep01",2160,2140,2400,2750,2150,2575,0.198,-425,2362.5,"Rep",20,-350,TRUE,FALSE,TRUE,16.5,"young",48,175,72,"m"
16,"ABDUCTOR",1,"Rep02",2860,2880,2750,2600,2870,2675,0.068,195,2772.5,"Rep",-20,150,FALSE,FALSE,FALSE,7.29,"young",48,175,72,"m"
16,"ABDUCTOR",1,"Rep03",2600,2580,2700,2650,2590,2675,0.033,-85,2632.5,"Rep",20,50,FALSE,FALSE,FALSE,3.18,"young",48,175,72,"m"
16,"ABDUCTOR",1,"Rep04",2640,2660,2550,2650,2650,2600,0.019,50,2625,"Rep",-20,-100,FALSE,FALSE,FALSE,1.92,"young",48,175,72,"m"
16,"ABDUCTOR",1,"Rep05",2640,2620,2650,2600,2630,2625,0.002,5,2627.5,"Rep",20,50,FALSE,FALSE,FALSE,0.19,"young",48,175,72,"m"
16,"ABDUCTOR",1,"Rep06",2320,2340,2200,2300,2330,2250,0.034,80,2290,"Rep",-20,-100,FALSE,FALSE,FALSE,3.56,"young",48,175,72,"m"
16,"ABDUCTOR",1,"Rep07",2460,2460,2500,2450,2460,2475,0.006,-15,2467.5,"Rep",0,50,FALSE,FALSE,FALSE,0.61,"young",48,175,72,"m"
16,"ABDUCTOR",1,"Rep08",2680,2660,2600,2650,2670,2625,0.017,45,2647.5,"Rep",20,-50,FALSE,FALSE,FALSE,1.71,"young",48,175,72,"m"
16,"ABDUCTOR",1,"Rep09",2460,2460,2150,2000,2460,2075,0.157,385,2267.5,"Rep",0,150,TRUE,FALSE,FALSE,18.55,"young",48,175,72,"m"
16,"ABDUCTOR",1,"Rep10",2400,2380,1950,3100,2390,2525,0.056,-135,2457.5,"Rep",20,-1150,FALSE,FALSE,TRUE,5.35,"young",48,175,72,"m"
16,"ABDUCTOR",2,"Rep01",2760,2780,2600,2700,2770,2650,0.043,120,2710,"Rep",-20,-100,FALSE,FALSE,FALSE,4.53,"young",48,175,72,"m"
16,"ABDUCTOR",2,"Rep02",2240,2220,1950,1350,2230,1650,0.26,580,1940,"Rep",20,600,TRUE,FALSE,TRUE,35.15,"young",48,175,72,"m"
16,"ABDUCTOR",2,"Rep03",2820,2840,3000,2900,2830,2950,0.042,-120,2890,"Rep",-20,100,FALSE,FALSE,FALSE,4.07,"young",48,175,72,"m"
16,"ABDUCTOR",2,"Rep04",2440,2440,2600,3050,2440,2825,0.158,-385,2632.5,"Rep",0,-450,TRUE,FALSE,TRUE,13.63,"young",48,175,72,"m"
16,"ABDUCTOR",2,"Rep05",3040,3020,2950,3100,3030,3025,0.002,5,3027.5,"Rep",20,-150,FALSE,FALSE,FALSE,0.17,"young",48,175,72,"m"
16,"ABDUCTOR",2,"Rep06",2600,2620,2600,2700,2610,2650,0.015,-40,2630,"Rep",-20,-100,FALSE,FALSE,FALSE,1.51,"young",48,175,72,"m"
16,"ABDUCTOR",2,"Rep07",2700,2680,2750,2750,2690,2750,0.022,-60,2720,"Rep",20,0,FALSE,FALSE,FALSE,2.18,"young",48,175,72,"m"
16,"ABDUCTOR",2,"Rep08",2460,2440,2450,2400,2450,2425,0.01,25,2437.5,"Rep",20,50,FALSE,FALSE,FALSE,1.03,"young",48,175,72,"m"
16,"ABDUCTOR",2,"Rep09",2740,2760,2700,2700,2750,2700,0.018,50,2725,"Rep",-20,0,FALSE,FALSE,FALSE,1.85,"young",48,175,72,"m"
16,"ABDUCTOR",2,"Rep10",2420,2420,2550,2550,2420,2550,0.054,-130,2485,"Rep",0,0,FALSE,FALSE,FALSE,5.1,"young",48,175,72,"m"
16,"ABDUCTOR",1,"TuT",25220,25180,24450,25750,25200,25100,0.004,100,25150,"TuT",40,-1300,FALSE,TRUE,TRUE,0.4,"young",48,175,72,"m"
16,"ABDUCTOR",2,"TuT",26220,26220,26150,26200,26220,26175,0.002,45,26197.5,"TuT",0,-50,FALSE,FALSE,FALSE,0.17,"young",48,175,72,"m"
16,"ADDUCTOR",1,"Con01",900,880,1200,1250,890,1225,0.376,-335,1057.5,"Con",20,-50,FALSE,FALSE,FALSE,27.35,"young",48,175,72,"m"
16,"ADDUCTOR",1,"Con02",600,600,750,750,600,750,0.25,-150,675,"Con",0,0,FALSE,FALSE,FALSE,20,"young",48,175,72,"m"
16,"ADDUCTOR",1,"Con03",920,920,600,800,920,700,0.239,220,810,"Con",0,-200,FALSE,FALSE,FALSE,31.43,"young",48,175,72,"m"
16,"ADDUCTOR",1,"Con04",960,960,950,900,960,925,0.036,35,942.5,"Con",0,50,FALSE,FALSE,FALSE,3.78,"young",48,175,72,"m"
16,"ADDUCTOR",1,"Con05",780,780,1000,950,780,975,0.25,-195,877.5,"Con",0,50,FALSE,FALSE,FALSE,20,"young",48,175,72,"m"
16,"ADDUCTOR",1,"Con06",700,700,1750,1050,700,1400,1,-700,1050,"Con",0,700,TRUE,FALSE,TRUE,50,"young",48,175,72,"m"
16,"ADDUCTOR",1,"Con07",760,760,850,950,760,900,0.184,-140,830,"Con",0,-100,FALSE,FALSE,FALSE,15.56,"young",48,175,72,"m"
16,"ADDUCTOR",1,"Con08",800,800,900,1050,800,975,0.219,-175,887.5,"Con",0,-150,FALSE,FALSE,FALSE,17.95,"young",48,175,72,"m"
16,"ADDUCTOR",1,"Con09",760,780,900,950,770,925,0.201,-155,847.5,"Con",-20,-50,FALSE,FALSE,FALSE,16.76,"young",48,175,72,"m"
16,"ADDUCTOR",1,"Con10",900,920,1150,1100,910,1125,0.236,-215,1017.5,"Con",-20,50,FALSE,FALSE,FALSE,19.11,"young",48,175,72,"m"
16,"ADDUCTOR",2,"Con01",740,760,1050,1050,750,1050,0.4,-300,900,"Con",-20,0,FALSE,FALSE,FALSE,28.57,"young",48,175,72,"m"
16,"ADDUCTOR",2,"Con02",1080,1080,950,1000,1080,975,0.097,105,1027.5,"Con",0,-50,FALSE,FALSE,FALSE,10.77,"young",48,175,72,"m"
16,"ADDUCTOR",2,"Con03",840,840,850,850,840,850,0.012,-10,845,"Con",0,0,FALSE,FALSE,FALSE,1.18,"young",48,175,72,"m"
16,"ADDUCTOR",2,"Con04",860,860,850,900,860,875,0.017,-15,867.5,"Con",0,-50,FALSE,FALSE,FALSE,1.71,"young",48,175,72,"m"
16,"ADDUCTOR",2,"Con05",740,740,750,850,740,800,0.081,-60,770,"Con",0,-100,FALSE,FALSE,FALSE,7.5,"young",48,175,72,"m"
16,"ADDUCTOR",2,"Con06",720,720,750,500,720,625,0.132,95,672.5,"Con",0,250,FALSE,FALSE,FALSE,15.2,"young",48,175,72,"m"
16,"ADDUCTOR",2,"Con07",780,740,900,850,760,875,0.151,-115,817.5,"Con",40,50,FALSE,TRUE,FALSE,13.14,"young",48,175,72,"m"
16,"ADDUCTOR",2,"Con08",820,820,1150,1450,820,1300,0.585,-480,1060,"Con",0,-300,FALSE,FALSE,FALSE,36.92,"young",48,175,72,"m"
16,"ADDUCTOR",2,"Con09",880,860,1700,1800,870,1750,1.011,-880,1310,"Con",20,-100,TRUE,FALSE,FALSE,50.29,"young",48,175,72,"m"
16,"ADDUCTOR",2,"Con10",800,800,1150,1400,800,1275,0.594,-475,1037.5,"Con",0,-250,FALSE,FALSE,FALSE,37.25,"young",48,175,72,"m"
16,"ADDUCTOR",1,"Ecc01",1580,1580,1400,1450,1580,1425,0.098,155,1502.5,"Ecc",0,-50,FALSE,FALSE,FALSE,10.88,"young",48,175,72,"m"
16,"ADDUCTOR",1,"Ecc02",1780,1780,1950,1800,1780,1875,0.053,-95,1827.5,"Ecc",0,150,FALSE,FALSE,FALSE,5.07,"young",48,175,72,"m"
16,"ADDUCTOR",1,"Ecc03",1800,1800,1900,1900,1800,1900,0.056,-100,1850,"Ecc",0,0,FALSE,FALSE,FALSE,5.26,"young",48,175,72,"m"
16,"ADDUCTOR",1,"Ecc04",1700,1700,1600,1600,1700,1600,0.059,100,1650,"Ecc",0,0,FALSE,FALSE,FALSE,6.25,"young",48,175,72,"m"
16,"ADDUCTOR",1,"Ecc05",1720,1720,650,1400,1720,1025,0.404,695,1372.5,"Ecc",0,-750,TRUE,FALSE,TRUE,67.8,"young",48,175,72,"m"
16,"ADDUCTOR",1,"Ecc06",1640,1640,1500,1450,1640,1475,0.101,165,1557.5,"Ecc",0,50,FALSE,FALSE,FALSE,11.19,"young",48,175,72,"m"
16,"ADDUCTOR",1,"Ecc07",1720,1720,1600,1450,1720,1525,0.113,195,1622.5,"Ecc",0,150,FALSE,FALSE,FALSE,12.79,"young",48,175,72,"m"
16,"ADDUCTOR",1,"Ecc08",1620,1600,1550,1400,1610,1475,0.084,135,1542.5,"Ecc",20,150,FALSE,FALSE,FALSE,9.15,"young",48,175,72,"m"
16,"ADDUCTOR",1,"Ecc09",1580,1560,1350,1400,1570,1375,0.124,195,1472.5,"Ecc",20,-50,FALSE,FALSE,FALSE,14.18,"young",48,175,72,"m"
16,"ADDUCTOR",1,"Ecc10",1280,1280,1300,1300,1280,1300,0.016,-20,1290,"Ecc",0,0,FALSE,FALSE,FALSE,1.54,"young",48,175,72,"m"
16,"ADDUCTOR",2,"Ecc01",1460,1460,1400,1350,1460,1375,0.058,85,1417.5,"Ecc",0,50,FALSE,FALSE,FALSE,6.18,"young",48,175,72,"m"
16,"ADDUCTOR",2,"Ecc02",1680,1680,1700,1750,1680,1725,0.027,-45,1702.5,"Ecc",0,-50,FALSE,FALSE,FALSE,2.61,"young",48,175,72,"m"
16,"ADDUCTOR",2,"Ecc03",1680,1680,1700,1650,1680,1675,0.003,5,1677.5,"Ecc",0,50,FALSE,FALSE,FALSE,0.3,"young",48,175,72,"m"
16,"ADDUCTOR",2,"Ecc04",1620,1620,1550,1450,1620,1500,0.074,120,1560,"Ecc",0,100,FALSE,FALSE,FALSE,8,"young",48,175,72,"m"
16,"ADDUCTOR",2,"Ecc05",1520,1520,1600,1700,1520,1650,0.086,-130,1585,"Ecc",0,-100,FALSE,FALSE,FALSE,7.88,"young",48,175,72,"m"
16,"ADDUCTOR",2,"Ecc06",1460,1500,1350,1550,1480,1450,0.02,30,1465,"Ecc",-40,-200,FALSE,TRUE,FALSE,2.07,"young",48,175,72,"m"
16,"ADDUCTOR",2,"Ecc07",1500,1500,1250,950,1500,1100,0.267,400,1300,"Ecc",0,300,FALSE,FALSE,FALSE,36.36,"young",48,175,72,"m"
16,"ADDUCTOR",2,"Ecc08",1420,1440,550,450,1430,500,0.65,930,965,"Ecc",-20,100,TRUE,FALSE,FALSE,186,"young",48,175,72,"m"
16,"ADDUCTOR",2,"Ecc09",1680,1680,1300,1050,1680,1175,0.301,505,1427.5,"Ecc",0,250,FALSE,FALSE,FALSE,42.98,"young",48,175,72,"m"
16,"ADDUCTOR",2,"Ecc10",1440,1440,1350,1500,1440,1425,0.01,15,1432.5,"Ecc",0,-150,FALSE,FALSE,FALSE,1.05,"young",48,175,72,"m"
16,"ADDUCTOR",1,"Rep01",2480,2460,2600,2700,2470,2650,0.073,-180,2560,"Rep",20,-100,FALSE,FALSE,FALSE,6.79,"young",48,175,72,"m"
16,"ADDUCTOR",1,"Rep02",2380,2380,2700,2550,2380,2625,0.103,-245,2502.5,"Rep",0,150,FALSE,FALSE,FALSE,9.33,"young",48,175,72,"m"
16,"ADDUCTOR",1,"Rep03",2720,2720,2500,2700,2720,2600,0.044,120,2660,"Rep",0,-200,FALSE,FALSE,FALSE,4.62,"young",48,175,72,"m"
16,"ADDUCTOR",1,"Rep04",2660,2660,2550,2500,2660,2525,0.051,135,2592.5,"Rep",0,50,FALSE,FALSE,FALSE,5.35,"young",48,175,72,"m"
16,"ADDUCTOR",1,"Rep05",2500,2500,1650,2350,2500,2000,0.2,500,2250,"Rep",0,-700,TRUE,FALSE,TRUE,25,"young",48,175,72,"m"
16,"ADDUCTOR",1,"Rep06",2340,2340,3250,2500,2340,2875,0.229,-535,2607.5,"Rep",0,750,TRUE,FALSE,TRUE,18.61,"young",48,175,72,"m"
16,"ADDUCTOR",1,"Rep07",2480,2480,2450,2400,2480,2425,0.022,55,2452.5,"Rep",0,50,FALSE,FALSE,FALSE,2.27,"young",48,175,72,"m"
16,"ADDUCTOR",1,"Rep08",2420,2400,2450,2450,2410,2450,0.017,-40,2430,"Rep",20,0,FALSE,FALSE,FALSE,1.63,"young",48,175,72,"m"
16,"ADDUCTOR",1,"Rep09",2340,2340,2250,2350,2340,2300,0.017,40,2320,"Rep",0,-100,FALSE,FALSE,FALSE,1.74,"young",48,175,72,"m"
16,"ADDUCTOR",1,"Rep10",2180,2200,2450,2400,2190,2425,0.107,-235,2307.5,"Rep",-20,50,FALSE,FALSE,FALSE,9.69,"young",48,175,72,"m"
16,"ADDUCTOR",2,"Rep01",2200,2220,2450,2400,2210,2425,0.097,-215,2317.5,"Rep",-20,50,FALSE,FALSE,FALSE,8.87,"young",48,175,72,"m"
16,"ADDUCTOR",2,"Rep02",2760,2760,2650,2750,2760,2700,0.022,60,2730,"Rep",0,-100,FALSE,FALSE,FALSE,2.22,"young",48,175,72,"m"
16,"ADDUCTOR",2,"Rep03",2520,2520,2550,2500,2520,2525,0.002,-5,2522.5,"Rep",0,50,FALSE,FALSE,FALSE,0.2,"young",48,175,72,"m"
16,"ADDUCTOR",2,"Rep04",2480,2480,2400,2350,2480,2375,0.042,105,2427.5,"Rep",0,50,FALSE,FALSE,FALSE,4.42,"young",48,175,72,"m"
16,"ADDUCTOR",2,"Rep05",2260,2260,2350,2550,2260,2450,0.084,-190,2355,"Rep",0,-200,FALSE,FALSE,FALSE,7.76,"young",48,175,72,"m"
16,"ADDUCTOR",2,"Rep06",2180,2220,2100,2050,2200,2075,0.057,125,2137.5,"Rep",-40,50,FALSE,FALSE,FALSE,6.02,"young",48,175,72,"m"
16,"ADDUCTOR",2,"Rep07",2280,2240,2150,1800,2260,1975,0.126,285,2117.5,"Rep",40,350,FALSE,FALSE,TRUE,14.43,"young",48,175,72,"m"
16,"ADDUCTOR",2,"Rep08",2240,2260,1700,1900,2250,1800,0.2,450,2025,"Rep",-20,-200,TRUE,FALSE,FALSE,25,"young",48,175,72,"m"
16,"ADDUCTOR",2,"Rep09",2560,2540,3000,2850,2550,2925,0.147,-375,2737.5,"Rep",20,150,TRUE,FALSE,FALSE,12.82,"young",48,175,72,"m"
16,"ADDUCTOR",2,"Rep10",2240,2240,2500,2900,2240,2700,0.205,-460,2470,"Rep",0,-400,TRUE,FALSE,TRUE,17.04,"young",48,175,72,"m"
16,"ADDUCTOR",1,"TuT",24500,24480,24850,24900,24490,24875,0.016,-385,24682.5,"TuT",20,-50,FALSE,FALSE,FALSE,1.55,"young",48,175,72,"m"
16,"ADDUCTOR",2,"TuT",23720,23740,23850,24050,23730,23950,0.009,-220,23840,"TuT",-20,-200,FALSE,FALSE,FALSE,0.92,"young",48,175,72,"m"
16,"LOWER BACK",1,"Con01",1140,1120,1250,1250,1130,1250,0.106,-120,1190,"Con",20,0,FALSE,FALSE,FALSE,9.6,"young",48,175,72,"m"
16,"LOWER BACK",1,"Con02",1180,1200,1250,1250,1190,1250,0.05,-60,1220,"Con",-20,0,FALSE,FALSE,FALSE,4.8,"young",48,175,72,"m"
16,"LOWER BACK",1,"Con03",1220,1240,1250,1300,1230,1275,0.037,-45,1252.5,"Con",-20,-50,FALSE,FALSE,FALSE,3.53,"young",48,175,72,"m"
16,"LOWER BACK",1,"Con04",1180,1200,1250,1300,1190,1275,0.071,-85,1232.5,"Con",-20,-50,FALSE,FALSE,FALSE,6.67,"young",48,175,72,"m"
16,"LOWER BACK",1,"Con05",1220,1240,1300,1300,1230,1300,0.057,-70,1265,"Con",-20,0,FALSE,FALSE,FALSE,5.38,"young",48,175,72,"m"
16,"LOWER BACK",1,"Con06",1100,1100,1200,1200,1100,1200,0.091,-100,1150,"Con",0,0,FALSE,FALSE,FALSE,8.33,"young",48,175,72,"m"
16,"LOWER BACK",1,"Con07",1300,1320,1400,1450,1310,1425,0.088,-115,1367.5,"Con",-20,-50,FALSE,FALSE,FALSE,8.07,"young",48,175,72,"m"
16,"LOWER BACK",1,"Con08",1300,1320,1500,1450,1310,1475,0.126,-165,1392.5,"Con",-20,50,FALSE,FALSE,FALSE,11.19,"young",48,175,72,"m"
16,"LOWER BACK",1,"Con09",1360,1380,1500,1400,1370,1450,0.058,-80,1410,"Con",-20,100,FALSE,FALSE,FALSE,5.52,"young",48,175,72,"m"
16,"LOWER BACK",1,"Con10",1260,1280,1350,1350,1270,1350,0.063,-80,1310,"Con",-20,0,FALSE,FALSE,FALSE,5.93,"young",48,175,72,"m"
16,"LOWER BACK",2,"Con01",1320,1320,1450,1450,1320,1450,0.098,-130,1385,"Con",0,0,FALSE,FALSE,FALSE,8.97,"young",48,175,72,"m"
16,"LOWER BACK",2,"Con02",1320,1320,1350,1300,1320,1325,0.004,-5,1322.5,"Con",0,50,FALSE,FALSE,FALSE,0.38,"young",48,175,72,"m"
16,"LOWER BACK",2,"Con03",1280,1320,1350,1350,1300,1350,0.038,-50,1325,"Con",-40,0,FALSE,TRUE,FALSE,3.7,"young",48,175,72,"m"
16,"LOWER BACK",2,"Con04",1280,1280,1400,1350,1280,1375,0.074,-95,1327.5,"Con",0,50,FALSE,FALSE,FALSE,6.91,"young",48,175,72,"m"
16,"LOWER BACK",2,"Con05",1320,1300,1350,1350,1310,1350,0.031,-40,1330,"Con",20,0,FALSE,FALSE,FALSE,2.96,"young",48,175,72,"m"
16,"LOWER BACK",2,"Con06",1220,1220,1300,1300,1220,1300,0.066,-80,1260,"Con",0,0,FALSE,FALSE,FALSE,6.15,"young",48,175,72,"m"
16,"LOWER BACK",2,"Con07",1220,1180,1250,1250,1200,1250,0.042,-50,1225,"Con",40,0,FALSE,TRUE,FALSE,4,"young",48,175,72,"m"
16,"LOWER BACK",2,"Con08",1280,1260,1350,1350,1270,1350,0.063,-80,1310,"Con",20,0,FALSE,FALSE,FALSE,5.93,"young",48,175,72,"m"
16,"LOWER BACK",2,"Con09",1140,1140,1250,1300,1140,1275,0.118,-135,1207.5,"Con",0,-50,FALSE,FALSE,FALSE,10.59,"young",48,175,72,"m"
16,"LOWER BACK",2,"Con10",1220,1220,1350,1400,1220,1375,0.127,-155,1297.5,"Con",0,-50,FALSE,FALSE,FALSE,11.27,"young",48,175,72,"m"
16,"LOWER BACK",1,"Ecc01",2240,2240,2200,2150,2240,2175,0.029,65,2207.5,"Ecc",0,50,FALSE,FALSE,FALSE,2.99,"young",48,175,72,"m"
16,"LOWER BACK",1,"Ecc02",2120,2120,2050,2050,2120,2050,0.033,70,2085,"Ecc",0,0,FALSE,FALSE,FALSE,3.41,"young",48,175,72,"m"
16,"LOWER BACK",1,"Ecc03",1960,1940,1900,1850,1950,1875,0.038,75,1912.5,"Ecc",20,50,FALSE,FALSE,FALSE,4,"young",48,175,72,"m"
16,"LOWER BACK",1,"Ecc04",2140,2120,2100,2050,2130,2075,0.026,55,2102.5,"Ecc",20,50,FALSE,FALSE,FALSE,2.65,"young",48,175,72,"m"
16,"LOWER BACK",1,"Ecc05",2000,1980,1900,1900,1990,1900,0.045,90,1945,"Ecc",20,0,FALSE,FALSE,FALSE,4.74,"young",48,175,72,"m"
16,"LOWER BACK",1,"Ecc06",2140,2140,2050,2050,2140,2050,0.042,90,2095,"Ecc",0,0,FALSE,FALSE,FALSE,4.39,"young",48,175,72,"m"
16,"LOWER BACK",1,"Ecc07",2060,2020,1900,1850,2040,1875,0.081,165,1957.5,"Ecc",40,50,FALSE,FALSE,FALSE,8.8,"young",48,175,72,"m"
16,"LOWER BACK",1,"Ecc08",1980,1980,1800,1900,1980,1850,0.066,130,1915,"Ecc",0,-100,FALSE,FALSE,FALSE,7.03,"young",48,175,72,"m"
16,"LOWER BACK",1,"Ecc09",1900,1880,1800,1850,1890,1825,0.034,65,1857.5,"Ecc",20,-50,FALSE,FALSE,FALSE,3.56,"young",48,175,72,"m"
16,"LOWER BACK",1,"Ecc10",1880,1860,1800,1800,1870,1800,0.037,70,1835,"Ecc",20,0,FALSE,FALSE,FALSE,3.89,"young",48,175,72,"m"
16,"LOWER BACK",2,"Ecc01",2080,2080,2000,2050,2080,2025,0.026,55,2052.5,"Ecc",0,-50,FALSE,FALSE,FALSE,2.72,"young",48,175,72,"m"
16,"LOWER BACK",2,"Ecc02",1920,1920,1900,1900,1920,1900,0.01,20,1910,"Ecc",0,0,FALSE,FALSE,FALSE,1.05,"young",48,175,72,"m"
16,"LOWER BACK",2,"Ecc03",2080,2040,1950,2000,2060,1975,0.041,85,2017.5,"Ecc",40,-50,FALSE,FALSE,FALSE,4.3,"young",48,175,72,"m"
16,"LOWER BACK",2,"Ecc04",2080,2080,2000,2000,2080,2000,0.038,80,2040,"Ecc",0,0,FALSE,FALSE,FALSE,4,"young",48,175,72,"m"
16,"LOWER BACK",2,"Ecc05",1760,1760,1700,1700,1760,1700,0.034,60,1730,"Ecc",0,0,FALSE,FALSE,FALSE,3.53,"young",48,175,72,"m"
16,"LOWER BACK",2,"Ecc06",1980,2020,1950,1950,2000,1950,0.025,50,1975,"Ecc",-40,0,FALSE,FALSE,FALSE,2.56,"young",48,175,72,"m"
16,"LOWER BACK",2,"Ecc07",1780,1800,1700,1750,1790,1725,0.036,65,1757.5,"Ecc",-20,-50,FALSE,FALSE,FALSE,3.77,"young",48,175,72,"m"
16,"LOWER BACK",2,"Ecc08",1720,1740,1650,1600,1730,1625,0.061,105,1677.5,"Ecc",-20,50,FALSE,FALSE,FALSE,6.46,"young",48,175,72,"m"
16,"LOWER BACK",2,"Ecc09",1920,1920,1800,1750,1920,1775,0.076,145,1847.5,"Ecc",0,50,FALSE,FALSE,FALSE,8.17,"young",48,175,72,"m"
16,"LOWER BACK",2,"Ecc10",1600,1600,1550,1550,1600,1550,0.031,50,1575,"Ecc",0,0,FALSE,FALSE,FALSE,3.23,"young",48,175,72,"m"
16,"LOWER BACK",1,"Rep01",3380,3360,3450,3400,3370,3425,0.016,-55,3397.5,"Rep",20,50,FALSE,FALSE,FALSE,1.61,"young",48,175,72,"m"
16,"LOWER BACK",1,"Rep02",3300,3320,3300,3300,3310,3300,0.003,10,3305,"Rep",-20,0,FALSE,FALSE,FALSE,0.3,"young",48,175,72,"m"
16,"LOWER BACK",1,"Rep03",3180,3180,3150,3150,3180,3150,0.009,30,3165,"Rep",0,0,FALSE,FALSE,FALSE,0.95,"young",48,175,72,"m"
16,"LOWER BACK",1,"Rep04",3320,3320,3350,3350,3320,3350,0.009,-30,3335,"Rep",0,0,FALSE,FALSE,FALSE,0.9,"young",48,175,72,"m"
16,"LOWER BACK",1,"Rep05",3220,3220,3200,3200,3220,3200,0.006,20,3210,"Rep",0,0,FALSE,FALSE,FALSE,0.62,"young",48,175,72,"m"
16,"LOWER BACK",1,"Rep06",3240,3240,3250,3250,3240,3250,0.003,-10,3245,"Rep",0,0,FALSE,FALSE,FALSE,0.31,"young",48,175,72,"m"
16,"LOWER BACK",1,"Rep07",3360,3340,3300,3300,3350,3300,0.015,50,3325,"Rep",20,0,FALSE,FALSE,FALSE,1.52,"young",48,175,72,"m"
16,"LOWER BACK",1,"Rep08",3280,3300,3300,3350,3290,3325,0.011,-35,3307.5,"Rep",-20,-50,FALSE,FALSE,FALSE,1.05,"young",48,175,72,"m"
16,"LOWER BACK",1,"Rep09",3260,3260,3300,3250,3260,3275,0.005,-15,3267.5,"Rep",0,50,FALSE,FALSE,FALSE,0.46,"young",48,175,72,"m"
16,"LOWER BACK",1,"Rep10",3140,3140,3150,3150,3140,3150,0.003,-10,3145,"Rep",0,0,FALSE,FALSE,FALSE,0.32,"young",48,175,72,"m"
16,"LOWER BACK",2,"Rep01",3400,3400,3450,3500,3400,3475,0.022,-75,3437.5,"Rep",0,-50,FALSE,FALSE,FALSE,2.16,"young",48,175,72,"m"
16,"LOWER BACK",2,"Rep02",3240,3240,3250,3200,3240,3225,0.005,15,3232.5,"Rep",0,50,FALSE,FALSE,FALSE,0.47,"young",48,175,72,"m"
16,"LOWER BACK",2,"Rep03",3360,3360,3300,3350,3360,3325,0.01,35,3342.5,"Rep",0,-50,FALSE,FALSE,FALSE,1.05,"young",48,175,72,"m"
16,"LOWER BACK",2,"Rep04",3360,3360,3400,3350,3360,3375,0.004,-15,3367.5,"Rep",0,50,FALSE,FALSE,FALSE,0.44,"young",48,175,72,"m"
16,"LOWER BACK",2,"Rep05",3080,3060,3050,3050,3070,3050,0.007,20,3060,"Rep",20,0,FALSE,FALSE,FALSE,0.66,"young",48,175,72,"m"
16,"LOWER BACK",2,"Rep06",3200,3240,3250,3250,3220,3250,0.009,-30,3235,"Rep",-40,0,FALSE,FALSE,FALSE,0.92,"young",48,175,72,"m"
16,"LOWER BACK",2,"Rep07",3000,2980,2950,3000,2990,2975,0.005,15,2982.5,"Rep",20,-50,FALSE,FALSE,FALSE,0.5,"young",48,175,72,"m"
16,"LOWER BACK",2,"Rep08",3000,3000,3000,2950,3000,2975,0.008,25,2987.5,"Rep",0,50,FALSE,FALSE,FALSE,0.84,"young",48,175,72,"m"
16,"LOWER BACK",2,"Rep09",3060,3060,3050,3050,3060,3050,0.003,10,3055,"Rep",0,0,FALSE,FALSE,FALSE,0.33,"young",48,175,72,"m"
16,"LOWER BACK",2,"Rep10",2820,2820,2900,2950,2820,2925,0.037,-105,2872.5,"Rep",0,-50,TRUE,FALSE,FALSE,3.59,"young",48,175,72,"m"
16,"LOWER BACK",1,"TuT",32680,32680,32750,32700,32680,32725,0.001,-45,32702.5,"TuT",0,50,FALSE,FALSE,FALSE,0.14,"young",48,175,72,"m"
16,"LOWER BACK",2,"TuT",31520,31520,31600,31650,31520,31625,0.003,-105,31572.5,"TuT",0,-50,FALSE,FALSE,FALSE,0.33,"young",48,175,72,"m"
16,"TOTAL ABDOMINAL",1,"Con01",1140,1140,1250,1150,1140,1200,0.053,-60,1170,"Con",0,100,FALSE,FALSE,FALSE,5,"young",48,175,72,"m"
16,"TOTAL ABDOMINAL",1,"Con02",1020,1040,1050,1100,1030,1075,0.044,-45,1052.5,"Con",-20,-50,FALSE,FALSE,FALSE,4.19,"young",48,175,72,"m"
16,"TOTAL ABDOMINAL",1,"Con03",1000,980,1000,1150,990,1075,0.086,-85,1032.5,"Con",20,-150,FALSE,FALSE,FALSE,7.91,"young",48,175,72,"m"
16,"TOTAL ABDOMINAL",1,"Con04",1140,1160,1200,1250,1150,1225,0.065,-75,1187.5,"Con",-20,-50,FALSE,FALSE,FALSE,6.12,"young",48,175,72,"m"
16,"TOTAL ABDOMINAL",1,"Con05",1280,1280,1350,1250,1280,1300,0.016,-20,1290,"Con",0,100,FALSE,FALSE,FALSE,1.54,"young",48,175,72,"m"
16,"TOTAL ABDOMINAL",1,"Con06",1120,1120,1300,1200,1120,1250,0.116,-130,1185,"Con",0,100,FALSE,FALSE,FALSE,10.4,"young",48,175,72,"m"
16,"TOTAL ABDOMINAL",1,"Con07",980,980,1150,1000,980,1075,0.097,-95,1027.5,"Con",0,150,FALSE,FALSE,FALSE,8.84,"young",48,175,72,"m"
16,"TOTAL ABDOMINAL",1,"Con08",1160,1120,1400,1250,1140,1325,0.162,-185,1232.5,"Con",40,150,TRUE,TRUE,FALSE,13.96,"young",48,175,72,"m"
16,"TOTAL ABDOMINAL",1,"Con09",1260,1280,1200,1450,1270,1325,0.043,-55,1297.5,"Con",-20,-250,FALSE,FALSE,TRUE,4.15,"young",48,175,72,"m"
16,"TOTAL ABDOMINAL",1,"Con10",1240,1260,1250,1400,1250,1325,0.06,-75,1287.5,"Con",-20,-150,FALSE,FALSE,FALSE,5.66,"young",48,175,72,"m"
16,"TOTAL ABDOMINAL",2,"Con01",960,940,1100,1050,950,1075,0.132,-125,1012.5,"Con",20,50,FALSE,FALSE,FALSE,11.63,"young",48,175,72,"m"
16,"TOTAL ABDOMINAL",2,"Con02",1000,1000,1050,1050,1000,1050,0.05,-50,1025,"Con",0,0,FALSE,FALSE,FALSE,4.76,"young",48,175,72,"m"
16,"TOTAL ABDOMINAL",2,"Con03",980,980,1050,1050,980,1050,0.071,-70,1015,"Con",0,0,FALSE,FALSE,FALSE,6.67,"young",48,175,72,"m"
16,"TOTAL ABDOMINAL",2,"Con04",940,980,1050,1000,960,1025,0.068,-65,992.5,"Con",-40,50,FALSE,TRUE,FALSE,6.34,"young",48,175,72,"m"
16,"TOTAL ABDOMINAL",2,"Con05",960,960,1100,1000,960,1050,0.094,-90,1005,"Con",0,100,FALSE,FALSE,FALSE,8.57,"young",48,175,72,"m"
16,"TOTAL ABDOMINAL",2,"Con06",1040,1040,1100,1100,1040,1100,0.058,-60,1070,"Con",0,0,FALSE,FALSE,FALSE,5.45,"young",48,175,72,"m"
16,"TOTAL ABDOMINAL",2,"Con07",920,920,1000,1050,920,1025,0.114,-105,972.5,"Con",0,-50,FALSE,FALSE,FALSE,10.24,"young",48,175,72,"m"
16,"TOTAL ABDOMINAL",2,"Con08",900,900,1000,1000,900,1000,0.111,-100,950,"Con",0,0,FALSE,FALSE,FALSE,10,"young",48,175,72,"m"
16,"TOTAL ABDOMINAL",2,"Con09",1040,1040,1200,1200,1040,1200,0.154,-160,1120,"Con",0,0,TRUE,FALSE,FALSE,13.33,"young",48,175,72,"m"
16,"TOTAL ABDOMINAL",2,"Con10",1240,1260,1350,1350,1250,1350,0.08,-100,1300,"Con",-20,0,FALSE,FALSE,FALSE,7.41,"young",48,175,72,"m"
16,"TOTAL ABDOMINAL",1,"Ecc01",2060,2060,2050,2000,2060,2025,0.017,35,2042.5,"Ecc",0,50,FALSE,FALSE,FALSE,1.73,"young",48,175,72,"m"
16,"TOTAL ABDOMINAL",1,"Ecc02",1880,1860,1850,1750,1870,1800,0.037,70,1835,"Ecc",20,100,FALSE,FALSE,FALSE,3.89,"young",48,175,72,"m"
16,"TOTAL ABDOMINAL",1,"Ecc03",1720,1740,1700,1600,1730,1650,0.046,80,1690,"Ecc",-20,100,FALSE,FALSE,FALSE,4.85,"young",48,175,72,"m"
16,"TOTAL ABDOMINAL",1,"Ecc04",1920,1900,1850,1900,1910,1875,0.018,35,1892.5,"Ecc",20,-50,FALSE,FALSE,FALSE,1.87,"young",48,175,72,"m"
16,"TOTAL ABDOMINAL",1,"Ecc05",1840,1840,1700,1800,1840,1750,0.049,90,1795,"Ecc",0,-100,FALSE,FALSE,FALSE,5.14,"young",48,175,72,"m"
16,"TOTAL ABDOMINAL",1,"Ecc06",1800,1800,1650,1750,1800,1700,0.056,100,1750,"Ecc",0,-100,FALSE,FALSE,FALSE,5.88,"young",48,175,72,"m"
16,"TOTAL ABDOMINAL",1,"Ecc07",1780,1800,1500,1750,1790,1625,0.092,165,1707.5,"Ecc",-20,-250,TRUE,FALSE,TRUE,10.15,"young",48,175,72,"m"
16,"TOTAL ABDOMINAL",1,"Ecc08",1800,1820,1800,1600,1810,1700,0.061,110,1755,"Ecc",-20,200,FALSE,FALSE,TRUE,6.47,"young",48,175,72,"m"
16,"TOTAL ABDOMINAL",1,"Ecc09",1820,1800,1850,1650,1810,1750,0.033,60,1780,"Ecc",20,200,FALSE,FALSE,TRUE,3.43,"young",48,175,72,"m"
16,"TOTAL ABDOMINAL",1,"Ecc10",1580,1580,1550,1550,1580,1550,0.019,30,1565,"Ecc",0,0,FALSE,FALSE,FALSE,1.94,"young",48,175,72,"m"
16,"TOTAL ABDOMINAL",2,"Ecc01",1780,1800,1750,1800,1790,1775,0.008,15,1782.5,"Ecc",-20,-50,FALSE,FALSE,FALSE,0.85,"young",48,175,72,"m"
16,"TOTAL ABDOMINAL",2,"Ecc02",1640,1640,1600,1550,1640,1575,0.04,65,1607.5,"Ecc",0,50,FALSE,FALSE,FALSE,4.13,"young",48,175,72,"m"
16,"TOTAL ABDOMINAL",2,"Ecc03",1700,1680,1600,1600,1690,1600,0.053,90,1645,"Ecc",20,0,FALSE,FALSE,FALSE,5.62,"young",48,175,72,"m"
16,"TOTAL ABDOMINAL",2,"Ecc04",1640,1620,1500,1600,1630,1550,0.049,80,1590,"Ecc",20,-100,FALSE,FALSE,FALSE,5.16,"young",48,175,72,"m"
16,"TOTAL ABDOMINAL",2,"Ecc05",1700,1700,1600,1650,1700,1625,0.044,75,1662.5,"Ecc",0,-50,FALSE,FALSE,FALSE,4.62,"young",48,175,72,"m"
16,"TOTAL ABDOMINAL",2,"Ecc06",1540,1540,1500,1450,1540,1475,0.042,65,1507.5,"Ecc",0,50,FALSE,FALSE,FALSE,4.41,"young",48,175,72,"m"
16,"TOTAL ABDOMINAL",2,"Ecc07",1620,1620,1500,1500,1620,1500,0.074,120,1560,"Ecc",0,0,FALSE,FALSE,FALSE,8,"young",48,175,72,"m"
16,"TOTAL ABDOMINAL",2,"Ecc08",1580,1580,1450,1450,1580,1450,0.082,130,1515,"Ecc",0,0,FALSE,FALSE,FALSE,8.97,"young",48,175,72,"m"
16,"TOTAL ABDOMINAL",2,"Ecc09",1640,1640,1500,1500,1640,1500,0.085,140,1570,"Ecc",0,0,FALSE,FALSE,FALSE,9.33,"young",48,175,72,"m"
16,"TOTAL ABDOMINAL",2,"Ecc10",1740,1720,1800,2250,1730,2025,0.171,-295,1877.5,"Ecc",20,-450,TRUE,FALSE,TRUE,14.57,"young",48,175,72,"m"
16,"TOTAL ABDOMINAL",1,"Rep01",3200,3200,3300,3150,3200,3225,0.008,-25,3212.5,"Rep",0,150,FALSE,FALSE,FALSE,0.78,"young",48,175,72,"m"
16,"TOTAL ABDOMINAL",1,"Rep02",2900,2900,2900,2850,2900,2875,0.009,25,2887.5,"Rep",0,50,FALSE,FALSE,FALSE,0.87,"young",48,175,72,"m"
16,"TOTAL ABDOMINAL",1,"Rep03",2720,2720,2700,2750,2720,2725,0.002,-5,2722.5,"Rep",0,-50,FALSE,FALSE,FALSE,0.18,"young",48,175,72,"m"
16,"TOTAL ABDOMINAL",1,"Rep04",3060,3060,3050,3150,3060,3100,0.013,-40,3080,"Rep",0,-100,FALSE,FALSE,FALSE,1.29,"young",48,175,72,"m"
16,"TOTAL ABDOMINAL",1,"Rep05",3120,3120,3050,3050,3120,3050,0.022,70,3085,"Rep",0,0,FALSE,FALSE,FALSE,2.3,"young",48,175,72,"m"
16,"TOTAL ABDOMINAL",1,"Rep06",2920,2920,2950,2950,2920,2950,0.01,-30,2935,"Rep",0,0,FALSE,FALSE,FALSE,1.02,"young",48,175,72,"m"
16,"TOTAL ABDOMINAL",1,"Rep07",2760,2780,2650,2750,2770,2700,0.025,70,2735,"Rep",-20,-100,FALSE,FALSE,FALSE,2.59,"young",48,175,72,"m"
16,"TOTAL ABDOMINAL",1,"Rep08",2960,2940,3200,2850,2950,3025,0.025,-75,2987.5,"Rep",20,350,FALSE,FALSE,TRUE,2.48,"young",48,175,72,"m"
16,"TOTAL ABDOMINAL",1,"Rep09",3080,3080,3050,3100,3080,3075,0.002,5,3077.5,"Rep",0,-50,FALSE,FALSE,FALSE,0.16,"young",48,175,72,"m"
16,"TOTAL ABDOMINAL",1,"Rep10",2820,2840,2800,2950,2830,2875,0.016,-45,2852.5,"Rep",-20,-150,FALSE,FALSE,FALSE,1.57,"young",48,175,72,"m"
16,"TOTAL ABDOMINAL",2,"Rep01",2740,2740,2850,2850,2740,2850,0.04,-110,2795,"Rep",0,0,FALSE,FALSE,FALSE,3.86,"young",48,175,72,"m"
16,"TOTAL ABDOMINAL",2,"Rep02",2640,2640,2650,2600,2640,2625,0.006,15,2632.5,"Rep",0,50,FALSE,FALSE,FALSE,0.57,"young",48,175,72,"m"
16,"TOTAL ABDOMINAL",2,"Rep03",2680,2660,2650,2650,2670,2650,0.007,20,2660,"Rep",20,0,FALSE,FALSE,FALSE,0.75,"young",48,175,72,"m"
16,"TOTAL ABDOMINAL",2,"Rep04",2580,2600,2550,2600,2590,2575,0.006,15,2582.5,"Rep",-20,-50,FALSE,FALSE,FALSE,0.58,"young",48,175,72,"m"
16,"TOTAL ABDOMINAL",2,"Rep05",2660,2660,2700,2650,2660,2675,0.006,-15,2667.5,"Rep",0,50,FALSE,FALSE,FALSE,0.56,"young",48,175,72,"m"
16,"TOTAL ABDOMINAL",2,"Rep06",2580,2580,2600,2550,2580,2575,0.002,5,2577.5,"Rep",0,50,FALSE,FALSE,FALSE,0.19,"young",48,175,72,"m"
16,"TOTAL ABDOMINAL",2,"Rep07",2540,2540,2500,2550,2540,2525,0.006,15,2532.5,"Rep",0,-50,FALSE,FALSE,FALSE,0.59,"young",48,175,72,"m"
16,"TOTAL ABDOMINAL",2,"Rep08",2480,2480,2450,2450,2480,2450,0.012,30,2465,"Rep",0,0,FALSE,FALSE,FALSE,1.22,"young",48,175,72,"m"
16,"TOTAL ABDOMINAL",2,"Rep09",2680,2680,2700,2700,2680,2700,0.007,-20,2690,"Rep",0,0,FALSE,FALSE,FALSE,0.74,"young",48,175,72,"m"
16,"TOTAL ABDOMINAL",2,"Rep10",2980,2980,3150,3600,2980,3375,0.133,-395,3177.5,"Rep",0,-450,TRUE,FALSE,TRUE,11.7,"young",48,175,72,"m"
16,"TOTAL ABDOMINAL",1,"TuT",29540,29560,29650,29550,29550,29600,0.002,-50,29575,"TuT",-20,100,FALSE,FALSE,FALSE,0.17,"young",48,175,72,"m"
16,"TOTAL ABDOMINAL",2,"TuT",26560,26560,26800,27200,26560,27000,0.017,-440,26780,"TuT",0,-400,TRUE,FALSE,TRUE,1.63,"young",48,175,72,"m"
16,"VERTICAL TRACTION",1,"Con01",1140,1160,1200,1300,1150,1250,0.087,-100,1200,"Con",-20,-100,FALSE,FALSE,FALSE,8,"young",48,175,72,"m"
16,"VERTICAL TRACTION",1,"Con02",1000,1000,1050,1050,1000,1050,0.05,-50,1025,"Con",0,0,FALSE,FALSE,FALSE,4.76,"young",48,175,72,"m"
16,"VERTICAL TRACTION",1,"Con03",960,980,1050,1050,970,1050,0.082,-80,1010,"Con",-20,0,FALSE,FALSE,FALSE,7.62,"young",48,175,72,"m"
16,"VERTICAL TRACTION",1,"Con04",1080,1060,1150,1150,1070,1150,0.075,-80,1110,"Con",20,0,FALSE,FALSE,FALSE,6.96,"young",48,175,72,"m"
16,"VERTICAL TRACTION",1,"Con05",960,960,1050,1050,960,1050,0.094,-90,1005,"Con",0,0,FALSE,FALSE,FALSE,8.57,"young",48,175,72,"m"
16,"VERTICAL TRACTION",1,"Con06",1040,1060,1150,1100,1050,1125,0.071,-75,1087.5,"Con",-20,50,FALSE,FALSE,FALSE,6.67,"young",48,175,72,"m"
16,"VERTICAL TRACTION",1,"Con07",880,900,1000,950,890,975,0.096,-85,932.5,"Con",-20,50,FALSE,FALSE,FALSE,8.72,"young",48,175,72,"m"
16,"VERTICAL TRACTION",1,"Con08",1020,1020,1100,1050,1020,1075,0.054,-55,1047.5,"Con",0,50,FALSE,FALSE,FALSE,5.12,"young",48,175,72,"m"
16,"VERTICAL TRACTION",1,"Con09",960,920,1050,1000,940,1025,0.09,-85,982.5,"Con",40,50,FALSE,FALSE,FALSE,8.29,"young",48,175,72,"m"
16,"VERTICAL TRACTION",1,"Con10",980,980,1100,1050,980,1075,0.097,-95,1027.5,"Con",0,50,FALSE,FALSE,FALSE,8.84,"young",48,175,72,"m"
16,"VERTICAL TRACTION",2,"Con01",1080,1080,2850,2650,1080,2750,1.546,-1670,1915,"Con",0,200,TRUE,FALSE,TRUE,60.73,"young",48,175,72,"m"
16,"VERTICAL TRACTION",2,"Con02",1040,1040,1150,1250,1040,1200,0.154,-160,1120,"Con",0,-100,FALSE,FALSE,FALSE,13.33,"young",48,175,72,"m"
16,"VERTICAL TRACTION",2,"Con03",980,980,1100,1100,980,1100,0.122,-120,1040,"Con",0,0,FALSE,FALSE,FALSE,10.91,"young",48,175,72,"m"
16,"VERTICAL TRACTION",2,"Con04",1000,1000,1100,1100,1000,1100,0.1,-100,1050,"Con",0,0,FALSE,FALSE,FALSE,9.09,"young",48,175,72,"m"
16,"VERTICAL TRACTION",2,"Con05",980,1000,1100,1100,990,1100,0.111,-110,1045,"Con",-20,0,FALSE,FALSE,FALSE,10,"young",48,175,72,"m"
16,"VERTICAL TRACTION",2,"Con06",940,940,1050,1000,940,1025,0.09,-85,982.5,"Con",0,50,FALSE,FALSE,FALSE,8.29,"young",48,175,72,"m"
16,"VERTICAL TRACTION",2,"Con07",1000,980,1100,1100,990,1100,0.111,-110,1045,"Con",20,0,FALSE,FALSE,FALSE,10,"young",48,175,72,"m"
16,"VERTICAL TRACTION",2,"Con08",1000,1000,1000,1000,1000,1000,0,0,1000,"Con",0,0,FALSE,FALSE,FALSE,0,"young",48,175,72,"m"
16,"VERTICAL TRACTION",2,"Con09",900,900,950,900,900,925,0.028,-25,912.5,"Con",0,50,FALSE,FALSE,FALSE,2.7,"young",48,175,72,"m"
16,"VERTICAL TRACTION",2,"Con10",1120,1120,1150,1100,1120,1125,0.004,-5,1122.5,"Con",0,50,FALSE,FALSE,FALSE,0.44,"young",48,175,72,"m"
16,"VERTICAL TRACTION",1,"Ecc01",2200,2200,2150,2150,2200,2150,0.023,50,2175,"Ecc",0,0,FALSE,FALSE,FALSE,2.33,"young",48,175,72,"m"
16,"VERTICAL TRACTION",1,"Ecc02",2060,2040,2050,2000,2050,2025,0.012,25,2037.5,"Ecc",20,50,FALSE,FALSE,FALSE,1.23,"young",48,175,72,"m"
16,"VERTICAL TRACTION",1,"Ecc03",2040,2060,1950,1950,2050,1950,0.049,100,2000,"Ecc",-20,0,FALSE,FALSE,FALSE,5.13,"young",48,175,72,"m"
16,"VERTICAL TRACTION",1,"Ecc04",1880,1880,1750,1800,1880,1775,0.056,105,1827.5,"Ecc",0,-50,FALSE,FALSE,FALSE,5.92,"young",48,175,72,"m"
16,"VERTICAL TRACTION",1,"Ecc05",1880,1860,1800,1800,1870,1800,0.037,70,1835,"Ecc",20,0,FALSE,FALSE,FALSE,3.89,"young",48,175,72,"m"
16,"VERTICAL TRACTION",1,"Ecc06",1900,1880,1800,1850,1890,1825,0.034,65,1857.5,"Ecc",20,-50,FALSE,FALSE,FALSE,3.56,"young",48,175,72,"m"
16,"VERTICAL TRACTION",1,"Ecc07",1800,1800,1700,1750,1800,1725,0.042,75,1762.5,"Ecc",0,-50,FALSE,FALSE,FALSE,4.35,"young",48,175,72,"m"
16,"VERTICAL TRACTION",1,"Ecc08",1760,1780,1650,1700,1770,1675,0.054,95,1722.5,"Ecc",-20,-50,FALSE,FALSE,FALSE,5.67,"young",48,175,72,"m"
16,"VERTICAL TRACTION",1,"Ecc09",1820,1840,1700,1750,1830,1725,0.057,105,1777.5,"Ecc",-20,-50,FALSE,FALSE,FALSE,6.09,"young",48,175,72,"m"
16,"VERTICAL TRACTION",1,"Ecc10",2320,2340,2350,2400,2330,2375,0.019,-45,2352.5,"Ecc",-20,-50,FALSE,FALSE,FALSE,1.89,"young",48,175,72,"m"
16,"VERTICAL TRACTION",2,"Ecc01",2020,2020,1900,1800,2020,1850,0.084,170,1935,"Ecc",0,100,FALSE,FALSE,FALSE,9.19,"young",48,175,72,"m"
16,"VERTICAL TRACTION",2,"Ecc02",1900,1900,1750,1750,1900,1750,0.079,150,1825,"Ecc",0,0,FALSE,FALSE,FALSE,8.57,"young",48,175,72,"m"
16,"VERTICAL TRACTION",2,"Ecc03",2020,2020,1900,1900,2020,1900,0.059,120,1960,"Ecc",0,0,FALSE,FALSE,FALSE,6.32,"young",48,175,72,"m"
16,"VERTICAL TRACTION",2,"Ecc04",1900,1880,1800,1800,1890,1800,0.048,90,1845,"Ecc",20,0,FALSE,FALSE,FALSE,5,"young",48,175,72,"m"
16,"VERTICAL TRACTION",2,"Ecc05",1700,1700,1600,1600,1700,1600,0.059,100,1650,"Ecc",0,0,FALSE,FALSE,FALSE,6.25,"young",48,175,72,"m"
16,"VERTICAL TRACTION",2,"Ecc06",1960,1980,1850,1900,1970,1875,0.048,95,1922.5,"Ecc",-20,-50,FALSE,FALSE,FALSE,5.07,"young",48,175,72,"m"
16,"VERTICAL TRACTION",2,"Ecc07",1900,1900,1850,1850,1900,1850,0.026,50,1875,"Ecc",0,0,FALSE,FALSE,FALSE,2.7,"young",48,175,72,"m"
16,"VERTICAL TRACTION",2,"Ecc08",1820,1820,1800,1800,1820,1800,0.011,20,1810,"Ecc",0,0,FALSE,FALSE,FALSE,1.11,"young",48,175,72,"m"
16,"VERTICAL TRACTION",2,"Ecc09",1840,1840,1800,1850,1840,1825,0.008,15,1832.5,"Ecc",0,-50,FALSE,FALSE,FALSE,0.82,"young",48,175,72,"m"
16,"VERTICAL TRACTION",2,"Ecc10",2740,2740,2800,2800,2740,2800,0.022,-60,2770,"Ecc",0,0,FALSE,FALSE,FALSE,2.14,"young",48,175,72,"m"
16,"VERTICAL TRACTION",1,"Rep01",3340,3360,3350,3450,3350,3400,0.015,-50,3375,"Rep",-20,-100,FALSE,FALSE,FALSE,1.47,"young",48,175,72,"m"
16,"VERTICAL TRACTION",1,"Rep02",3060,3040,3100,3050,3050,3075,0.008,-25,3062.5,"Rep",20,50,FALSE,FALSE,FALSE,0.81,"young",48,175,72,"m"
16,"VERTICAL TRACTION",1,"Rep03",3000,3040,3000,3000,3020,3000,0.007,20,3010,"Rep",-40,0,FALSE,FALSE,FALSE,0.67,"young",48,175,72,"m"
16,"VERTICAL TRACTION",1,"Rep04",2960,2940,2900,2950,2950,2925,0.008,25,2937.5,"Rep",20,-50,FALSE,FALSE,FALSE,0.85,"young",48,175,72,"m"
16,"VERTICAL TRACTION",1,"Rep05",2840,2820,2850,2850,2830,2850,0.007,-20,2840,"Rep",20,0,FALSE,FALSE,FALSE,0.7,"young",48,175,72,"m"
16,"VERTICAL TRACTION",1,"Rep06",2940,2940,2950,2950,2940,2950,0.003,-10,2945,"Rep",0,0,FALSE,FALSE,FALSE,0.34,"young",48,175,72,"m"
16,"VERTICAL TRACTION",1,"Rep07",2680,2700,2700,2700,2690,2700,0.004,-10,2695,"Rep",-20,0,FALSE,FALSE,FALSE,0.37,"young",48,175,72,"m"
16,"VERTICAL TRACTION",1,"Rep08",2780,2800,2750,2750,2790,2750,0.014,40,2770,"Rep",-20,0,FALSE,FALSE,FALSE,1.45,"young",48,175,72,"m"
16,"VERTICAL TRACTION",1,"Rep09",2780,2760,2750,2750,2770,2750,0.007,20,2760,"Rep",20,0,FALSE,FALSE,FALSE,0.73,"young",48,175,72,"m"
16,"VERTICAL TRACTION",1,"Rep10",3300,3320,3450,3450,3310,3450,0.042,-140,3380,"Rep",-20,0,FALSE,FALSE,FALSE,4.06,"young",48,175,72,"m"
16,"VERTICAL TRACTION",2,"Rep01",3100,3100,4750,4450,3100,4600,0.484,-1500,3850,"Rep",0,300,TRUE,FALSE,TRUE,32.61,"young",48,175,72,"m"
16,"VERTICAL TRACTION",2,"Rep02",2940,2940,2900,3000,2940,2950,0.003,-10,2945,"Rep",0,-100,FALSE,FALSE,FALSE,0.34,"young",48,175,72,"m"
16,"VERTICAL TRACTION",2,"Rep03",3000,3000,3000,3000,3000,3000,0,0,3000,"Rep",0,0,FALSE,FALSE,FALSE,0,"young",48,175,72,"m"
16,"VERTICAL TRACTION",2,"Rep04",2900,2880,2900,2900,2890,2900,0.003,-10,2895,"Rep",20,0,FALSE,FALSE,FALSE,0.34,"young",48,175,72,"m"
16,"VERTICAL TRACTION",2,"Rep05",2680,2700,2700,2700,2690,2700,0.004,-10,2695,"Rep",-20,0,FALSE,FALSE,FALSE,0.37,"young",48,175,72,"m"
16,"VERTICAL TRACTION",2,"Rep06",2900,2920,2900,2900,2910,2900,0.003,10,2905,"Rep",-20,0,FALSE,FALSE,FALSE,0.34,"young",48,175,72,"m"
16,"VERTICAL TRACTION",2,"Rep07",2900,2880,2950,2950,2890,2950,0.021,-60,2920,"Rep",20,0,FALSE,FALSE,FALSE,2.03,"young",48,175,72,"m"
16,"VERTICAL TRACTION",2,"Rep08",2820,2820,2800,2800,2820,2800,0.007,20,2810,"Rep",0,0,FALSE,FALSE,FALSE,0.71,"young",48,175,72,"m"
16,"VERTICAL TRACTION",2,"Rep09",2740,2740,2750,2750,2740,2750,0.004,-10,2745,"Rep",0,0,FALSE,FALSE,FALSE,0.36,"young",48,175,72,"m"
16,"VERTICAL TRACTION",2,"Rep10",3860,3860,3950,3900,3860,3925,0.017,-65,3892.5,"Rep",0,50,FALSE,FALSE,FALSE,1.66,"young",48,175,72,"m"
16,"VERTICAL TRACTION",1,"TuT",29680,29720,29800,29900,29700,29850,0.005,-150,29775,"TuT",-40,-100,FALSE,FALSE,FALSE,0.5,"young",48,175,72,"m"
16,"VERTICAL TRACTION",2,"TuT",29840,29840,31600,31350,29840,31475,0.055,-1635,30657.5,"TuT",0,250,FALSE,FALSE,FALSE,5.19,"young",48,175,72,"m"
16,"CHEST PRESS",1,"Con01",1300,1280,3100,1450,1290,2275,0.764,-985,1782.5,"Con",20,1650,TRUE,FALSE,TRUE,43.3,"young",48,175,72,"m"
16,"CHEST PRESS",1,"Con02",920,920,1000,1100,920,1050,0.141,-130,985,"Con",0,-100,FALSE,FALSE,FALSE,12.38,"young",48,175,72,"m"
16,"CHEST PRESS",1,"Con03",1020,1020,1250,1250,1020,1250,0.225,-230,1135,"Con",0,0,FALSE,FALSE,FALSE,18.4,"young",48,175,72,"m"
16,"CHEST PRESS",1,"Con04",920,920,1150,1150,920,1150,0.25,-230,1035,"Con",0,0,FALSE,FALSE,FALSE,20,"young",48,175,72,"m"
16,"CHEST PRESS",1,"Con05",900,900,1150,1100,900,1125,0.25,-225,1012.5,"Con",0,50,FALSE,FALSE,FALSE,20,"young",48,175,72,"m"
16,"CHEST PRESS",1,"Con06",920,920,1150,1050,920,1100,0.196,-180,1010,"Con",0,100,FALSE,FALSE,FALSE,16.36,"young",48,175,72,"m"
16,"CHEST PRESS",1,"Con07",980,980,1250,1150,980,1200,0.224,-220,1090,"Con",0,100,FALSE,FALSE,FALSE,18.33,"young",48,175,72,"m"
16,"CHEST PRESS",1,"Con08",1500,1500,1550,1500,1500,1525,0.017,-25,1512.5,"Con",0,50,FALSE,FALSE,FALSE,1.64,"young",48,175,72,"m"
16,"CHEST PRESS",1,"Con09",1060,1060,1250,1500,1060,1375,0.297,-315,1217.5,"Con",0,-250,FALSE,FALSE,FALSE,22.91,"young",48,175,72,"m"
16,"CHEST PRESS",1,"Con10",1220,1200,1350,1600,1210,1475,0.219,-265,1342.5,"Con",20,-250,FALSE,FALSE,FALSE,17.97,"young",48,175,72,"m"
16,"CHEST PRESS",2,"Con01",1160,1180,2000,1050,1170,1525,0.303,-355,1347.5,"Con",-20,950,TRUE,FALSE,TRUE,23.28,"young",48,175,72,"m"
16,"CHEST PRESS",2,"Con02",840,840,1000,850,840,925,0.101,-85,882.5,"Con",0,150,FALSE,FALSE,FALSE,9.19,"young",48,175,72,"m"
16,"CHEST PRESS",2,"Con03",900,900,1050,900,900,975,0.083,-75,937.5,"Con",0,150,FALSE,FALSE,FALSE,7.69,"young",48,175,72,"m"
16,"CHEST PRESS",2,"Con04",920,920,1100,1000,920,1050,0.141,-130,985,"Con",0,100,FALSE,FALSE,FALSE,12.38,"young",48,175,72,"m"
16,"CHEST PRESS",2,"Con05",900,940,1150,1100,920,1125,0.223,-205,1022.5,"Con",-40,50,FALSE,TRUE,FALSE,18.22,"young",48,175,72,"m"
16,"CHEST PRESS",2,"Con06",980,980,1150,1100,980,1125,0.148,-145,1052.5,"Con",0,50,FALSE,FALSE,FALSE,12.89,"young",48,175,72,"m"
16,"CHEST PRESS",2,"Con07",880,880,1000,1050,880,1025,0.165,-145,952.5,"Con",0,-50,FALSE,FALSE,FALSE,14.15,"young",48,175,72,"m"
16,"CHEST PRESS",2,"Con08",860,860,950,1150,860,1050,0.221,-190,955,"Con",0,-200,FALSE,FALSE,FALSE,18.1,"young",48,175,72,"m"
16,"CHEST PRESS",2,"Con09",1040,1040,1050,1250,1040,1150,0.106,-110,1095,"Con",0,-200,FALSE,FALSE,FALSE,9.57,"young",48,175,72,"m"
16,"CHEST PRESS",2,"Con10",1080,1080,1100,1250,1080,1175,0.088,-95,1127.5,"Con",0,-150,FALSE,FALSE,FALSE,8.09,"young",48,175,72,"m"
16,"CHEST PRESS",1,"Ecc01",2160,2160,2050,2000,2160,2025,0.062,135,2092.5,"Ecc",0,50,FALSE,FALSE,FALSE,6.67,"young",48,175,72,"m"
16,"CHEST PRESS",1,"Ecc02",2120,2120,2000,1950,2120,1975,0.068,145,2047.5,"Ecc",0,50,FALSE,FALSE,FALSE,7.34,"young",48,175,72,"m"
16,"CHEST PRESS",1,"Ecc03",2040,2040,1800,1800,2040,1800,0.118,240,1920,"Ecc",0,0,FALSE,FALSE,FALSE,13.33,"young",48,175,72,"m"
16,"CHEST PRESS",1,"Ecc04",1980,1980,1750,1750,1980,1750,0.116,230,1865,"Ecc",0,0,FALSE,FALSE,FALSE,13.14,"young",48,175,72,"m"
16,"CHEST PRESS",1,"Ecc05",2260,2260,2000,2100,2260,2050,0.093,210,2155,"Ecc",0,-100,FALSE,FALSE,FALSE,10.24,"young",48,175,72,"m"
16,"CHEST PRESS",1,"Ecc06",2040,2040,1850,1900,2040,1875,0.081,165,1957.5,"Ecc",0,-50,FALSE,FALSE,FALSE,8.8,"young",48,175,72,"m"
16,"CHEST PRESS",1,"Ecc07",2160,2160,1900,2000,2160,1950,0.097,210,2055,"Ecc",0,-100,FALSE,FALSE,FALSE,10.77,"young",48,175,72,"m"
16,"CHEST PRESS",1,"Ecc08",1800,1800,1750,1750,1800,1750,0.028,50,1775,"Ecc",0,0,FALSE,FALSE,FALSE,2.86,"young",48,175,72,"m"
16,"CHEST PRESS",1,"Ecc09",2020,2020,1850,1600,2020,1725,0.146,295,1872.5,"Ecc",0,250,FALSE,FALSE,TRUE,17.1,"young",48,175,72,"m"
16,"CHEST PRESS",1,"Ecc10",2280,2300,1650,1450,2290,1550,0.323,740,1920,"Ecc",-20,200,TRUE,FALSE,FALSE,47.74,"young",48,175,72,"m"
16,"CHEST PRESS",2,"Ecc01",1740,1740,1450,1700,1740,1575,0.095,165,1657.5,"Ecc",0,-250,FALSE,FALSE,TRUE,10.48,"young",48,175,72,"m"
16,"CHEST PRESS",2,"Ecc02",1700,1700,1550,1700,1700,1625,0.044,75,1662.5,"Ecc",0,-150,FALSE,FALSE,FALSE,4.62,"young",48,175,72,"m"
16,"CHEST PRESS",2,"Ecc03",1700,1700,1500,1650,1700,1575,0.074,125,1637.5,"Ecc",0,-150,FALSE,FALSE,FALSE,7.94,"young",48,175,72,"m"
16,"CHEST PRESS",2,"Ecc04",1700,1660,1500,1550,1680,1525,0.092,155,1602.5,"Ecc",40,-50,FALSE,TRUE,FALSE,10.16,"young",48,175,72,"m"
16,"CHEST PRESS",2,"Ecc05",1800,1800,1600,1650,1800,1625,0.097,175,1712.5,"Ecc",0,-50,FALSE,FALSE,FALSE,10.77,"young",48,175,72,"m"
16,"CHEST PRESS",2,"Ecc06",1600,1600,1450,1450,1600,1450,0.094,150,1525,"Ecc",0,0,FALSE,FALSE,FALSE,10.34,"young",48,175,72,"m"
16,"CHEST PRESS",2,"Ecc07",1480,1480,1400,1250,1480,1325,0.105,155,1402.5,"Ecc",0,150,FALSE,FALSE,FALSE,11.7,"young",48,175,72,"m"
16,"CHEST PRESS",2,"Ecc08",1680,1680,1600,1400,1680,1500,0.107,180,1590,"Ecc",0,200,FALSE,FALSE,FALSE,12,"young",48,175,72,"m"
16,"CHEST PRESS",2,"Ecc09",1560,1560,1550,1400,1560,1475,0.054,85,1517.5,"Ecc",0,150,FALSE,FALSE,FALSE,5.76,"young",48,175,72,"m"
16,"CHEST PRESS",2,"Ecc10",1140,1140,550,550,1140,550,0.518,590,845,"Ecc",0,0,TRUE,FALSE,FALSE,107.27,"young",48,175,72,"m"
16,"CHEST PRESS",1,"Rep01",3460,3440,5150,3450,3450,4300,0.246,-850,3875,"Rep",20,1700,TRUE,FALSE,TRUE,19.77,"young",48,175,72,"m"
16,"CHEST PRESS",1,"Rep02",3040,3040,3000,3050,3040,3025,0.005,15,3032.5,"Rep",0,-50,FALSE,FALSE,FALSE,0.5,"young",48,175,72,"m"
16,"CHEST PRESS",1,"Rep03",3060,3060,3050,3050,3060,3050,0.003,10,3055,"Rep",0,0,FALSE,FALSE,FALSE,0.33,"young",48,175,72,"m"
16,"CHEST PRESS",1,"Rep04",2900,2900,2900,2900,2900,2900,0,0,2900,"Rep",0,0,FALSE,FALSE,FALSE,0,"young",48,175,72,"m"
16,"CHEST PRESS",1,"Rep05",3160,3160,3150,3200,3160,3175,0.005,-15,3167.5,"Rep",0,-50,FALSE,FALSE,FALSE,0.47,"young",48,175,72,"m"
16,"CHEST PRESS",1,"Rep06",2960,2960,3000,2950,2960,2975,0.005,-15,2967.5,"Rep",0,50,FALSE,FALSE,FALSE,0.5,"young",48,175,72,"m"
16,"CHEST PRESS",1,"Rep07",3140,3140,3150,3150,3140,3150,0.003,-10,3145,"Rep",0,0,FALSE,FALSE,FALSE,0.32,"young",48,175,72,"m"
16,"CHEST PRESS",1,"Rep08",3300,3300,3300,3250,3300,3275,0.008,25,3287.5,"Rep",0,50,FALSE,FALSE,FALSE,0.76,"young",48,175,72,"m"
16,"CHEST PRESS",1,"Rep09",3080,3080,3100,3100,3080,3100,0.006,-20,3090,"Rep",0,0,FALSE,FALSE,FALSE,0.65,"young",48,175,72,"m"
16,"CHEST PRESS",1,"Rep10",3500,3500,3000,3050,3500,3025,0.136,475,3262.5,"Rep",0,-50,TRUE,FALSE,FALSE,15.7,"young",48,175,72,"m"
16,"CHEST PRESS",2,"Rep01",2900,2920,3450,2750,2910,3100,0.065,-190,3005,"Rep",-20,700,TRUE,FALSE,TRUE,6.13,"young",48,175,72,"m"
16,"CHEST PRESS",2,"Rep02",2540,2540,2550,2550,2540,2550,0.004,-10,2545,"Rep",0,0,FALSE,FALSE,FALSE,0.39,"young",48,175,72,"m"
16,"CHEST PRESS",2,"Rep03",2600,2600,2550,2550,2600,2550,0.019,50,2575,"Rep",0,0,FALSE,FALSE,FALSE,1.96,"young",48,175,72,"m"
16,"CHEST PRESS",2,"Rep04",2620,2580,2600,2550,2600,2575,0.01,25,2587.5,"Rep",40,50,FALSE,FALSE,FALSE,0.97,"young",48,175,72,"m"
16,"CHEST PRESS",2,"Rep05",2700,2740,2750,2750,2720,2750,0.011,-30,2735,"Rep",-40,0,FALSE,FALSE,FALSE,1.09,"young",48,175,72,"m"
16,"CHEST PRESS",2,"Rep06",2580,2580,2600,2550,2580,2575,0.002,5,2577.5,"Rep",0,50,FALSE,FALSE,FALSE,0.19,"young",48,175,72,"m"
16,"CHEST PRESS",2,"Rep07",2360,2360,2400,2300,2360,2350,0.004,10,2355,"Rep",0,100,FALSE,FALSE,FALSE,0.43,"young",48,175,72,"m"
16,"CHEST PRESS",2,"Rep08",2540,2540,2550,2550,2540,2550,0.004,-10,2545,"Rep",0,0,FALSE,FALSE,FALSE,0.39,"young",48,175,72,"m"
16,"CHEST PRESS",2,"Rep09",2600,2600,2600,2650,2600,2625,0.01,-25,2612.5,"Rep",0,-50,FALSE,FALSE,FALSE,0.95,"young",48,175,72,"m"
16,"CHEST PRESS",2,"Rep10",2220,2220,1650,1800,2220,1725,0.223,495,1972.5,"Rep",0,-150,TRUE,FALSE,FALSE,28.7,"young",48,175,72,"m"
16,"CHEST PRESS",1,"TuT",31600,31580,32800,31150,31590,31975,0.012,-385,31782.5,"TuT",20,1650,FALSE,FALSE,TRUE,1.2,"young",48,175,72,"m"
16,"CHEST PRESS",2,"TuT",25660,25680,25700,25000,25670,25350,0.012,320,25510,"TuT",-20,700,FALSE,FALSE,FALSE,1.26,"young",48,175,72,"m"
17,"LEG PRESS",1,"Con01",1460,1480,1550,1550,1470,1550,0.054,-80,1510,"Con",-20,0,FALSE,FALSE,FALSE,5.16,"young",31,166,46,"f"
17,"LEG PRESS",1,"Con02",1260,1260,1300,1250,1260,1275,0.012,-15,1267.5,"Con",0,50,FALSE,FALSE,FALSE,1.18,"young",31,166,46,"f"
17,"LEG PRESS",1,"Con03",1380,1400,1450,1450,1390,1450,0.043,-60,1420,"Con",-20,0,FALSE,FALSE,FALSE,4.14,"young",31,166,46,"f"
17,"LEG PRESS",1,"Con04",1260,1260,1500,1450,1260,1475,0.171,-215,1367.5,"Con",0,50,FALSE,FALSE,FALSE,14.58,"young",31,166,46,"f"
17,"LEG PRESS",1,"Con05",1140,1160,1350,1300,1150,1325,0.152,-175,1237.5,"Con",-20,50,FALSE,FALSE,FALSE,13.21,"young",31,166,46,"f"
17,"LEG PRESS",1,"Con06",1280,1280,1450,1500,1280,1475,0.152,-195,1377.5,"Con",0,-50,FALSE,FALSE,FALSE,13.22,"young",31,166,46,"f"
17,"LEG PRESS",1,"Con07",1200,1200,1350,1400,1200,1375,0.146,-175,1287.5,"Con",0,-50,FALSE,FALSE,FALSE,12.73,"young",31,166,46,"f"
17,"LEG PRESS",1,"Con08",1180,1160,1250,1350,1170,1300,0.111,-130,1235,"Con",20,-100,FALSE,FALSE,FALSE,10,"young",31,166,46,"f"
17,"LEG PRESS",1,"Con09",1160,1160,1450,1500,1160,1475,0.272,-315,1317.5,"Con",0,-50,FALSE,FALSE,FALSE,21.36,"young",31,166,46,"f"
17,"LEG PRESS",1,"Con10",1500,1540,1500,1550,1520,1525,0.003,-5,1522.5,"Con",-40,-50,FALSE,FALSE,FALSE,0.33,"young",31,166,46,"f"
17,"LEG PRESS",2,"Con01",1360,1340,1300,1450,1350,1375,0.019,-25,1362.5,"Con",20,-150,FALSE,FALSE,FALSE,1.82,"young",31,166,46,"f"
17,"LEG PRESS",2,"Con02",1480,1440,1450,1500,1460,1475,0.01,-15,1467.5,"Con",40,-50,FALSE,FALSE,FALSE,1.02,"young",31,166,46,"f"
17,"LEG PRESS",2,"Con03",1260,1280,1550,1400,1270,1475,0.161,-205,1372.5,"Con",-20,150,FALSE,FALSE,FALSE,13.9,"young",31,166,46,"f"
17,"LEG PRESS",2,"Con04",1200,1220,1250,1250,1210,1250,0.033,-40,1230,"Con",-20,0,FALSE,FALSE,FALSE,3.2,"young",31,166,46,"f"
17,"LEG PRESS",2,"Con05",1180,1200,1250,1250,1190,1250,0.05,-60,1220,"Con",-20,0,FALSE,FALSE,FALSE,4.8,"young",31,166,46,"f"
17,"LEG PRESS",2,"Con06",1080,1100,1350,1300,1090,1325,0.216,-235,1207.5,"Con",-20,50,FALSE,FALSE,FALSE,17.74,"young",31,166,46,"f"
17,"LEG PRESS",2,"Con07",1220,1220,1350,1400,1220,1375,0.127,-155,1297.5,"Con",0,-50,FALSE,FALSE,FALSE,11.27,"young",31,166,46,"f"
17,"LEG PRESS",2,"Con08",1160,1160,1600,1650,1160,1625,0.401,-465,1392.5,"Con",0,-50,TRUE,FALSE,FALSE,28.62,"young",31,166,46,"f"
17,"LEG PRESS",2,"Con09",1020,1040,1250,1250,1030,1250,0.214,-220,1140,"Con",-20,0,FALSE,FALSE,FALSE,17.6,"young",31,166,46,"f"
17,"LEG PRESS",2,"Con10",1240,1240,1550,1500,1240,1525,0.23,-285,1382.5,"Con",0,50,FALSE,FALSE,FALSE,18.69,"young",31,166,46,"f"
17,"LEG PRESS",1,"Ecc01",2060,2060,2050,2050,2060,2050,0.005,10,2055,"Ecc",0,0,FALSE,FALSE,FALSE,0.49,"young",31,166,46,"f"
17,"LEG PRESS",1,"Ecc02",1840,1840,1800,1850,1840,1825,0.008,15,1832.5,"Ecc",0,-50,FALSE,FALSE,FALSE,0.82,"young",31,166,46,"f"
17,"LEG PRESS",1,"Ecc03",1800,1800,1700,1700,1800,1700,0.056,100,1750,"Ecc",0,0,FALSE,FALSE,FALSE,5.88,"young",31,166,46,"f"
17,"LEG PRESS",1,"Ecc04",2060,2040,1850,1950,2050,1900,0.073,150,1975,"Ecc",20,-100,FALSE,FALSE,FALSE,7.89,"young",31,166,46,"f"
17,"LEG PRESS",1,"Ecc05",2120,2100,1900,1900,2110,1900,0.1,210,2005,"Ecc",20,0,FALSE,FALSE,FALSE,11.05,"young",31,166,46,"f"
17,"LEG PRESS",1,"Ecc06",2080,2100,1900,1850,2090,1875,0.103,215,1982.5,"Ecc",-20,50,FALSE,FALSE,FALSE,11.47,"young",31,166,46,"f"
17,"LEG PRESS",1,"Ecc07",1780,1780,1700,1600,1780,1650,0.073,130,1715,"Ecc",0,100,FALSE,FALSE,FALSE,7.88,"young",31,166,46,"f"
17,"LEG PRESS",1,"Ecc08",1880,1880,1700,1650,1880,1675,0.109,205,1777.5,"Ecc",0,50,FALSE,FALSE,FALSE,12.24,"young",31,166,46,"f"
17,"LEG PRESS",1,"Ecc09",1860,1840,1600,1550,1850,1575,0.149,275,1712.5,"Ecc",20,50,FALSE,FALSE,FALSE,17.46,"young",31,166,46,"f"
17,"LEG PRESS",1,"Ecc10",1920,1920,2050,2000,1920,2025,0.055,-105,1972.5,"Ecc",0,50,FALSE,FALSE,FALSE,5.19,"young",31,166,46,"f"
17,"LEG PRESS",2,"Ecc01",1860,1880,1950,1900,1870,1925,0.029,-55,1897.5,"Ecc",-20,50,FALSE,FALSE,FALSE,2.86,"young",31,166,46,"f"
17,"LEG PRESS",2,"Ecc02",1920,1940,1850,1850,1930,1850,0.041,80,1890,"Ecc",-20,0,FALSE,FALSE,FALSE,4.32,"young",31,166,46,"f"
17,"LEG PRESS",2,"Ecc03",1860,1840,1600,1750,1850,1675,0.095,175,1762.5,"Ecc",20,-150,FALSE,FALSE,FALSE,10.45,"young",31,166,46,"f"
17,"LEG PRESS",2,"Ecc04",1760,1760,1700,1700,1760,1700,0.034,60,1730,"Ecc",0,0,FALSE,FALSE,FALSE,3.53,"young",31,166,46,"f"
17,"LEG PRESS",2,"Ecc05",1880,1840,1750,1750,1860,1750,0.059,110,1805,"Ecc",40,0,FALSE,FALSE,FALSE,6.29,"young",31,166,46,"f"
17,"LEG PRESS",2,"Ecc06",1880,1900,1650,1650,1890,1650,0.127,240,1770,"Ecc",-20,0,FALSE,FALSE,FALSE,14.55,"young",31,166,46,"f"
17,"LEG PRESS",2,"Ecc07",1700,1680,1500,1450,1690,1475,0.127,215,1582.5,"Ecc",20,50,FALSE,FALSE,FALSE,14.58,"young",31,166,46,"f"
17,"LEG PRESS",2,"Ecc08",1840,1820,1400,1400,1830,1400,0.235,430,1615,"Ecc",20,0,TRUE,FALSE,FALSE,30.71,"young",31,166,46,"f"
17,"LEG PRESS",2,"Ecc09",1740,1740,1400,1450,1740,1425,0.181,315,1582.5,"Ecc",0,-50,FALSE,FALSE,FALSE,22.11,"young",31,166,46,"f"
17,"LEG PRESS",2,"Ecc10",1880,1860,1850,1650,1870,1750,0.064,120,1810,"Ecc",20,200,FALSE,FALSE,TRUE,6.86,"young",31,166,46,"f"
17,"LEG PRESS",1,"Rep01",3520,3540,3600,3600,3530,3600,0.02,-70,3565,"Rep",-20,0,FALSE,FALSE,FALSE,1.94,"young",31,166,46,"f"
17,"LEG PRESS",1,"Rep02",3100,3100,3100,3100,3100,3100,0,0,3100,"Rep",0,0,FALSE,FALSE,FALSE,0,"young",31,166,46,"f"
17,"LEG PRESS",1,"Rep03",3180,3200,3150,3150,3190,3150,0.013,40,3170,"Rep",-20,0,FALSE,FALSE,FALSE,1.27,"young",31,166,46,"f"
17,"LEG PRESS",1,"Rep04",3320,3300,3350,3400,3310,3375,0.02,-65,3342.5,"Rep",20,-50,FALSE,FALSE,FALSE,1.93,"young",31,166,46,"f"
17,"LEG PRESS",1,"Rep05",3260,3260,3250,3200,3260,3225,0.011,35,3242.5,"Rep",0,50,FALSE,FALSE,FALSE,1.09,"young",31,166,46,"f"
17,"LEG PRESS",1,"Rep06",3360,3380,3350,3350,3370,3350,0.006,20,3360,"Rep",-20,0,FALSE,FALSE,FALSE,0.6,"young",31,166,46,"f"
17,"LEG PRESS",1,"Rep07",2980,2980,3050,3000,2980,3025,0.015,-45,3002.5,"Rep",0,50,FALSE,FALSE,FALSE,1.49,"young",31,166,46,"f"
17,"LEG PRESS",1,"Rep08",3060,3040,2950,3000,3050,2975,0.025,75,3012.5,"Rep",20,-50,FALSE,FALSE,FALSE,2.52,"young",31,166,46,"f"
17,"LEG PRESS",1,"Rep09",3020,3000,3050,3050,3010,3050,0.013,-40,3030,"Rep",20,0,FALSE,FALSE,FALSE,1.31,"young",31,166,46,"f"
17,"LEG PRESS",1,"Rep10",3420,3460,3550,3550,3440,3550,0.032,-110,3495,"Rep",-40,0,FALSE,FALSE,FALSE,3.1,"young",31,166,46,"f"
17,"LEG PRESS",2,"Rep01",3220,3220,3250,3350,3220,3300,0.025,-80,3260,"Rep",0,-100,FALSE,FALSE,TRUE,2.42,"young",31,166,46,"f"
17,"LEG PRESS",2,"Rep02",3400,3380,3300,3350,3390,3325,0.019,65,3357.5,"Rep",20,-50,FALSE,FALSE,FALSE,1.95,"young",31,166,46,"f"
17,"LEG PRESS",2,"Rep03",3120,3120,3150,3150,3120,3150,0.01,-30,3135,"Rep",0,0,FALSE,FALSE,FALSE,0.95,"young",31,166,46,"f"
17,"LEG PRESS",2,"Rep04",2960,2980,2950,2950,2970,2950,0.007,20,2960,"Rep",-20,0,FALSE,FALSE,FALSE,0.68,"young",31,166,46,"f"
17,"LEG PRESS",2,"Rep05",3060,3040,3000,3000,3050,3000,0.016,50,3025,"Rep",20,0,FALSE,FALSE,FALSE,1.67,"young",31,166,46,"f"
17,"LEG PRESS",2,"Rep06",2960,3000,3000,2950,2980,2975,0.002,5,2977.5,"Rep",-40,50,FALSE,FALSE,FALSE,0.17,"young",31,166,46,"f"
17,"LEG PRESS",2,"Rep07",2920,2900,2850,2850,2910,2850,0.021,60,2880,"Rep",20,0,FALSE,FALSE,FALSE,2.11,"young",31,166,46,"f"
17,"LEG PRESS",2,"Rep08",3000,2980,3000,3050,2990,3025,0.012,-35,3007.5,"Rep",20,-50,FALSE,FALSE,FALSE,1.16,"young",31,166,46,"f"
17,"LEG PRESS",2,"Rep09",2760,2780,2650,2700,2770,2675,0.034,95,2722.5,"Rep",-20,-50,FALSE,FALSE,FALSE,3.55,"young",31,166,46,"f"
17,"LEG PRESS",2,"Rep10",3120,3100,3400,3150,3110,3275,0.053,-165,3192.5,"Rep",20,250,TRUE,FALSE,TRUE,5.04,"young",31,166,46,"f"
17,"LEG PRESS",1,"TuT",32220,32260,32400,32400,32240,32400,0.005,-160,32320,"TuT",-40,0,FALSE,FALSE,FALSE,0.49,"young",31,166,46,"f"
17,"LEG PRESS",2,"TuT",30520,30500,30550,30500,30510,30525,0,-15,30517.5,"TuT",20,50,FALSE,FALSE,FALSE,0.05,"young",31,166,46,"f"
17,"LEG EXTENSION",1,"Con01",1980,1960,2000,2050,1970,2025,0.028,-55,1997.5,"Con",20,-50,FALSE,FALSE,FALSE,2.72,"young",31,166,46,"f"
17,"LEG EXTENSION",1,"Con02",1760,1800,1750,1750,1780,1750,0.017,30,1765,"Con",-40,0,FALSE,TRUE,FALSE,1.71,"young",31,166,46,"f"
17,"LEG EXTENSION",1,"Con03",1680,1660,1650,1650,1670,1650,0.012,20,1660,"Con",20,0,FALSE,FALSE,FALSE,1.21,"young",31,166,46,"f"
17,"LEG EXTENSION",1,"Con04",1720,1760,1750,1750,1740,1750,0.006,-10,1745,"Con",-40,0,FALSE,TRUE,FALSE,0.57,"young",31,166,46,"f"
17,"LEG EXTENSION",1,"Con05",1460,1480,1600,1500,1470,1550,0.054,-80,1510,"Con",-20,100,FALSE,FALSE,FALSE,5.16,"young",31,166,46,"f"
17,"LEG EXTENSION",1,"Con06",1480,1500,1550,1550,1490,1550,0.04,-60,1520,"Con",-20,0,FALSE,FALSE,FALSE,3.87,"young",31,166,46,"f"
17,"LEG EXTENSION",1,"Con07",1440,1420,1500,1500,1430,1500,0.049,-70,1465,"Con",20,0,FALSE,FALSE,FALSE,4.67,"young",31,166,46,"f"
17,"LEG EXTENSION",1,"Con08",1420,1440,1500,1500,1430,1500,0.049,-70,1465,"Con",-20,0,FALSE,FALSE,FALSE,4.67,"young",31,166,46,"f"
17,"LEG EXTENSION",1,"Con09",1360,1380,1450,1450,1370,1450,0.058,-80,1410,"Con",-20,0,FALSE,FALSE,FALSE,5.52,"young",31,166,46,"f"
17,"LEG EXTENSION",1,"Con10",1340,1360,1450,1550,1350,1500,0.111,-150,1425,"Con",-20,-100,FALSE,FALSE,FALSE,10,"young",31,166,46,"f"
17,"LEG EXTENSION",2,"Con01",1620,1620,1600,1600,1620,1600,0.012,20,1610,"Con",0,0,FALSE,FALSE,FALSE,1.25,"young",31,166,46,"f"
17,"LEG EXTENSION",2,"Con02",1340,1360,1400,1400,1350,1400,0.037,-50,1375,"Con",-20,0,FALSE,FALSE,FALSE,3.57,"young",31,166,46,"f"
17,"LEG EXTENSION",2,"Con03",1440,1440,1450,1450,1440,1450,0.007,-10,1445,"Con",0,0,FALSE,FALSE,FALSE,0.69,"young",31,166,46,"f"
17,"LEG EXTENSION",2,"Con04",1340,1340,1350,1350,1340,1350,0.007,-10,1345,"Con",0,0,FALSE,FALSE,FALSE,0.74,"young",31,166,46,"f"
17,"LEG EXTENSION",2,"Con05",1360,1360,1400,1400,1360,1400,0.029,-40,1380,"Con",0,0,FALSE,FALSE,FALSE,2.86,"young",31,166,46,"f"
17,"LEG EXTENSION",2,"Con06",1440,1460,1500,1500,1450,1500,0.034,-50,1475,"Con",-20,0,FALSE,FALSE,FALSE,3.33,"young",31,166,46,"f"
17,"LEG EXTENSION",2,"Con07",1380,1400,1450,1450,1390,1450,0.043,-60,1420,"Con",-20,0,FALSE,FALSE,FALSE,4.14,"young",31,166,46,"f"
17,"LEG EXTENSION",2,"Con08",1260,1280,1400,1350,1270,1375,0.083,-105,1322.5,"Con",-20,50,FALSE,FALSE,FALSE,7.64,"young",31,166,46,"f"
17,"LEG EXTENSION",2,"Con09",1260,1240,1350,1350,1250,1350,0.08,-100,1300,"Con",20,0,FALSE,FALSE,FALSE,7.41,"young",31,166,46,"f"
17,"LEG EXTENSION",2,"Con10",1080,1080,1200,1250,1080,1225,0.134,-145,1152.5,"Con",0,-50,FALSE,FALSE,FALSE,11.84,"young",31,166,46,"f"
17,"LEG EXTENSION",1,"Ecc01",2200,2180,2150,2200,2190,2175,0.007,15,2182.5,"Ecc",20,-50,FALSE,FALSE,FALSE,0.69,"young",31,166,46,"f"
17,"LEG EXTENSION",1,"Ecc02",2240,2240,2300,2250,2240,2275,0.016,-35,2257.5,"Ecc",0,50,FALSE,FALSE,FALSE,1.54,"young",31,166,46,"f"
17,"LEG EXTENSION",1,"Ecc03",2440,2440,2450,2450,2440,2450,0.004,-10,2445,"Ecc",0,0,FALSE,FALSE,FALSE,0.41,"young",31,166,46,"f"
17,"LEG EXTENSION",1,"Ecc04",2220,2180,2150,2200,2200,2175,0.011,25,2187.5,"Ecc",40,-50,FALSE,TRUE,FALSE,1.15,"young",31,166,46,"f"
17,"LEG EXTENSION",1,"Ecc05",2620,2580,2500,2550,2600,2525,0.029,75,2562.5,"Ecc",40,-50,FALSE,TRUE,FALSE,2.97,"young",31,166,46,"f"
17,"LEG EXTENSION",1,"Ecc06",1880,1880,1800,1800,1880,1800,0.043,80,1840,"Ecc",0,0,FALSE,FALSE,FALSE,4.44,"young",31,166,46,"f"
17,"LEG EXTENSION",1,"Ecc07",1900,1920,1850,1850,1910,1850,0.031,60,1880,"Ecc",-20,0,FALSE,FALSE,FALSE,3.24,"young",31,166,46,"f"
17,"LEG EXTENSION",1,"Ecc08",1980,1940,1900,1900,1960,1900,0.031,60,1930,"Ecc",40,0,FALSE,TRUE,FALSE,3.16,"young",31,166,46,"f"
17,"LEG EXTENSION",1,"Ecc09",1820,1800,1700,1650,1810,1675,0.075,135,1742.5,"Ecc",20,50,FALSE,FALSE,FALSE,8.06,"young",31,166,46,"f"
17,"LEG EXTENSION",1,"Ecc10",2240,2240,2250,2250,2240,2250,0.004,-10,2245,"Ecc",0,0,FALSE,FALSE,FALSE,0.44,"young",31,166,46,"f"
17,"LEG EXTENSION",2,"Ecc01",2140,2120,2150,2150,2130,2150,0.009,-20,2140,"Ecc",20,0,FALSE,FALSE,FALSE,0.93,"young",31,166,46,"f"
17,"LEG EXTENSION",2,"Ecc02",1860,1860,1800,1850,1860,1825,0.019,35,1842.5,"Ecc",0,-50,FALSE,FALSE,FALSE,1.92,"young",31,166,46,"f"
17,"LEG EXTENSION",2,"Ecc03",1780,1780,1800,1750,1780,1775,0.003,5,1777.5,"Ecc",0,50,FALSE,FALSE,FALSE,0.28,"young",31,166,46,"f"
17,"LEG EXTENSION",2,"Ecc04",1840,1840,1800,1800,1840,1800,0.022,40,1820,"Ecc",0,0,FALSE,FALSE,FALSE,2.22,"young",31,166,46,"f"
17,"LEG EXTENSION",2,"Ecc05",1760,1740,1700,1700,1750,1700,0.029,50,1725,"Ecc",20,0,FALSE,FALSE,FALSE,2.94,"young",31,166,46,"f"
17,"LEG EXTENSION",2,"Ecc06",1900,1880,1850,1850,1890,1850,0.021,40,1870,"Ecc",20,0,FALSE,FALSE,FALSE,2.16,"young",31,166,46,"f"
17,"LEG EXTENSION",2,"Ecc07",1920,1900,1800,1850,1910,1825,0.045,85,1867.5,"Ecc",20,-50,FALSE,FALSE,FALSE,4.66,"young",31,166,46,"f"
17,"LEG EXTENSION",2,"Ecc08",1860,1880,1750,1750,1870,1750,0.064,120,1810,"Ecc",-20,0,FALSE,FALSE,FALSE,6.86,"young",31,166,46,"f"
17,"LEG EXTENSION",2,"Ecc09",1840,1840,1750,1750,1840,1750,0.049,90,1795,"Ecc",0,0,FALSE,FALSE,FALSE,5.14,"young",31,166,46,"f"
17,"LEG EXTENSION",2,"Ecc10",2160,2120,2250,2050,2140,2150,0.005,-10,2145,"Ecc",40,200,FALSE,TRUE,TRUE,0.47,"young",31,166,46,"f"
17,"LEG EXTENSION",1,"Rep01",4180,4140,4150,4250,4160,4200,0.01,-40,4180,"Rep",40,-100,FALSE,FALSE,FALSE,0.95,"young",31,166,46,"f"
17,"LEG EXTENSION",1,"Rep02",4000,4040,4050,4000,4020,4025,0.001,-5,4022.5,"Rep",-40,50,FALSE,FALSE,FALSE,0.12,"young",31,166,46,"f"
17,"LEG EXTENSION",1,"Rep03",4120,4100,4100,4100,4110,4100,0.002,10,4105,"Rep",20,0,FALSE,FALSE,FALSE,0.24,"young",31,166,46,"f"
17,"LEG EXTENSION",1,"Rep04",3940,3940,3900,3950,3940,3925,0.004,15,3932.5,"Rep",0,-50,FALSE,FALSE,FALSE,0.38,"young",31,166,46,"f"
17,"LEG EXTENSION",1,"Rep05",4080,4060,4100,4050,4070,4075,0.001,-5,4072.5,"Rep",20,50,FALSE,FALSE,FALSE,0.12,"young",31,166,46,"f"
17,"LEG EXTENSION",1,"Rep06",3360,3380,3350,3350,3370,3350,0.006,20,3360,"Rep",-20,0,FALSE,FALSE,FALSE,0.6,"young",31,166,46,"f"
17,"LEG EXTENSION",1,"Rep07",3340,3340,3350,3350,3340,3350,0.003,-10,3345,"Rep",0,0,FALSE,FALSE,FALSE,0.3,"young",31,166,46,"f"
17,"LEG EXTENSION",1,"Rep08",3400,3380,3400,3400,3390,3400,0.003,-10,3395,"Rep",20,0,FALSE,FALSE,FALSE,0.29,"young",31,166,46,"f"
17,"LEG EXTENSION",1,"Rep09",3180,3180,3150,3100,3180,3125,0.017,55,3152.5,"Rep",0,50,FALSE,FALSE,FALSE,1.76,"young",31,166,46,"f"
17,"LEG EXTENSION",1,"Rep10",3580,3600,3700,3800,3590,3750,0.045,-160,3670,"Rep",-20,-100,TRUE,FALSE,FALSE,4.27,"young",31,166,46,"f"
17,"LEG EXTENSION",2,"Rep01",3760,3740,3750,3750,3750,3750,0,0,3750,"Rep",20,0,FALSE,FALSE,FALSE,0,"young",31,166,46,"f"
17,"LEG EXTENSION",2,"Rep02",3200,3220,3200,3250,3210,3225,0.005,-15,3217.5,"Rep",-20,-50,FALSE,FALSE,FALSE,0.47,"young",31,166,46,"f"
17,"LEG EXTENSION",2,"Rep03",3220,3220,3250,3200,3220,3225,0.002,-5,3222.5,"Rep",0,50,FALSE,FALSE,FALSE,0.16,"young",31,166,46,"f"
17,"LEG EXTENSION",2,"Rep04",3180,3180,3150,3150,3180,3150,0.009,30,3165,"Rep",0,0,FALSE,FALSE,FALSE,0.95,"young",31,166,46,"f"
17,"LEG EXTENSION",2,"Rep05",3120,3100,3100,3100,3110,3100,0.003,10,3105,"Rep",20,0,FALSE,FALSE,FALSE,0.32,"young",31,166,46,"f"
17,"LEG EXTENSION",2,"Rep06",3340,3340,3350,3350,3340,3350,0.003,-10,3345,"Rep",0,0,FALSE,FALSE,FALSE,0.3,"young",31,166,46,"f"
17,"LEG EXTENSION",2,"Rep07",3300,3300,3250,3300,3300,3275,0.008,25,3287.5,"Rep",0,-50,FALSE,FALSE,FALSE,0.76,"young",31,166,46,"f"
17,"LEG EXTENSION",2,"Rep08",3120,3160,3150,3100,3140,3125,0.005,15,3132.5,"Rep",-40,50,FALSE,FALSE,FALSE,0.48,"young",31,166,46,"f"
17,"LEG EXTENSION",2,"Rep09",3100,3080,3100,3100,3090,3100,0.003,-10,3095,"Rep",20,0,FALSE,FALSE,FALSE,0.32,"young",31,166,46,"f"
17,"LEG EXTENSION",2,"Rep10",3240,3200,3450,3300,3220,3375,0.048,-155,3297.5,"Rep",40,150,TRUE,FALSE,FALSE,4.59,"young",31,166,46,"f"
17,"LEG EXTENSION",1,"TuT",37180,37160,37250,37350,37170,37300,0.003,-130,37235,"TuT",20,-100,FALSE,FALSE,FALSE,0.35,"young",31,166,46,"f"
17,"LEG EXTENSION",2,"TuT",32580,32540,32750,32600,32560,32675,0.004,-115,32617.5,"TuT",40,150,FALSE,FALSE,FALSE,0.35,"young",31,166,46,"f"
17,"LEG CURL",1,"Con01",2080,2080,2100,2100,2080,2100,0.01,-20,2090,"Con",0,0,FALSE,FALSE,FALSE,0.95,"young",31,166,46,"f"
17,"LEG CURL",1,"Con02",1880,1880,1800,1800,1880,1800,0.043,80,1840,"Con",0,0,FALSE,FALSE,FALSE,4.44,"young",31,166,46,"f"
17,"LEG CURL",1,"Con03",2080,2100,2150,2400,2090,2275,0.089,-185,2182.5,"Con",-20,-250,FALSE,FALSE,TRUE,8.13,"young",31,166,46,"f"
17,"LEG CURL",1,"Con04",2160,2180,2250,2250,2170,2250,0.037,-80,2210,"Con",-20,0,FALSE,FALSE,FALSE,3.56,"young",31,166,46,"f"
17,"LEG CURL",1,"Con05",2080,2100,2150,2250,2090,2200,0.053,-110,2145,"Con",-20,-100,FALSE,FALSE,FALSE,5,"young",31,166,46,"f"
17,"LEG CURL",1,"Con06",1940,1920,1950,1950,1930,1950,0.01,-20,1940,"Con",20,0,FALSE,FALSE,FALSE,1.03,"young",31,166,46,"f"
17,"LEG CURL",1,"Con07",2040,2060,2150,2050,2050,2100,0.024,-50,2075,"Con",-20,100,FALSE,FALSE,FALSE,2.38,"young",31,166,46,"f"
17,"LEG CURL",1,"Con08",1800,1820,2000,1950,1810,1975,0.091,-165,1892.5,"Con",-20,50,FALSE,FALSE,FALSE,8.35,"young",31,166,46,"f"
17,"LEG CURL",1,"Con09",2040,2060,2100,2100,2050,2100,0.024,-50,2075,"Con",-20,0,FALSE,FALSE,FALSE,2.38,"young",31,166,46,"f"
17,"LEG CURL",1,"Con10",1980,2000,2100,2100,1990,2100,0.055,-110,2045,"Con",-20,0,FALSE,FALSE,FALSE,5.24,"young",31,166,46,"f"
17,"LEG CURL",2,"Con01",2360,2340,2400,2300,2350,2350,0,0,2350,"Con",20,100,FALSE,FALSE,FALSE,0,"young",31,166,46,"f"
17,"LEG CURL",2,"Con02",1980,1960,1950,1950,1970,1950,0.01,20,1960,"Con",20,0,FALSE,FALSE,FALSE,1.03,"young",31,166,46,"f"
17,"LEG CURL",2,"Con03",2440,2440,2400,2550,2440,2475,0.014,-35,2457.5,"Con",0,-150,FALSE,FALSE,FALSE,1.41,"young",31,166,46,"f"
17,"LEG CURL",2,"Con04",1860,1880,1800,1950,1870,1875,0.003,-5,1872.5,"Con",-20,-150,FALSE,FALSE,FALSE,0.27,"young",31,166,46,"f"
17,"LEG CURL",2,"Con05",1900,1920,2000,2000,1910,2000,0.047,-90,1955,"Con",-20,0,FALSE,FALSE,FALSE,4.5,"young",31,166,46,"f"
17,"LEG CURL",2,"Con06",1800,1800,1900,1850,1800,1875,0.042,-75,1837.5,"Con",0,50,FALSE,FALSE,FALSE,4,"young",31,166,46,"f"
17,"LEG CURL",2,"Con07",1660,1680,1750,1800,1670,1775,0.063,-105,1722.5,"Con",-20,-50,FALSE,FALSE,FALSE,5.92,"young",31,166,46,"f"
17,"LEG CURL",2,"Con08",1660,1660,1800,1800,1660,1800,0.084,-140,1730,"Con",0,0,FALSE,FALSE,FALSE,7.78,"young",31,166,46,"f"
17,"LEG CURL",2,"Con09",1720,1700,1950,1900,1710,1925,0.126,-215,1817.5,"Con",20,50,FALSE,FALSE,FALSE,11.17,"young",31,166,46,"f"
17,"LEG CURL",2,"Con10",1660,1660,1850,1800,1660,1825,0.099,-165,1742.5,"Con",0,50,FALSE,FALSE,FALSE,9.04,"young",31,166,46,"f"
17,"LEG CURL",1,"Ecc01",2420,2440,2500,2550,2430,2525,0.039,-95,2477.5,"Ecc",-20,-50,FALSE,FALSE,FALSE,3.76,"young",31,166,46,"f"
17,"LEG CURL",1,"Ecc02",2700,2700,2650,2400,2700,2525,0.065,175,2612.5,"Ecc",0,250,FALSE,FALSE,TRUE,6.93,"young",31,166,46,"f"
17,"LEG CURL",1,"Ecc03",2200,2160,2100,2100,2180,2100,0.037,80,2140,"Ecc",40,0,FALSE,FALSE,FALSE,3.81,"young",31,166,46,"f"
17,"LEG CURL",1,"Ecc04",2280,2260,2250,2200,2270,2225,0.02,45,2247.5,"Ecc",20,50,FALSE,FALSE,FALSE,2.02,"young",31,166,46,"f"
17,"LEG CURL",1,"Ecc05",2220,2240,2150,2100,2230,2125,0.047,105,2177.5,"Ecc",-20,50,FALSE,FALSE,FALSE,4.94,"young",31,166,46,"f"
17,"LEG CURL",1,"Ecc06",2180,2160,2150,2200,2170,2175,0.002,-5,2172.5,"Ecc",20,-50,FALSE,FALSE,FALSE,0.23,"young",31,166,46,"f"
17,"LEG CURL",1,"Ecc07",2440,2420,2200,2300,2430,2250,0.074,180,2340,"Ecc",20,-100,FALSE,FALSE,FALSE,8,"young",31,166,46,"f"
17,"LEG CURL",1,"Ecc08",2360,2360,2300,2300,2360,2300,0.025,60,2330,"Ecc",0,0,FALSE,FALSE,FALSE,2.61,"young",31,166,46,"f"
17,"LEG CURL",1,"Ecc09",2360,2320,2250,2250,2340,2250,0.038,90,2295,"Ecc",40,0,FALSE,FALSE,FALSE,4,"young",31,166,46,"f"
17,"LEG CURL",1,"Ecc10",3180,3160,3200,2550,3170,2875,0.093,295,3022.5,"Ecc",20,650,TRUE,FALSE,TRUE,10.26,"young",31,166,46,"f"
17,"LEG CURL",2,"Ecc01",1960,1960,2000,2050,1960,2025,0.033,-65,1992.5,"Ecc",0,-50,FALSE,FALSE,FALSE,3.21,"young",31,166,46,"f"
17,"LEG CURL",2,"Ecc02",2120,2120,2100,2000,2120,2050,0.033,70,2085,"Ecc",0,100,FALSE,FALSE,FALSE,3.41,"young",31,166,46,"f"
17,"LEG CURL",2,"Ecc03",2300,2300,2400,2200,2300,2300,0,0,2300,"Ecc",0,200,FALSE,FALSE,TRUE,0,"young",31,166,46,"f"
17,"LEG CURL",2,"Ecc04",2040,2020,2000,1950,2030,1975,0.027,55,2002.5,"Ecc",20,50,FALSE,FALSE,FALSE,2.78,"young",31,166,46,"f"
17,"LEG CURL",2,"Ecc05",1940,1940,1850,1900,1940,1875,0.034,65,1907.5,"Ecc",0,-50,FALSE,FALSE,FALSE,3.47,"young",31,166,46,"f"
17,"LEG CURL",2,"Ecc06",2060,2020,1950,1950,2040,1950,0.044,90,1995,"Ecc",40,0,FALSE,FALSE,FALSE,4.62,"young",31,166,46,"f"
17,"LEG CURL",2,"Ecc07",1940,1940,1850,1800,1940,1825,0.059,115,1882.5,"Ecc",0,50,FALSE,FALSE,FALSE,6.3,"young",31,166,46,"f"
17,"LEG CURL",2,"Ecc08",2040,2060,1850,1900,2050,1875,0.085,175,1962.5,"Ecc",-20,-50,FALSE,FALSE,FALSE,9.33,"young",31,166,46,"f"
17,"LEG CURL",2,"Ecc09",1960,1960,1750,1800,1960,1775,0.094,185,1867.5,"Ecc",0,-50,FALSE,FALSE,FALSE,10.42,"young",31,166,46,"f"
17,"LEG CURL",2,"Ecc10",2400,2400,2350,2400,2400,2375,0.01,25,2387.5,"Ecc",0,-50,FALSE,FALSE,FALSE,1.05,"young",31,166,46,"f"
17,"LEG CURL",1,"Rep01",4500,4520,4600,4650,4510,4625,0.025,-115,4567.5,"Rep",-20,-50,FALSE,FALSE,FALSE,2.49,"young",31,166,46,"f"
17,"LEG CURL",1,"Rep02",4580,4580,4450,4200,4580,4325,0.056,255,4452.5,"Rep",0,250,TRUE,FALSE,TRUE,5.9,"young",31,166,46,"f"
17,"LEG CURL",1,"Rep03",4280,4260,4250,4500,4270,4375,0.025,-105,4322.5,"Rep",20,-250,FALSE,FALSE,TRUE,2.4,"young",31,166,46,"f"
17,"LEG CURL",1,"Rep04",4440,4440,4500,4450,4440,4475,0.008,-35,4457.5,"Rep",0,50,FALSE,FALSE,FALSE,0.78,"young",31,166,46,"f"
17,"LEG CURL",1,"Rep05",4300,4340,4300,4350,4320,4325,0.001,-5,4322.5,"Rep",-40,-50,FALSE,FALSE,FALSE,0.12,"young",31,166,46,"f"
17,"LEG CURL",1,"Rep06",4120,4080,4100,4150,4100,4125,0.006,-25,4112.5,"Rep",40,-50,FALSE,FALSE,FALSE,0.61,"young",31,166,46,"f"
17,"LEG CURL",1,"Rep07",4480,4480,4350,4350,4480,4350,0.029,130,4415,"Rep",0,0,FALSE,FALSE,FALSE,2.99,"young",31,166,46,"f"
17,"LEG CURL",1,"Rep08",4160,4180,4300,4250,4170,4275,0.025,-105,4222.5,"Rep",-20,50,FALSE,FALSE,FALSE,2.46,"young",31,166,46,"f"
17,"LEG CURL",1,"Rep09",4400,4380,4350,4350,4390,4350,0.009,40,4370,"Rep",20,0,FALSE,FALSE,FALSE,0.92,"young",31,166,46,"f"
17,"LEG CURL",1,"Rep10",5160,5160,5300,4650,5160,4975,0.036,185,5067.5,"Rep",0,650,TRUE,FALSE,TRUE,3.72,"young",31,166,46,"f"
17,"LEG CURL",2,"Rep01",4320,4300,4400,4350,4310,4375,0.015,-65,4342.5,"Rep",20,50,FALSE,FALSE,FALSE,1.49,"young",31,166,46,"f"
17,"LEG CURL",2,"Rep02",4100,4080,4050,3950,4090,4000,0.022,90,4045,"Rep",20,100,FALSE,FALSE,FALSE,2.25,"young",31,166,46,"f"
17,"LEG CURL",2,"Rep03",4740,4740,4800,4750,4740,4775,0.007,-35,4757.5,"Rep",0,50,FALSE,FALSE,FALSE,0.73,"young",31,166,46,"f"
17,"LEG CURL",2,"Rep04",3900,3900,3800,3900,3900,3850,0.013,50,3875,"Rep",0,-100,FALSE,FALSE,FALSE,1.3,"young",31,166,46,"f"
17,"LEG CURL",2,"Rep05",3840,3860,3850,3900,3850,3875,0.006,-25,3862.5,"Rep",-20,-50,FALSE,FALSE,FALSE,0.65,"young",31,166,46,"f"
17,"LEG CURL",2,"Rep06",3860,3820,3850,3800,3840,3825,0.004,15,3832.5,"Rep",40,50,FALSE,FALSE,FALSE,0.39,"young",31,166,46,"f"
17,"LEG CURL",2,"Rep07",3600,3620,3600,3600,3610,3600,0.003,10,3605,"Rep",-20,0,FALSE,FALSE,FALSE,0.28,"young",31,166,46,"f"
17,"LEG CURL",2,"Rep08",3700,3720,3650,3700,3710,3675,0.009,35,3692.5,"Rep",-20,-50,FALSE,FALSE,FALSE,0.95,"young",31,166,46,"f"
17,"LEG CURL",2,"Rep09",3680,3660,3700,3700,3670,3700,0.008,-30,3685,"Rep",20,0,FALSE,FALSE,FALSE,0.81,"young",31,166,46,"f"
17,"LEG CURL",2,"Rep10",4060,4060,4200,4200,4060,4200,0.034,-140,4130,"Rep",0,0,FALSE,FALSE,FALSE,3.33,"young",31,166,46,"f"
17,"LEG CURL",1,"TuT",44420,44420,44500,43900,44420,44200,0.005,220,44310,"TuT",0,600,FALSE,FALSE,TRUE,0.5,"young",31,166,46,"f"
17,"LEG CURL",2,"TuT",39800,39760,39900,39850,39780,39875,0.002,-95,39827.5,"TuT",40,50,FALSE,TRUE,FALSE,0.24,"young",31,166,46,"f"
17,"ABDUCTOR",1,"Con01",1600,1620,1150,1100,1610,1125,0.301,485,1367.5,"Con",-20,50,TRUE,FALSE,FALSE,43.11,"young",31,166,46,"f"
17,"ABDUCTOR",1,"Con02",1320,1340,1100,1250,1330,1175,0.117,155,1252.5,"Con",-20,-150,FALSE,FALSE,FALSE,13.19,"young",31,166,46,"f"
17,"ABDUCTOR",1,"Con03",1340,1380,1450,1450,1360,1450,0.066,-90,1405,"Con",-40,0,FALSE,TRUE,FALSE,6.21,"young",31,166,46,"f"
17,"ABDUCTOR",1,"Con04",1260,1280,1950,1650,1270,1800,0.417,-530,1535,"Con",-20,300,TRUE,FALSE,TRUE,29.44,"young",31,166,46,"f"
17,"ABDUCTOR",1,"Con05",1240,1260,1200,1150,1250,1175,0.06,75,1212.5,"Con",-20,50,FALSE,FALSE,FALSE,6.38,"young",31,166,46,"f"
17,"ABDUCTOR",1,"Con06",1320,1320,1250,1050,1320,1150,0.129,170,1235,"Con",0,200,FALSE,FALSE,FALSE,14.78,"young",31,166,46,"f"
17,"ABDUCTOR",1,"Con07",1260,1240,850,800,1250,825,0.34,425,1037.5,"Con",20,50,TRUE,FALSE,FALSE,51.52,"young",31,166,46,"f"
17,"ABDUCTOR",1,"Con08",1140,1140,1000,950,1140,975,0.145,165,1057.5,"Con",0,50,FALSE,FALSE,FALSE,16.92,"young",31,166,46,"f"
17,"ABDUCTOR",1,"Con09",1160,1180,1000,1150,1170,1075,0.081,95,1122.5,"Con",-20,-150,FALSE,FALSE,FALSE,8.84,"young",31,166,46,"f"
17,"ABDUCTOR",1,"Con10",1260,1260,1550,1900,1260,1725,0.369,-465,1492.5,"Con",0,-350,TRUE,FALSE,TRUE,26.96,"young",31,166,46,"f"
17,"ABDUCTOR",2,"Con01",1300,1320,2350,2250,1310,2300,0.756,-990,1805,"Con",-20,100,TRUE,FALSE,FALSE,43.04,"young",31,166,46,"f"
17,"ABDUCTOR",2,"Con02",1260,1300,1100,1150,1280,1125,0.121,155,1202.5,"Con",-40,-50,FALSE,TRUE,FALSE,13.78,"young",31,166,46,"f"
17,"ABDUCTOR",2,"Con03",1500,1480,1100,1200,1490,1150,0.228,340,1320,"Con",20,-100,TRUE,FALSE,FALSE,29.57,"young",31,166,46,"f"
17,"ABDUCTOR",2,"Con04",1400,1360,1550,1600,1380,1575,0.141,-195,1477.5,"Con",40,-50,FALSE,TRUE,FALSE,12.38,"young",31,166,46,"f"
17,"ABDUCTOR",2,"Con05",1380,1420,1450,1400,1400,1425,0.018,-25,1412.5,"Con",-40,50,FALSE,TRUE,FALSE,1.75,"young",31,166,46,"f"
17,"ABDUCTOR",2,"Con06",1300,1320,1550,1500,1310,1525,0.164,-215,1417.5,"Con",-20,50,FALSE,FALSE,FALSE,14.1,"young",31,166,46,"f"
17,"ABDUCTOR",2,"Con07",1360,1360,1200,1150,1360,1175,0.136,185,1267.5,"Con",0,50,FALSE,FALSE,FALSE,15.74,"young",31,166,46,"f"
17,"ABDUCTOR",2,"Con08",1300,1280,1250,1300,1290,1275,0.012,15,1282.5,"Con",20,-50,FALSE,FALSE,FALSE,1.18,"young",31,166,46,"f"
17,"ABDUCTOR",2,"Con09",1420,1400,1350,1250,1410,1300,0.078,110,1355,"Con",20,100,FALSE,FALSE,FALSE,8.46,"young",31,166,46,"f"
17,"ABDUCTOR",2,"Con10",1460,1440,1300,1300,1450,1300,0.103,150,1375,"Con",20,0,FALSE,FALSE,FALSE,11.54,"young",31,166,46,"f"
17,"ABDUCTOR",1,"Ecc01",1780,1740,1400,1300,1760,1350,0.233,410,1555,"Ecc",40,100,TRUE,TRUE,FALSE,30.37,"young",31,166,46,"f"
17,"ABDUCTOR",1,"Ecc02",1880,1860,1650,1550,1870,1600,0.144,270,1735,"Ecc",20,100,FALSE,FALSE,FALSE,16.88,"young",31,166,46,"f"
17,"ABDUCTOR",1,"Ecc03",1600,1580,1150,1500,1590,1325,0.167,265,1457.5,"Ecc",20,-350,FALSE,FALSE,TRUE,20,"young",31,166,46,"f"
17,"ABDUCTOR",1,"Ecc04",1680,1640,1600,1600,1660,1600,0.036,60,1630,"Ecc",40,0,FALSE,TRUE,FALSE,3.75,"young",31,166,46,"f"
17,"ABDUCTOR",1,"Ecc05",1620,1620,1500,1600,1620,1550,0.043,70,1585,"Ecc",0,-100,FALSE,FALSE,FALSE,4.52,"young",31,166,46,"f"
17,"ABDUCTOR",1,"Ecc06",1600,1620,1750,1900,1610,1825,0.134,-215,1717.5,"Ecc",-20,-150,FALSE,FALSE,FALSE,11.78,"young",31,166,46,"f"
17,"ABDUCTOR",1,"Ecc07",1660,1660,1750,1800,1660,1775,0.069,-115,1717.5,"Ecc",0,-50,FALSE,FALSE,FALSE,6.48,"young",31,166,46,"f"
17,"ABDUCTOR",1,"Ecc08",1400,1400,1600,1550,1400,1575,0.125,-175,1487.5,"Ecc",0,50,FALSE,FALSE,FALSE,11.11,"young",31,166,46,"f"
17,"ABDUCTOR",1,"Ecc09",1560,1540,1350,900,1550,1125,0.274,425,1337.5,"Ecc",20,450,TRUE,FALSE,TRUE,37.78,"young",31,166,46,"f"
17,"ABDUCTOR",1,"Ecc10",2340,2320,2000,1950,2330,1975,0.152,355,2152.5,"Ecc",20,50,TRUE,FALSE,FALSE,17.97,"young",31,166,46,"f"
17,"ABDUCTOR",2,"Ecc01",1820,1800,1550,1550,1810,1550,0.144,260,1680,"Ecc",20,0,FALSE,FALSE,FALSE,16.77,"young",31,166,46,"f"
17,"ABDUCTOR",2,"Ecc02",1580,1560,1550,1450,1570,1500,0.045,70,1535,"Ecc",20,100,FALSE,FALSE,FALSE,4.67,"young",31,166,46,"f"
17,"ABDUCTOR",2,"Ecc03",1700,1740,1650,1550,1720,1600,0.07,120,1660,"Ecc",-40,100,FALSE,TRUE,FALSE,7.5,"young",31,166,46,"f"
17,"ABDUCTOR",2,"Ecc04",1700,1680,1400,1450,1690,1425,0.157,265,1557.5,"Ecc",20,-50,FALSE,FALSE,FALSE,18.6,"young",31,166,46,"f"
17,"ABDUCTOR",2,"Ecc05",1680,1660,1600,1600,1670,1600,0.042,70,1635,"Ecc",20,0,FALSE,FALSE,FALSE,4.38,"young",31,166,46,"f"
17,"ABDUCTOR",2,"Ecc06",1580,1560,1450,1550,1570,1500,0.045,70,1535,"Ecc",20,-100,FALSE,FALSE,FALSE,4.67,"young",31,166,46,"f"
17,"ABDUCTOR",2,"Ecc07",1500,1520,1500,1500,1510,1500,0.007,10,1505,"Ecc",-20,0,FALSE,FALSE,FALSE,0.67,"young",31,166,46,"f"
17,"ABDUCTOR",2,"Ecc08",1520,1540,1650,1650,1530,1650,0.078,-120,1590,"Ecc",-20,0,FALSE,FALSE,FALSE,7.27,"young",31,166,46,"f"
17,"ABDUCTOR",2,"Ecc09",1560,1580,1500,1550,1570,1525,0.029,45,1547.5,"Ecc",-20,-50,FALSE,FALSE,FALSE,2.95,"young",31,166,46,"f"
17,"ABDUCTOR",2,"Ecc10",2100,2080,1700,2300,2090,2000,0.043,90,2045,"Ecc",20,-600,FALSE,FALSE,TRUE,4.5,"young",31,166,46,"f"
17,"ABDUCTOR",1,"Rep01",3380,3360,2550,2400,3370,2475,0.266,895,2922.5,"Rep",20,150,TRUE,FALSE,FALSE,36.16,"young",31,166,46,"f"
17,"ABDUCTOR",1,"Rep02",3200,3200,2750,2800,3200,2775,0.133,425,2987.5,"Rep",0,-50,TRUE,FALSE,FALSE,15.32,"young",31,166,46,"f"
17,"ABDUCTOR",1,"Rep03",2940,2960,2600,2950,2950,2775,0.059,175,2862.5,"Rep",-20,-350,FALSE,FALSE,TRUE,6.31,"young",31,166,46,"f"
17,"ABDUCTOR",1,"Rep04",2940,2920,3550,3250,2930,3400,0.16,-470,3165,"Rep",20,300,TRUE,FALSE,FALSE,13.82,"young",31,166,46,"f"
17,"ABDUCTOR",1,"Rep05",2860,2880,2700,2750,2870,2725,0.051,145,2797.5,"Rep",-20,-50,FALSE,FALSE,FALSE,5.32,"young",31,166,46,"f"
17,"ABDUCTOR",1,"Rep06",2920,2940,3000,2950,2930,2975,0.015,-45,2952.5,"Rep",-20,50,FALSE,FALSE,FALSE,1.51,"young",31,166,46,"f"
17,"ABDUCTOR",1,"Rep07",2920,2900,2600,2600,2910,2600,0.107,310,2755,"Rep",20,0,TRUE,FALSE,FALSE,11.92,"young",31,166,46,"f"
17,"ABDUCTOR",1,"Rep08",2540,2540,2600,2500,2540,2550,0.004,-10,2545,"Rep",0,100,FALSE,FALSE,FALSE,0.39,"young",31,166,46,"f"
17,"ABDUCTOR",1,"Rep09",2720,2720,2350,2050,2720,2200,0.191,520,2460,"Rep",0,300,TRUE,FALSE,FALSE,23.64,"young",31,166,46,"f"
17,"ABDUCTOR",1,"Rep10",3600,3580,3550,3850,3590,3700,0.031,-110,3645,"Rep",20,-300,FALSE,FALSE,FALSE,2.97,"young",31,166,46,"f"
17,"ABDUCTOR",2,"Rep01",3120,3120,3900,3800,3120,3850,0.234,-730,3485,"Rep",0,100,TRUE,FALSE,FALSE,18.96,"young",31,166,46,"f"
17,"ABDUCTOR",2,"Rep02",2840,2860,2650,2600,2850,2625,0.079,225,2737.5,"Rep",-20,50,FALSE,FALSE,FALSE,8.57,"young",31,166,46,"f"
17,"ABDUCTOR",2,"Rep03",3200,3220,2750,2750,3210,2750,0.143,460,2980,"Rep",-20,0,TRUE,FALSE,FALSE,16.73,"young",31,166,46,"f"
17,"ABDUCTOR",2,"Rep04",3100,3040,2950,3050,3070,3000,0.023,70,3035,"Rep",60,-100,FALSE,FALSE,FALSE,2.33,"young",31,166,46,"f"
17,"ABDUCTOR",2,"Rep05",3060,3080,3050,3000,3070,3025,0.015,45,3047.5,"Rep",-20,50,FALSE,FALSE,FALSE,1.49,"young",31,166,46,"f"
17,"ABDUCTOR",2,"Rep06",2880,2880,3000,3050,2880,3025,0.05,-145,2952.5,"Rep",0,-50,FALSE,FALSE,FALSE,4.79,"young",31,166,46,"f"
17,"ABDUCTOR",2,"Rep07",2860,2880,2700,2650,2870,2675,0.068,195,2772.5,"Rep",-20,50,FALSE,FALSE,FALSE,7.29,"young",31,166,46,"f"
17,"ABDUCTOR",2,"Rep08",2820,2820,2900,2950,2820,2925,0.037,-105,2872.5,"Rep",0,-50,FALSE,FALSE,FALSE,3.59,"young",31,166,46,"f"
17,"ABDUCTOR",2,"Rep09",2980,2980,2850,2800,2980,2825,0.052,155,2902.5,"Rep",0,50,FALSE,FALSE,FALSE,5.49,"young",31,166,46,"f"
17,"ABDUCTOR",2,"Rep10",3560,3520,3000,3600,3540,3300,0.068,240,3420,"Rep",40,-600,FALSE,FALSE,TRUE,7.27,"young",31,166,46,"f"
17,"ABDUCTOR",1,"TuT",30020,30000,28250,28100,30010,28175,0.061,1835,29092.5,"TuT",20,150,TRUE,FALSE,FALSE,6.51,"young",31,166,46,"f"
17,"ABDUCTOR",2,"TuT",30420,30400,29750,30250,30410,30000,0.013,410,30205,"TuT",20,-500,FALSE,FALSE,TRUE,1.37,"young",31,166,46,"f"
17,"ADDUCTOR",1,"Con01",1160,1160,1250,1700,1160,1475,0.272,-315,1317.5,"Con",0,-450,FALSE,FALSE,TRUE,21.36,"young",31,166,46,"f"
17,"ADDUCTOR",1,"Con02",1060,1040,1250,1400,1050,1325,0.262,-275,1187.5,"Con",20,-150,FALSE,FALSE,FALSE,20.75,"young",31,166,46,"f"
17,"ADDUCTOR",1,"Con03",1140,1160,1300,1400,1150,1350,0.174,-200,1250,"Con",-20,-100,FALSE,FALSE,FALSE,14.81,"young",31,166,46,"f"
17,"ADDUCTOR",1,"Con04",1360,1360,1250,1350,1360,1300,0.044,60,1330,"Con",0,-100,FALSE,FALSE,FALSE,4.62,"young",31,166,46,"f"
17,"ADDUCTOR",1,"Con05",1060,1040,1350,1400,1050,1375,0.31,-325,1212.5,"Con",20,-50,FALSE,FALSE,FALSE,23.64,"young",31,166,46,"f"
17,"ADDUCTOR",1,"Con06",1160,1180,1350,1350,1170,1350,0.154,-180,1260,"Con",-20,0,FALSE,FALSE,FALSE,13.33,"young",31,166,46,"f"
17,"ADDUCTOR",1,"Con07",1060,1060,1300,1300,1060,1300,0.226,-240,1180,"Con",0,0,FALSE,FALSE,FALSE,18.46,"young",31,166,46,"f"
17,"ADDUCTOR",1,"Con08",1160,1160,1300,1300,1160,1300,0.121,-140,1230,"Con",0,0,FALSE,FALSE,FALSE,10.77,"young",31,166,46,"f"
17,"ADDUCTOR",1,"Con09",1020,1000,1250,1150,1010,1200,0.188,-190,1105,"Con",20,100,FALSE,FALSE,FALSE,15.83,"young",31,166,46,"f"
17,"ADDUCTOR",1,"Con10",1120,1120,1350,1250,1120,1300,0.161,-180,1210,"Con",0,100,FALSE,FALSE,FALSE,13.85,"young",31,166,46,"f"
17,"ADDUCTOR",2,"Con01",2380,2380,1450,1550,2380,1500,0.37,880,1940,"Con",0,-100,TRUE,FALSE,FALSE,58.67,"young",31,166,46,"f"
17,"ADDUCTOR",2,"Con02",1140,1160,1300,1250,1150,1275,0.109,-125,1212.5,"Con",-20,50,FALSE,FALSE,FALSE,9.8,"young",31,166,46,"f"
17,"ADDUCTOR",2,"Con03",1100,1100,1550,1550,1100,1550,0.409,-450,1325,"Con",0,0,FALSE,FALSE,FALSE,29.03,"young",31,166,46,"f"
17,"ADDUCTOR",2,"Con04",1320,1340,1350,1400,1330,1375,0.034,-45,1352.5,"Con",-20,-50,FALSE,FALSE,FALSE,3.27,"young",31,166,46,"f"
17,"ADDUCTOR",2,"Con05",1280,1280,1450,1400,1280,1425,0.113,-145,1352.5,"Con",0,50,FALSE,FALSE,FALSE,10.18,"young",31,166,46,"f"
17,"ADDUCTOR",2,"Con06",1580,1580,1400,1350,1580,1375,0.13,205,1477.5,"Con",0,50,FALSE,FALSE,FALSE,14.91,"young",31,166,46,"f"
17,"ADDUCTOR",2,"Con07",1140,1140,1500,1400,1140,1450,0.272,-310,1295,"Con",0,100,FALSE,FALSE,FALSE,21.38,"young",31,166,46,"f"
17,"ADDUCTOR",2,"Con08",1220,1260,1350,1400,1240,1375,0.109,-135,1307.5,"Con",-40,-50,FALSE,TRUE,FALSE,9.82,"young",31,166,46,"f"
17,"ADDUCTOR",2,"Con09",1380,1360,1500,1450,1370,1475,0.077,-105,1422.5,"Con",20,50,FALSE,FALSE,FALSE,7.12,"young",31,166,46,"f"
17,"ADDUCTOR",2,"Con10",1140,1140,1600,1650,1140,1625,0.425,-485,1382.5,"Con",0,-50,FALSE,FALSE,FALSE,29.85,"young",31,166,46,"f"
17,"ADDUCTOR",1,"Ecc01",1460,1480,1750,1750,1470,1750,0.19,-280,1610,"Ecc",-20,0,FALSE,FALSE,FALSE,16,"young",31,166,46,"f"
17,"ADDUCTOR",1,"Ecc02",1720,1720,1950,1800,1720,1875,0.09,-155,1797.5,"Ecc",0,150,FALSE,FALSE,FALSE,8.27,"young",31,166,46,"f"
17,"ADDUCTOR",1,"Ecc03",1920,1900,1650,1550,1910,1600,0.162,310,1755,"Ecc",20,100,FALSE,FALSE,FALSE,19.38,"young",31,166,46,"f"
17,"ADDUCTOR",1,"Ecc04",1700,1720,1600,1500,1710,1550,0.094,160,1630,"Ecc",-20,100,FALSE,FALSE,FALSE,10.32,"young",31,166,46,"f"
17,"ADDUCTOR",1,"Ecc05",1720,1720,1550,1550,1720,1550,0.099,170,1635,"Ecc",0,0,FALSE,FALSE,FALSE,10.97,"young",31,166,46,"f"
17,"ADDUCTOR",1,"Ecc06",1620,1600,1550,1550,1610,1550,0.037,60,1580,"Ecc",20,0,FALSE,FALSE,FALSE,3.87,"young",31,166,46,"f"
17,"ADDUCTOR",1,"Ecc07",1580,1580,1500,1500,1580,1500,0.051,80,1540,"Ecc",0,0,FALSE,FALSE,FALSE,5.33,"young",31,166,46,"f"
17,"ADDUCTOR",1,"Ecc08",1420,1440,1350,1400,1430,1375,0.038,55,1402.5,"Ecc",-20,-50,FALSE,FALSE,FALSE,4,"young",31,166,46,"f"
17,"ADDUCTOR",1,"Ecc09",1580,1580,1450,1550,1580,1500,0.051,80,1540,"Ecc",0,-100,FALSE,FALSE,FALSE,5.33,"young",31,166,46,"f"
17,"ADDUCTOR",1,"Ecc10",2140,2140,2400,2350,2140,2375,0.11,-235,2257.5,"Ecc",0,50,FALSE,FALSE,FALSE,9.89,"young",31,166,46,"f"
17,"ADDUCTOR",2,"Ecc01",1520,1520,1800,1800,1520,1800,0.184,-280,1660,"Ecc",0,0,FALSE,FALSE,FALSE,15.56,"young",31,166,46,"f"
17,"ADDUCTOR",2,"Ecc02",1480,1460,1550,1550,1470,1550,0.054,-80,1510,"Ecc",20,0,FALSE,FALSE,FALSE,5.16,"young",31,166,46,"f"
17,"ADDUCTOR",2,"Ecc03",1780,1780,1700,1700,1780,1700,0.045,80,1740,"Ecc",0,0,FALSE,FALSE,FALSE,4.71,"young",31,166,46,"f"
17,"ADDUCTOR",2,"Ecc04",1640,1620,1650,1650,1630,1650,0.012,-20,1640,"Ecc",20,0,FALSE,FALSE,FALSE,1.21,"young",31,166,46,"f"
17,"ADDUCTOR",2,"Ecc05",1680,1680,1600,1650,1680,1625,0.033,55,1652.5,"Ecc",0,-50,FALSE,FALSE,FALSE,3.38,"young",31,166,46,"f"
17,"ADDUCTOR",2,"Ecc06",1440,1440,1450,1550,1440,1500,0.042,-60,1470,"Ecc",0,-100,FALSE,FALSE,FALSE,4,"young",31,166,46,"f"
17,"ADDUCTOR",2,"Ecc07",1560,1540,1450,1450,1550,1450,0.065,100,1500,"Ecc",20,0,FALSE,FALSE,FALSE,6.9,"young",31,166,46,"f"
17,"ADDUCTOR",2,"Ecc08",1620,1620,1450,1450,1620,1450,0.105,170,1535,"Ecc",0,0,FALSE,FALSE,FALSE,11.72,"young",31,166,46,"f"
17,"ADDUCTOR",2,"Ecc09",1540,1500,1450,1450,1520,1450,0.046,70,1485,"Ecc",40,0,FALSE,TRUE,FALSE,4.83,"young",31,166,46,"f"
17,"ADDUCTOR",2,"Ecc10",1900,1920,2100,2000,1910,2050,0.073,-140,1980,"Ecc",-20,100,FALSE,FALSE,FALSE,6.83,"young",31,166,46,"f"
17,"ADDUCTOR",1,"Rep01",2620,2640,3000,3450,2630,3225,0.226,-595,2927.5,"Rep",-20,-450,TRUE,FALSE,TRUE,18.45,"young",31,166,46,"f"
17,"ADDUCTOR",1,"Rep02",2780,2760,3200,3200,2770,3200,0.155,-430,2985,"Rep",20,0,TRUE,FALSE,FALSE,13.44,"young",31,166,46,"f"
17,"ADDUCTOR",1,"Rep03",3060,3060,2950,2950,3060,2950,0.036,110,3005,"Rep",0,0,FALSE,FALSE,FALSE,3.73,"young",31,166,46,"f"
17,"ADDUCTOR",1,"Rep04",3060,3080,2850,2850,3070,2850,0.072,220,2960,"Rep",-20,0,FALSE,FALSE,FALSE,7.72,"young",31,166,46,"f"
17,"ADDUCTOR",1,"Rep05",2780,2760,2900,2950,2770,2925,0.056,-155,2847.5,"Rep",20,-50,FALSE,FALSE,FALSE,5.3,"young",31,166,46,"f"
17,"ADDUCTOR",1,"Rep06",2780,2780,2900,2900,2780,2900,0.043,-120,2840,"Rep",0,0,FALSE,FALSE,FALSE,4.14,"young",31,166,46,"f"
17,"ADDUCTOR",1,"Rep07",2640,2640,2800,2800,2640,2800,0.061,-160,2720,"Rep",0,0,FALSE,FALSE,FALSE,5.71,"young",31,166,46,"f"
17,"ADDUCTOR",1,"Rep08",2580,2600,2650,2700,2590,2675,0.033,-85,2632.5,"Rep",-20,-50,FALSE,FALSE,FALSE,3.18,"young",31,166,46,"f"
17,"ADDUCTOR",1,"Rep09",2600,2580,2700,2700,2590,2700,0.042,-110,2645,"Rep",20,0,FALSE,FALSE,FALSE,4.07,"young",31,166,46,"f"
17,"ADDUCTOR",1,"Rep10",3260,3260,3750,3600,3260,3675,0.127,-415,3467.5,"Rep",0,150,TRUE,FALSE,FALSE,11.29,"young",31,166,46,"f"
17,"ADDUCTOR",2,"Rep01",3900,3900,3250,3350,3900,3300,0.154,600,3600,"Rep",0,-100,TRUE,FALSE,FALSE,18.18,"young",31,166,46,"f"
17,"ADDUCTOR",2,"Rep02",2620,2620,2850,2800,2620,2825,0.078,-205,2722.5,"Rep",0,50,FALSE,FALSE,FALSE,7.26,"young",31,166,46,"f"
17,"ADDUCTOR",2,"Rep03",2880,2880,3250,3250,2880,3250,0.128,-370,3065,"Rep",0,0,FALSE,FALSE,FALSE,11.38,"young",31,166,46,"f"
17,"ADDUCTOR",2,"Rep04",2960,2960,3000,3050,2960,3025,0.022,-65,2992.5,"Rep",0,-50,FALSE,FALSE,FALSE,2.15,"young",31,166,46,"f"
17,"ADDUCTOR",2,"Rep05",2960,2960,3050,3050,2960,3050,0.03,-90,3005,"Rep",0,0,FALSE,FALSE,FALSE,2.95,"young",31,166,46,"f"
17,"ADDUCTOR",2,"Rep06",3020,3020,2850,2900,3020,2875,0.048,145,2947.5,"Rep",0,-50,FALSE,FALSE,FALSE,5.04,"young",31,166,46,"f"
17,"ADDUCTOR",2,"Rep07",2700,2680,2950,2850,2690,2900,0.078,-210,2795,"Rep",20,100,FALSE,FALSE,FALSE,7.24,"young",31,166,46,"f"
17,"ADDUCTOR",2,"Rep08",2840,2880,2800,2850,2860,2825,0.012,35,2842.5,"Rep",-40,-50,FALSE,FALSE,FALSE,1.24,"young",31,166,46,"f"
17,"ADDUCTOR",2,"Rep09",2920,2860,2950,2900,2890,2925,0.012,-35,2907.5,"Rep",60,50,FALSE,FALSE,FALSE,1.2,"young",31,166,46,"f"
17,"ADDUCTOR",2,"Rep10",3040,3060,3700,3650,3050,3675,0.205,-625,3362.5,"Rep",-20,50,TRUE,FALSE,FALSE,17.01,"young",31,166,46,"f"
17,"ADDUCTOR",1,"TuT",28160,28160,29700,30100,28160,29900,0.062,-1740,29030,"TuT",0,-400,TRUE,FALSE,FALSE,5.82,"young",31,166,46,"f"
17,"ADDUCTOR",2,"TuT",29840,29820,30650,30650,29830,30650,0.027,-820,30240,"TuT",20,0,FALSE,FALSE,FALSE,2.68,"young",31,166,46,"f"
17,"LOWER BACK",1,"Con01",1900,1920,2050,2150,1910,2100,0.099,-190,2005,"Con",-20,-100,TRUE,FALSE,FALSE,9.05,"young",31,166,46,"f"
17,"LOWER BACK",1,"Con02",1620,1620,1600,1600,1620,1600,0.012,20,1610,"Con",0,0,FALSE,FALSE,FALSE,1.25,"young",31,166,46,"f"
17,"LOWER BACK",1,"Con03",1840,1880,1800,1850,1860,1825,0.019,35,1842.5,"Con",-40,-50,FALSE,TRUE,FALSE,1.92,"young",31,166,46,"f"
17,"LOWER BACK",1,"Con04",1680,1700,1600,1650,1690,1625,0.038,65,1657.5,"Con",-20,-50,FALSE,FALSE,FALSE,4,"young",31,166,46,"f"
17,"LOWER BACK",1,"Con05",1620,1660,1600,1600,1640,1600,0.024,40,1620,"Con",-40,0,FALSE,TRUE,FALSE,2.5,"young",31,166,46,"f"
17,"LOWER BACK",1,"Con06",1640,1640,1700,1650,1640,1675,0.021,-35,1657.5,"Con",0,50,FALSE,FALSE,FALSE,2.09,"young",31,166,46,"f"
17,"LOWER BACK",1,"Con07",1540,1580,1700,1650,1560,1675,0.074,-115,1617.5,"Con",-40,50,FALSE,TRUE,FALSE,6.87,"young",31,166,46,"f"
17,"LOWER BACK",1,"Con08",1640,1640,1700,1700,1640,1700,0.037,-60,1670,"Con",0,0,FALSE,FALSE,FALSE,3.53,"young",31,166,46,"f"
17,"LOWER BACK",1,"Con09",1620,1640,1800,1750,1630,1775,0.089,-145,1702.5,"Con",-20,50,FALSE,FALSE,FALSE,8.17,"young",31,166,46,"f"
17,"LOWER BACK",1,"Con10",1540,1560,1800,1750,1550,1775,0.145,-225,1662.5,"Con",-20,50,TRUE,FALSE,FALSE,12.68,"young",31,166,46,"f"
17,"LOWER BACK",2,"Con01",1780,1800,1850,1750,1790,1800,0.006,-10,1795,"Con",-20,100,FALSE,FALSE,FALSE,0.56,"young",31,166,46,"f"
17,"LOWER BACK",2,"Con02",1700,1740,1700,1650,1720,1675,0.026,45,1697.5,"Con",-40,50,FALSE,TRUE,FALSE,2.69,"young",31,166,46,"f"
17,"LOWER BACK",2,"Con03",1720,1760,1650,1650,1740,1650,0.052,90,1695,"Con",-40,0,FALSE,TRUE,FALSE,5.45,"young",31,166,46,"f"
17,"LOWER BACK",2,"Con04",1740,1720,1800,1800,1730,1800,0.04,-70,1765,"Con",20,0,FALSE,FALSE,FALSE,3.89,"young",31,166,46,"f"
17,"LOWER BACK",2,"Con05",1780,1760,1850,1800,1770,1825,0.031,-55,1797.5,"Con",20,50,FALSE,FALSE,FALSE,3.01,"young",31,166,46,"f"
17,"LOWER BACK",2,"Con06",1760,1760,1800,1800,1760,1800,0.023,-40,1780,"Con",0,0,FALSE,FALSE,FALSE,2.22,"young",31,166,46,"f"
17,"LOWER BACK",2,"Con07",1680,1660,1700,1800,1670,1750,0.048,-80,1710,"Con",20,-100,FALSE,FALSE,FALSE,4.57,"young",31,166,46,"f"
17,"LOWER BACK",2,"Con08",1540,1540,1700,1700,1540,1700,0.104,-160,1620,"Con",0,0,FALSE,FALSE,FALSE,9.41,"young",31,166,46,"f"
17,"LOWER BACK",2,"Con09",1800,1780,1850,1900,1790,1875,0.047,-85,1832.5,"Con",20,-50,FALSE,FALSE,FALSE,4.53,"young",31,166,46,"f"
17,"LOWER BACK",2,"Con10",1680,1660,1750,1750,1670,1750,0.048,-80,1710,"Con",20,0,FALSE,FALSE,FALSE,4.57,"young",31,166,46,"f"
17,"LOWER BACK",1,"Ecc01",2460,2460,2450,2550,2460,2500,0.016,-40,2480,"Ecc",0,-100,FALSE,FALSE,FALSE,1.6,"young",31,166,46,"f"
17,"LOWER BACK",1,"Ecc02",2260,2240,2300,2250,2250,2275,0.011,-25,2262.5,"Ecc",20,50,FALSE,FALSE,FALSE,1.1,"young",31,166,46,"f"
17,"LOWER BACK",1,"Ecc03",1920,1880,1950,1900,1900,1925,0.013,-25,1912.5,"Ecc",40,50,FALSE,FALSE,FALSE,1.3,"young",31,166,46,"f"
17,"LOWER BACK",1,"Ecc04",2000,1980,2050,2050,1990,2050,0.03,-60,2020,"Ecc",20,0,FALSE,FALSE,FALSE,2.93,"young",31,166,46,"f"
17,"LOWER BACK",1,"Ecc05",1840,1820,1850,1850,1830,1850,0.011,-20,1840,"Ecc",20,0,FALSE,FALSE,FALSE,1.08,"young",31,166,46,"f"
17,"LOWER BACK",1,"Ecc06",2100,2060,1950,2000,2080,1975,0.05,105,2027.5,"Ecc",40,-50,FALSE,FALSE,FALSE,5.32,"young",31,166,46,"f"
17,"LOWER BACK",1,"Ecc07",1820,1820,1750,1800,1820,1775,0.025,45,1797.5,"Ecc",0,-50,FALSE,FALSE,FALSE,2.54,"young",31,166,46,"f"
17,"LOWER BACK",1,"Ecc08",1840,1820,1700,1700,1830,1700,0.071,130,1765,"Ecc",20,0,FALSE,FALSE,FALSE,7.65,"young",31,166,46,"f"
17,"LOWER BACK",1,"Ecc09",1720,1700,1450,1500,1710,1475,0.137,235,1592.5,"Ecc",20,-50,TRUE,FALSE,FALSE,15.93,"young",31,166,46,"f"
17,"LOWER BACK",1,"Ecc10",2220,2220,2250,2200,2220,2225,0.002,-5,2222.5,"Ecc",0,50,FALSE,FALSE,FALSE,0.22,"young",31,166,46,"f"
17,"LOWER BACK",2,"Ecc01",1780,1760,1800,1750,1770,1775,0.003,-5,1772.5,"Ecc",20,50,FALSE,FALSE,FALSE,0.28,"young",31,166,46,"f"
17,"LOWER BACK",2,"Ecc02",2100,2080,2150,2200,2090,2175,0.041,-85,2132.5,"Ecc",20,-50,FALSE,FALSE,FALSE,3.91,"young",31,166,46,"f"
17,"LOWER BACK",2,"Ecc03",2120,2100,2150,2150,2110,2150,0.019,-40,2130,"Ecc",20,0,FALSE,FALSE,FALSE,1.86,"young",31,166,46,"f"
17,"LOWER BACK",2,"Ecc04",2300,2300,2200,2250,2300,2225,0.033,75,2262.5,"Ecc",0,-50,FALSE,FALSE,FALSE,3.37,"young",31,166,46,"f"
17,"LOWER BACK",2,"Ecc05",1940,1980,1900,1900,1960,1900,0.031,60,1930,"Ecc",-40,0,FALSE,FALSE,FALSE,3.16,"young",31,166,46,"f"
17,"LOWER BACK",2,"Ecc06",1780,1780,1750,1700,1780,1725,0.031,55,1752.5,"Ecc",0,50,FALSE,FALSE,FALSE,3.19,"young",31,166,46,"f"
17,"LOWER BACK",2,"Ecc07",1860,1880,1750,1700,1870,1725,0.078,145,1797.5,"Ecc",-20,50,FALSE,FALSE,FALSE,8.41,"young",31,166,46,"f"
17,"LOWER BACK",2,"Ecc08",1860,1860,1750,1700,1860,1725,0.073,135,1792.5,"Ecc",0,50,FALSE,FALSE,FALSE,7.83,"young",31,166,46,"f"
17,"LOWER BACK",2,"Ecc09",1880,1900,1850,1850,1890,1850,0.021,40,1870,"Ecc",-20,0,FALSE,FALSE,FALSE,2.16,"young",31,166,46,"f"
17,"LOWER BACK",2,"Ecc10",2640,2620,2650,2650,2630,2650,0.008,-20,2640,"Ecc",20,0,FALSE,FALSE,FALSE,0.75,"young",31,166,46,"f"
17,"LOWER BACK",1,"Rep01",4360,4380,4500,4700,4370,4600,0.053,-230,4485,"Rep",-20,-200,TRUE,FALSE,TRUE,5,"young",31,166,46,"f"
17,"LOWER BACK",1,"Rep02",3880,3860,3900,3850,3870,3875,0.001,-5,3872.5,"Rep",20,50,FALSE,FALSE,FALSE,0.13,"young",31,166,46,"f"
17,"LOWER BACK",1,"Rep03",3760,3760,3750,3750,3760,3750,0.003,10,3755,"Rep",0,0,FALSE,FALSE,FALSE,0.27,"young",31,166,46,"f"
17,"LOWER BACK",1,"Rep04",3680,3680,3650,3700,3680,3675,0.001,5,3677.5,"Rep",0,-50,FALSE,FALSE,FALSE,0.14,"young",31,166,46,"f"
17,"LOWER BACK",1,"Rep05",3460,3480,3450,3450,3470,3450,0.006,20,3460,"Rep",-20,0,FALSE,FALSE,FALSE,0.58,"young",31,166,46,"f"
17,"LOWER BACK",1,"Rep06",3740,3700,3650,3650,3720,3650,0.019,70,3685,"Rep",40,0,FALSE,FALSE,FALSE,1.92,"young",31,166,46,"f"
17,"LOWER BACK",1,"Rep07",3360,3400,3450,3450,3380,3450,0.021,-70,3415,"Rep",-40,0,FALSE,FALSE,FALSE,2.03,"young",31,166,46,"f"
17,"LOWER BACK",1,"Rep08",3480,3460,3400,3400,3470,3400,0.02,70,3435,"Rep",20,0,FALSE,FALSE,FALSE,2.06,"young",31,166,46,"f"
17,"LOWER BACK",1,"Rep09",3340,3340,3250,3250,3340,3250,0.027,90,3295,"Rep",0,0,FALSE,FALSE,FALSE,2.77,"young",31,166,46,"f"
17,"LOWER BACK",1,"Rep10",3760,3780,4050,3950,3770,4000,0.061,-230,3885,"Rep",-20,100,TRUE,FALSE,FALSE,5.75,"young",31,166,46,"f"
17,"LOWER BACK",2,"Rep01",3560,3560,3650,3500,3560,3575,0.004,-15,3567.5,"Rep",0,150,FALSE,FALSE,FALSE,0.42,"young",31,166,46,"f"
17,"LOWER BACK",2,"Rep02",3800,3820,3850,3850,3810,3850,0.01,-40,3830,"Rep",-20,0,FALSE,FALSE,FALSE,1.04,"young",31,166,46,"f"
17,"LOWER BACK",2,"Rep03",3840,3860,3800,3800,3850,3800,0.013,50,3825,"Rep",-20,0,FALSE,FALSE,FALSE,1.32,"young",31,166,46,"f"
17,"LOWER BACK",2,"Rep04",4040,4020,4000,4050,4030,4025,0.001,5,4027.5,"Rep",20,-50,FALSE,FALSE,FALSE,0.12,"young",31,166,46,"f"
17,"LOWER BACK",2,"Rep05",3720,3740,3750,3700,3730,3725,0.001,5,3727.5,"Rep",-20,50,FALSE,FALSE,FALSE,0.13,"young",31,166,46,"f"
17,"LOWER BACK",2,"Rep06",3540,3540,3550,3500,3540,3525,0.004,15,3532.5,"Rep",0,50,FALSE,FALSE,FALSE,0.43,"young",31,166,46,"f"
17,"LOWER BACK",2,"Rep07",3540,3540,3450,3500,3540,3475,0.018,65,3507.5,"Rep",0,-50,FALSE,FALSE,FALSE,1.87,"young",31,166,46,"f"
17,"LOWER BACK",2,"Rep08",3400,3400,3450,3400,3400,3425,0.007,-25,3412.5,"Rep",0,50,FALSE,FALSE,FALSE,0.73,"young",31,166,46,"f"
17,"LOWER BACK",2,"Rep09",3680,3680,3700,3750,3680,3725,0.012,-45,3702.5,"Rep",0,-50,FALSE,FALSE,FALSE,1.21,"young",31,166,46,"f"
17,"LOWER BACK",2,"Rep10",4320,4280,4400,4400,4300,4400,0.023,-100,4350,"Rep",40,0,TRUE,FALSE,FALSE,2.27,"young",31,166,46,"f"
17,"LOWER BACK",1,"TuT",36820,36840,37050,37150,36830,37100,0.007,-270,36965,"TuT",-20,-100,TRUE,FALSE,FALSE,0.73,"young",31,166,46,"f"
17,"LOWER BACK",2,"TuT",37440,37440,37600,37450,37440,37525,0.002,-85,37482.5,"TuT",0,150,FALSE,FALSE,FALSE,0.23,"young",31,166,46,"f"
17,"TOTAL ABDOMINAL",1,"Con01",2380,2400,2450,2350,2390,2400,0.004,-10,2395,"Con",-20,100,FALSE,FALSE,FALSE,0.42,"young",31,166,46,"f"
17,"TOTAL ABDOMINAL",1,"Con02",1960,1960,1900,2000,1960,1950,0.005,10,1955,"Con",0,-100,FALSE,FALSE,FALSE,0.51,"young",31,166,46,"f"
17,"TOTAL ABDOMINAL",1,"Con03",1900,1900,1900,1900,1900,1900,0,0,1900,"Con",0,0,FALSE,FALSE,FALSE,0,"young",31,166,46,"f"
17,"TOTAL ABDOMINAL",1,"Con04",1840,1840,1800,1800,1840,1800,0.022,40,1820,"Con",0,0,FALSE,FALSE,FALSE,2.22,"young",31,166,46,"f"
17,"TOTAL ABDOMINAL",1,"Con05",1780,1800,1800,1800,1790,1800,0.006,-10,1795,"Con",-20,0,FALSE,FALSE,FALSE,0.56,"young",31,166,46,"f"
17,"TOTAL ABDOMINAL",1,"Con06",1860,1880,1900,1850,1870,1875,0.003,-5,1872.5,"Con",-20,50,FALSE,FALSE,FALSE,0.27,"young",31,166,46,"f"
17,"TOTAL ABDOMINAL",1,"Con07",1720,1720,1800,1850,1720,1825,0.061,-105,1772.5,"Con",0,-50,FALSE,FALSE,FALSE,5.75,"young",31,166,46,"f"
17,"TOTAL ABDOMINAL",1,"Con08",1740,1740,1800,1800,1740,1800,0.034,-60,1770,"Con",0,0,FALSE,FALSE,FALSE,3.33,"young",31,166,46,"f"
17,"TOTAL ABDOMINAL",1,"Con09",1720,1700,1850,1850,1710,1850,0.082,-140,1780,"Con",20,0,FALSE,FALSE,FALSE,7.57,"young",31,166,46,"f"
17,"TOTAL ABDOMINAL",1,"Con10",1840,1860,2050,2100,1850,2075,0.122,-225,1962.5,"Con",-20,-50,TRUE,FALSE,FALSE,10.84,"young",31,166,46,"f"
17,"TOTAL ABDOMINAL",2,"Con01",1820,1840,1900,1900,1830,1900,0.038,-70,1865,"Con",-20,0,FALSE,FALSE,FALSE,3.68,"young",31,166,46,"f"
17,"TOTAL ABDOMINAL",2,"Con02",1740,1760,1800,1700,1750,1750,0,0,1750,"Con",-20,100,FALSE,FALSE,FALSE,0,"young",31,166,46,"f"
17,"TOTAL ABDOMINAL",2,"Con03",1940,1940,1950,1900,1940,1925,0.008,15,1932.5,"Con",0,50,FALSE,FALSE,FALSE,0.78,"young",31,166,46,"f"
17,"TOTAL ABDOMINAL",2,"Con04",1760,1780,1800,1750,1770,1775,0.003,-5,1772.5,"Con",-20,50,FALSE,FALSE,FALSE,0.28,"young",31,166,46,"f"
17,"TOTAL ABDOMINAL",2,"Con05",1700,1720,1700,1700,1710,1700,0.006,10,1705,"Con",-20,0,FALSE,FALSE,FALSE,0.59,"young",31,166,46,"f"
17,"TOTAL ABDOMINAL",2,"Con06",1720,1740,1750,1800,1730,1775,0.026,-45,1752.5,"Con",-20,-50,FALSE,FALSE,FALSE,2.54,"young",31,166,46,"f"
17,"TOTAL ABDOMINAL",2,"Con07",1520,1560,1650,1650,1540,1650,0.071,-110,1595,"Con",-40,0,FALSE,TRUE,FALSE,6.67,"young",31,166,46,"f"
17,"TOTAL ABDOMINAL",2,"Con08",1720,1700,1750,1750,1710,1750,0.023,-40,1730,"Con",20,0,FALSE,FALSE,FALSE,2.29,"young",31,166,46,"f"
17,"TOTAL ABDOMINAL",2,"Con09",1680,1680,1700,1750,1680,1725,0.027,-45,1702.5,"Con",0,-50,FALSE,FALSE,FALSE,2.61,"young",31,166,46,"f"
17,"TOTAL ABDOMINAL",2,"Con10",1640,1620,1750,1750,1630,1750,0.074,-120,1690,"Con",20,0,FALSE,FALSE,FALSE,6.86,"young",31,166,46,"f"
17,"TOTAL ABDOMINAL",1,"Ecc01",2160,2160,2250,2150,2160,2200,0.019,-40,2180,"Ecc",0,100,FALSE,FALSE,FALSE,1.82,"young",31,166,46,"f"
17,"TOTAL ABDOMINAL",1,"Ecc02",2080,2080,2200,2100,2080,2150,0.034,-70,2115,"Ecc",0,100,FALSE,FALSE,FALSE,3.26,"young",31,166,46,"f"
17,"TOTAL ABDOMINAL",1,"Ecc03",2160,2160,2150,2150,2160,2150,0.005,10,2155,"Ecc",0,0,FALSE,FALSE,FALSE,0.47,"young",31,166,46,"f"
17,"TOTAL ABDOMINAL",1,"Ecc04",2100,2100,2100,2150,2100,2125,0.012,-25,2112.5,"Ecc",0,-50,FALSE,FALSE,FALSE,1.18,"young",31,166,46,"f"
17,"TOTAL ABDOMINAL",1,"Ecc05",2180,2160,2150,2150,2170,2150,0.009,20,2160,"Ecc",20,0,FALSE,FALSE,FALSE,0.93,"young",31,166,46,"f"
17,"TOTAL ABDOMINAL",1,"Ecc06",2240,2200,2150,2150,2220,2150,0.032,70,2185,"Ecc",40,0,FALSE,TRUE,FALSE,3.26,"young",31,166,46,"f"
17,"TOTAL ABDOMINAL",1,"Ecc07",2000,2020,1950,1950,2010,1950,0.03,60,1980,"Ecc",-20,0,FALSE,FALSE,FALSE,3.08,"young",31,166,46,"f"
17,"TOTAL ABDOMINAL",1,"Ecc08",1960,1980,1850,1850,1970,1850,0.061,120,1910,"Ecc",-20,0,FALSE,FALSE,FALSE,6.49,"young",31,166,46,"f"
17,"TOTAL ABDOMINAL",1,"Ecc09",1940,1940,1800,1750,1940,1775,0.085,165,1857.5,"Ecc",0,50,TRUE,FALSE,FALSE,9.3,"young",31,166,46,"f"
17,"TOTAL ABDOMINAL",1,"Ecc10",2340,2300,2300,2250,2320,2275,0.019,45,2297.5,"Ecc",40,50,FALSE,TRUE,FALSE,1.98,"young",31,166,46,"f"
17,"TOTAL ABDOMINAL",2,"Ecc01",2000,1980,1950,2050,1990,2000,0.005,-10,1995,"Ecc",20,-100,FALSE,FALSE,FALSE,0.5,"young",31,166,46,"f"
17,"TOTAL ABDOMINAL",2,"Ecc02",1960,1960,1950,2000,1960,1975,0.008,-15,1967.5,"Ecc",0,-50,FALSE,FALSE,FALSE,0.76,"young",31,166,46,"f"
17,"TOTAL ABDOMINAL",2,"Ecc03",2240,2240,2150,2200,2240,2175,0.029,65,2207.5,"Ecc",0,-50,FALSE,FALSE,FALSE,2.99,"young",31,166,46,"f"
17,"TOTAL ABDOMINAL",2,"Ecc04",2100,2060,2100,2150,2080,2125,0.022,-45,2102.5,"Ecc",40,-50,FALSE,TRUE,FALSE,2.12,"young",31,166,46,"f"
17,"TOTAL ABDOMINAL",2,"Ecc05",2000,1980,2000,1950,1990,1975,0.008,15,1982.5,"Ecc",20,50,FALSE,FALSE,FALSE,0.76,"young",31,166,46,"f"
17,"TOTAL ABDOMINAL",2,"Ecc06",2260,2240,2150,2150,2250,2150,0.044,100,2200,"Ecc",20,0,FALSE,FALSE,FALSE,4.65,"young",31,166,46,"f"
17,"TOTAL ABDOMINAL",2,"Ecc07",2060,2060,2000,2000,2060,2000,0.029,60,2030,"Ecc",0,0,FALSE,FALSE,FALSE,3,"young",31,166,46,"f"
17,"TOTAL ABDOMINAL",2,"Ecc08",1980,1960,1950,1900,1970,1925,0.023,45,1947.5,"Ecc",20,50,FALSE,FALSE,FALSE,2.34,"young",31,166,46,"f"
17,"TOTAL ABDOMINAL",2,"Ecc09",1800,1820,1750,1750,1810,1750,0.033,60,1780,"Ecc",-20,0,FALSE,FALSE,FALSE,3.43,"young",31,166,46,"f"
17,"TOTAL ABDOMINAL",2,"Ecc10",2000,2020,2000,1950,2010,1975,0.017,35,1992.5,"Ecc",-20,50,FALSE,FALSE,FALSE,1.77,"young",31,166,46,"f"
17,"TOTAL ABDOMINAL",1,"Rep01",4540,4560,4700,4500,4550,4600,0.011,-50,4575,"Rep",-20,200,FALSE,FALSE,TRUE,1.09,"young",31,166,46,"f"
17,"TOTAL ABDOMINAL",1,"Rep02",4040,4040,4100,4100,4040,4100,0.015,-60,4070,"Rep",0,0,FALSE,FALSE,FALSE,1.46,"young",31,166,46,"f"
17,"TOTAL ABDOMINAL",1,"Rep03",4060,4060,4050,4050,4060,4050,0.002,10,4055,"Rep",0,0,FALSE,FALSE,FALSE,0.25,"young",31,166,46,"f"
17,"TOTAL ABDOMINAL",1,"Rep04",3940,3940,3900,3950,3940,3925,0.004,15,3932.5,"Rep",0,-50,FALSE,FALSE,FALSE,0.38,"young",31,166,46,"f"
17,"TOTAL ABDOMINAL",1,"Rep05",3960,3960,3950,3950,3960,3950,0.003,10,3955,"Rep",0,0,FALSE,FALSE,FALSE,0.25,"young",31,166,46,"f"
17,"TOTAL ABDOMINAL",1,"Rep06",4100,4080,4050,4000,4090,4025,0.016,65,4057.5,"Rep",20,50,FALSE,FALSE,FALSE,1.61,"young",31,166,46,"f"
17,"TOTAL ABDOMINAL",1,"Rep07",3720,3740,3750,3800,3730,3775,0.012,-45,3752.5,"Rep",-20,-50,FALSE,FALSE,FALSE,1.19,"young",31,166,46,"f"
17,"TOTAL ABDOMINAL",1,"Rep08",3700,3720,3650,3650,3710,3650,0.016,60,3680,"Rep",-20,0,FALSE,FALSE,FALSE,1.64,"young",31,166,46,"f"
17,"TOTAL ABDOMINAL",1,"Rep09",3660,3640,3650,3600,3650,3625,0.007,25,3637.5,"Rep",20,50,FALSE,FALSE,FALSE,0.69,"young",31,166,46,"f"
17,"TOTAL ABDOMINAL",1,"Rep10",4180,4160,4350,4350,4170,4350,0.043,-180,4260,"Rep",20,0,TRUE,FALSE,FALSE,4.14,"young",31,166,46,"f"
17,"TOTAL ABDOMINAL",2,"Rep01",3820,3820,3850,3950,3820,3900,0.021,-80,3860,"Rep",0,-100,FALSE,FALSE,FALSE,2.05,"young",31,166,46,"f"
17,"TOTAL ABDOMINAL",2,"Rep02",3700,3720,3750,3700,3710,3725,0.004,-15,3717.5,"Rep",-20,50,FALSE,FALSE,FALSE,0.4,"young",31,166,46,"f"
17,"TOTAL ABDOMINAL",2,"Rep03",4180,4180,4100,4100,4180,4100,0.019,80,4140,"Rep",0,0,FALSE,FALSE,FALSE,1.95,"young",31,166,46,"f"
17,"TOTAL ABDOMINAL",2,"Rep04",3860,3840,3900,3900,3850,3900,0.013,-50,3875,"Rep",20,0,FALSE,FALSE,FALSE,1.28,"young",31,166,46,"f"
17,"TOTAL ABDOMINAL",2,"Rep05",3700,3700,3700,3650,3700,3675,0.007,25,3687.5,"Rep",0,50,FALSE,FALSE,FALSE,0.68,"young",31,166,46,"f"
17,"TOTAL ABDOMINAL",2,"Rep06",3980,3980,3900,3950,3980,3925,0.014,55,3952.5,"Rep",0,-50,FALSE,FALSE,FALSE,1.4,"young",31,166,46,"f"
17,"TOTAL ABDOMINAL",2,"Rep07",3580,3620,3650,3650,3600,3650,0.014,-50,3625,"Rep",-40,0,FALSE,FALSE,FALSE,1.37,"young",31,166,46,"f"
17,"TOTAL ABDOMINAL",2,"Rep08",3700,3660,3700,3650,3680,3675,0.001,5,3677.5,"Rep",40,50,FALSE,FALSE,FALSE,0.14,"young",31,166,46,"f"
17,"TOTAL ABDOMINAL",2,"Rep09",3480,3500,3450,3500,3490,3475,0.004,15,3482.5,"Rep",-20,-50,FALSE,FALSE,FALSE,0.43,"young",31,166,46,"f"
17,"TOTAL ABDOMINAL",2,"Rep10",3640,3640,3750,3700,3640,3725,0.023,-85,3682.5,"Rep",0,50,FALSE,FALSE,FALSE,2.28,"young",31,166,46,"f"
17,"TOTAL ABDOMINAL",1,"TuT",39900,39900,40150,39950,39900,40050,0.004,-150,39975,"TuT",0,200,FALSE,FALSE,FALSE,0.37,"young",31,166,46,"f"
17,"TOTAL ABDOMINAL",2,"TuT",37640,37660,37750,37750,37650,37750,0.003,-100,37700,"TuT",-20,0,FALSE,FALSE,FALSE,0.26,"young",31,166,46,"f"
17,"VERTICAL TRACTION",1,"Con01",2560,2620,2400,1400,2590,1900,0.266,690,2245,"Con",-60,1000,TRUE,FALSE,TRUE,36.32,"young",31,166,46,"f"
17,"VERTICAL TRACTION",1,"Con02",1460,1480,1450,1350,1470,1400,0.048,70,1435,"Con",-20,100,FALSE,FALSE,FALSE,5,"young",31,166,46,"f"
17,"VERTICAL TRACTION",1,"Con03",1400,1400,1350,1300,1400,1325,0.054,75,1362.5,"Con",0,50,FALSE,FALSE,FALSE,5.66,"young",31,166,46,"f"
17,"VERTICAL TRACTION",1,"Con04",1300,1300,1300,1400,1300,1350,0.038,-50,1325,"Con",0,-100,FALSE,FALSE,FALSE,3.7,"young",31,166,46,"f"
17,"VERTICAL TRACTION",1,"Con05",1360,1380,1350,1550,1370,1450,0.058,-80,1410,"Con",-20,-200,FALSE,FALSE,TRUE,5.52,"young",31,166,46,"f"
17,"VERTICAL TRACTION",1,"Con06",1460,1480,1500,1400,1470,1450,0.014,20,1460,"Con",-20,100,FALSE,FALSE,FALSE,1.38,"young",31,166,46,"f"
17,"VERTICAL TRACTION",1,"Con07",1360,1380,1400,1600,1370,1500,0.095,-130,1435,"Con",-20,-200,FALSE,FALSE,TRUE,8.67,"young",31,166,46,"f"
17,"VERTICAL TRACTION",1,"Con08",1520,1540,1550,1600,1530,1575,0.029,-45,1552.5,"Con",-20,-50,FALSE,FALSE,FALSE,2.86,"young",31,166,46,"f"
17,"VERTICAL TRACTION",1,"Con09",1480,1480,1600,1500,1480,1550,0.047,-70,1515,"Con",0,100,FALSE,FALSE,FALSE,4.52,"young",31,166,46,"f"
17,"VERTICAL TRACTION",1,"Con10",1360,1380,1500,0,1370,750,0.453,620,1060,"Con",-20,1500,TRUE,FALSE,TRUE,82.67,"young",31,166,46,"f"
17,"VERTICAL TRACTION",2,"Con01",2100,2080,1900,1850,2090,1875,0.103,215,1982.5,"Con",20,50,FALSE,FALSE,FALSE,11.47,"young",31,166,46,"f"
17,"VERTICAL TRACTION",2,"Con02",1560,1580,1550,1550,1570,1550,0.013,20,1560,"Con",-20,0,FALSE,FALSE,FALSE,1.29,"young",31,166,46,"f"
17,"VERTICAL TRACTION",2,"Con03",1340,1340,1350,1350,1340,1350,0.007,-10,1345,"Con",0,0,FALSE,FALSE,FALSE,0.74,"young",31,166,46,"f"
17,"VERTICAL TRACTION",2,"Con04",1460,1480,1500,1500,1470,1500,0.02,-30,1485,"Con",-20,0,FALSE,FALSE,FALSE,2,"young",31,166,46,"f"
17,"VERTICAL TRACTION",2,"Con05",1520,1540,1550,1550,1530,1550,0.013,-20,1540,"Con",-20,0,FALSE,FALSE,FALSE,1.29,"young",31,166,46,"f"
17,"VERTICAL TRACTION",2,"Con06",1400,1420,1450,1450,1410,1450,0.028,-40,1430,"Con",-20,0,FALSE,FALSE,FALSE,2.76,"young",31,166,46,"f"
17,"VERTICAL TRACTION",2,"Con07",1480,1480,1500,1500,1480,1500,0.014,-20,1490,"Con",0,0,FALSE,FALSE,FALSE,1.33,"young",31,166,46,"f"
17,"VERTICAL TRACTION",2,"Con08",1460,1440,1500,1450,1450,1475,0.017,-25,1462.5,"Con",20,50,FALSE,FALSE,FALSE,1.69,"young",31,166,46,"f"
17,"VERTICAL TRACTION",2,"Con09",1400,1380,1400,1400,1390,1400,0.007,-10,1395,"Con",20,0,FALSE,FALSE,FALSE,0.71,"young",31,166,46,"f"
17,"VERTICAL TRACTION",2,"Con10",1560,1540,1550,1600,1550,1575,0.016,-25,1562.5,"Con",20,-50,FALSE,FALSE,FALSE,1.59,"young",31,166,46,"f"
17,"VERTICAL TRACTION",1,"Ecc01",1580,1560,1600,1750,1570,1675,0.067,-105,1622.5,"Ecc",20,-150,FALSE,FALSE,FALSE,6.27,"young",31,166,46,"f"
17,"VERTICAL TRACTION",1,"Ecc02",1680,1680,1750,1850,1680,1800,0.071,-120,1740,"Ecc",0,-100,FALSE,FALSE,FALSE,6.67,"young",31,166,46,"f"
17,"VERTICAL TRACTION",1,"Ecc03",1860,1860,1850,1750,1860,1800,0.032,60,1830,"Ecc",0,100,FALSE,FALSE,FALSE,3.33,"young",31,166,46,"f"
17,"VERTICAL TRACTION",1,"Ecc04",1780,1780,1800,1800,1780,1800,0.011,-20,1790,"Ecc",0,0,FALSE,FALSE,FALSE,1.11,"young",31,166,46,"f"
17,"VERTICAL TRACTION",1,"Ecc05",1860,1820,1850,1750,1840,1800,0.022,40,1820,"Ecc",40,100,FALSE,FALSE,FALSE,2.22,"young",31,166,46,"f"
17,"VERTICAL TRACTION",1,"Ecc06",1800,1780,1750,1500,1790,1625,0.092,165,1707.5,"Ecc",20,250,FALSE,FALSE,TRUE,10.15,"young",31,166,46,"f"
17,"VERTICAL TRACTION",1,"Ecc07",1560,1540,1550,1700,1550,1625,0.048,-75,1587.5,"Ecc",20,-150,FALSE,FALSE,FALSE,4.62,"young",31,166,46,"f"
17,"VERTICAL TRACTION",1,"Ecc08",1820,1820,1700,1750,1820,1725,0.052,95,1772.5,"Ecc",0,-50,FALSE,FALSE,FALSE,5.51,"young",31,166,46,"f"
17,"VERTICAL TRACTION",1,"Ecc09",1880,1860,1750,2650,1870,2200,0.176,-330,2035,"Ecc",20,-900,TRUE,FALSE,TRUE,15,"young",31,166,46,"f"
17,"VERTICAL TRACTION",1,"Ecc10",3140,3140,2800,0,3140,1400,0.554,1740,2270,"Ecc",0,2800,TRUE,FALSE,TRUE,124.29,"young",31,166,46,"f"
17,"VERTICAL TRACTION",2,"Ecc01",1500,1480,1500,1500,1490,1500,0.007,-10,1495,"Ecc",20,0,FALSE,FALSE,FALSE,0.67,"young",31,166,46,"f"
17,"VERTICAL TRACTION",2,"Ecc02",1580,1580,1600,1600,1580,1600,0.013,-20,1590,"Ecc",0,0,FALSE,FALSE,FALSE,1.25,"young",31,166,46,"f"
17,"VERTICAL TRACTION",2,"Ecc03",1800,1780,1750,1750,1790,1750,0.022,40,1770,"Ecc",20,0,FALSE,FALSE,FALSE,2.29,"young",31,166,46,"f"
17,"VERTICAL TRACTION",2,"Ecc04",1900,1900,1850,1850,1900,1850,0.026,50,1875,"Ecc",0,0,FALSE,FALSE,FALSE,2.7,"young",31,166,46,"f"
17,"VERTICAL TRACTION",2,"Ecc05",1640,1600,1600,1600,1620,1600,0.012,20,1610,"Ecc",40,0,FALSE,FALSE,FALSE,1.25,"young",31,166,46,"f"
17,"VERTICAL TRACTION",2,"Ecc06",1840,1840,1850,1850,1840,1850,0.005,-10,1845,"Ecc",0,0,FALSE,FALSE,FALSE,0.54,"young",31,166,46,"f"
17,"VERTICAL TRACTION",2,"Ecc07",1900,1920,1850,1900,1910,1875,0.018,35,1892.5,"Ecc",-20,-50,FALSE,FALSE,FALSE,1.87,"young",31,166,46,"f"
17,"VERTICAL TRACTION",2,"Ecc08",1700,1720,1700,1700,1710,1700,0.006,10,1705,"Ecc",-20,0,FALSE,FALSE,FALSE,0.59,"young",31,166,46,"f"
17,"VERTICAL TRACTION",2,"Ecc09",1880,1880,1850,1850,1880,1850,0.016,30,1865,"Ecc",0,0,FALSE,FALSE,FALSE,1.62,"young",31,166,46,"f"
17,"VERTICAL TRACTION",2,"Ecc10",3200,3220,3300,3250,3210,3275,0.02,-65,3242.5,"Ecc",-20,50,FALSE,FALSE,FALSE,1.98,"young",31,166,46,"f"
17,"VERTICAL TRACTION",1,"Rep01",4140,4180,4000,3150,4160,3575,0.141,585,3867.5,"Rep",-40,850,TRUE,FALSE,TRUE,16.36,"young",31,166,46,"f"
17,"VERTICAL TRACTION",1,"Rep02",3140,3160,3200,3200,3150,3200,0.016,-50,3175,"Rep",-20,0,FALSE,FALSE,FALSE,1.56,"young",31,166,46,"f"
17,"VERTICAL TRACTION",1,"Rep03",3260,3260,3200,3050,3260,3125,0.041,135,3192.5,"Rep",0,150,FALSE,FALSE,FALSE,4.32,"young",31,166,46,"f"
17,"VERTICAL TRACTION",1,"Rep04",3080,3080,3100,3200,3080,3150,0.023,-70,3115,"Rep",0,-100,FALSE,FALSE,FALSE,2.22,"young",31,166,46,"f"
17,"VERTICAL TRACTION",1,"Rep05",3220,3200,3200,3300,3210,3250,0.012,-40,3230,"Rep",20,-100,FALSE,FALSE,FALSE,1.23,"young",31,166,46,"f"
17,"VERTICAL TRACTION",1,"Rep06",3260,3260,3250,2900,3260,3075,0.057,185,3167.5,"Rep",0,350,TRUE,FALSE,TRUE,6.02,"young",31,166,46,"f"
17,"VERTICAL TRACTION",1,"Rep07",2920,2920,2950,3300,2920,3125,0.07,-205,3022.5,"Rep",0,-350,TRUE,FALSE,TRUE,6.56,"young",31,166,46,"f"
17,"VERTICAL TRACTION",1,"Rep08",3340,3360,3250,3350,3350,3300,0.015,50,3325,"Rep",-20,-100,FALSE,FALSE,FALSE,1.52,"young",31,166,46,"f"
17,"VERTICAL TRACTION",1,"Rep09",3360,3340,3350,4150,3350,3750,0.119,-400,3550,"Rep",20,-800,TRUE,FALSE,TRUE,10.67,"young",31,166,46,"f"
17,"VERTICAL TRACTION",1,"Rep10",4500,4520,4300,0,4510,2150,0.523,2360,3330,"Rep",-20,4300,TRUE,FALSE,TRUE,109.77,"young",31,166,46,"f"
17,"VERTICAL TRACTION",2,"Rep01",3600,3560,3400,3350,3580,3375,0.057,205,3477.5,"Rep",40,50,TRUE,FALSE,FALSE,6.07,"young",31,166,46,"f"
17,"VERTICAL TRACTION",2,"Rep02",3140,3160,3150,3150,3150,3150,0,0,3150,"Rep",-20,0,FALSE,FALSE,FALSE,0,"young",31,166,46,"f"
17,"VERTICAL TRACTION",2,"Rep03",3140,3120,3100,3100,3130,3100,0.01,30,3115,"Rep",20,0,FALSE,FALSE,FALSE,0.97,"young",31,166,46,"f"
17,"VERTICAL TRACTION",2,"Rep04",3360,3380,3350,3350,3370,3350,0.006,20,3360,"Rep",-20,0,FALSE,FALSE,FALSE,0.6,"young",31,166,46,"f"
17,"VERTICAL TRACTION",2,"Rep05",3160,3140,3150,3150,3150,3150,0,0,3150,"Rep",20,0,FALSE,FALSE,FALSE,0,"young",31,166,46,"f"
17,"VERTICAL TRACTION",2,"Rep06",3240,3260,3300,3300,3250,3300,0.015,-50,3275,"Rep",-20,0,FALSE,FALSE,FALSE,1.52,"young",31,166,46,"f"
17,"VERTICAL TRACTION",2,"Rep07",3380,3400,3350,3400,3390,3375,0.004,15,3382.5,"Rep",-20,-50,FALSE,FALSE,FALSE,0.44,"young",31,166,46,"f"
17,"VERTICAL TRACTION",2,"Rep08",3160,3160,3200,3150,3160,3175,0.005,-15,3167.5,"Rep",0,50,FALSE,FALSE,FALSE,0.47,"young",31,166,46,"f"
17,"VERTICAL TRACTION",2,"Rep09",3280,3260,3250,3250,3270,3250,0.006,20,3260,"Rep",20,0,FALSE,FALSE,FALSE,0.62,"young",31,166,46,"f"
17,"VERTICAL TRACTION",2,"Rep10",4760,4760,4850,4850,4760,4850,0.019,-90,4805,"Rep",0,0,FALSE,FALSE,FALSE,1.86,"young",31,166,46,"f"
17,"VERTICAL TRACTION",1,"TuT",34220,34280,33800,29600,34250,31700,0.074,2550,32975,"TuT",-60,4200,TRUE,FALSE,TRUE,8.04,"young",31,166,46,"f"
17,"VERTICAL TRACTION",2,"TuT",34220,34200,34100,34050,34210,34075,0.004,135,34142.5,"TuT",20,50,FALSE,FALSE,FALSE,0.4,"young",31,166,46,"f"
17,"CHEST PRESS",1,"Con01",1800,1820,1800,1800,1810,1800,0.006,10,1805,"Con",-20,0,FALSE,FALSE,FALSE,0.56,"young",31,166,46,"f"
17,"CHEST PRESS",1,"Con02",1300,1340,1400,1350,1320,1375,0.042,-55,1347.5,"Con",-40,50,FALSE,TRUE,FALSE,4,"young",31,166,46,"f"
17,"CHEST PRESS",1,"Con03",1340,1320,1400,1400,1330,1400,0.053,-70,1365,"Con",20,0,FALSE,FALSE,FALSE,5,"young",31,166,46,"f"
17,"CHEST PRESS",1,"Con04",1240,1260,1350,1350,1250,1350,0.08,-100,1300,"Con",-20,0,FALSE,FALSE,FALSE,7.41,"young",31,166,46,"f"
17,"CHEST PRESS",1,"Con05",1240,1240,1350,1400,1240,1375,0.109,-135,1307.5,"Con",0,-50,FALSE,FALSE,FALSE,9.82,"young",31,166,46,"f"
17,"CHEST PRESS",1,"Con06",1320,1320,1450,1450,1320,1450,0.098,-130,1385,"Con",0,0,FALSE,FALSE,FALSE,8.97,"young",31,166,46,"f"
17,"CHEST PRESS",1,"Con07",1280,1280,1400,1400,1280,1400,0.094,-120,1340,"Con",0,0,FALSE,FALSE,FALSE,8.57,"young",31,166,46,"f"
17,"CHEST PRESS",1,"Con08",1260,1260,1300,1300,1260,1300,0.032,-40,1280,"Con",0,0,FALSE,FALSE,FALSE,3.08,"young",31,166,46,"f"
17,"CHEST PRESS",1,"Con09",1200,1220,1250,1250,1210,1250,0.033,-40,1230,"Con",-20,0,FALSE,FALSE,FALSE,3.2,"young",31,166,46,"f"
17,"CHEST PRESS",1,"Con10",1220,1220,1350,1350,1220,1350,0.107,-130,1285,"Con",0,0,FALSE,FALSE,FALSE,9.63,"young",31,166,46,"f"
17,"CHEST PRESS",2,"Con01",1440,1460,1400,1400,1450,1400,0.034,50,1425,"Con",-20,0,FALSE,FALSE,FALSE,3.57,"young",31,166,46,"f"
17,"CHEST PRESS",2,"Con02",1220,1240,1300,1350,1230,1325,0.077,-95,1277.5,"Con",-20,-50,FALSE,FALSE,FALSE,7.17,"young",31,166,46,"f"
17,"CHEST PRESS",2,"Con03",1220,1240,1350,1250,1230,1300,0.057,-70,1265,"Con",-20,100,FALSE,FALSE,FALSE,5.38,"young",31,166,46,"f"
17,"CHEST PRESS",2,"Con04",1260,1260,1400,1350,1260,1375,0.091,-115,1317.5,"Con",0,50,FALSE,FALSE,FALSE,8.36,"young",31,166,46,"f"
17,"CHEST PRESS",2,"Con05",1260,1260,1400,1350,1260,1375,0.091,-115,1317.5,"Con",0,50,FALSE,FALSE,FALSE,8.36,"young",31,166,46,"f"
17,"CHEST PRESS",2,"Con06",1340,1360,1500,1450,1350,1475,0.093,-125,1412.5,"Con",-20,50,FALSE,FALSE,FALSE,8.47,"young",31,166,46,"f"
17,"CHEST PRESS",2,"Con07",1360,1380,1400,1450,1370,1425,0.04,-55,1397.5,"Con",-20,-50,FALSE,FALSE,FALSE,3.86,"young",31,166,46,"f"
17,"CHEST PRESS",2,"Con08",1400,1420,1450,1500,1410,1475,0.046,-65,1442.5,"Con",-20,-50,FALSE,FALSE,FALSE,4.41,"young",31,166,46,"f"
17,"CHEST PRESS",2,"Con09",1180,1200,1250,1300,1190,1275,0.071,-85,1232.5,"Con",-20,-50,FALSE,FALSE,FALSE,6.67,"young",31,166,46,"f"
17,"CHEST PRESS",2,"Con10",1420,1400,1500,1600,1410,1550,0.099,-140,1480,"Con",20,-100,FALSE,FALSE,FALSE,9.03,"young",31,166,46,"f"
17,"CHEST PRESS",1,"Ecc01",1940,1900,1850,1850,1920,1850,0.036,70,1885,"Ecc",40,0,FALSE,TRUE,FALSE,3.78,"young",31,166,46,"f"
17,"CHEST PRESS",1,"Ecc02",1900,1900,1800,1850,1900,1825,0.039,75,1862.5,"Ecc",0,-50,FALSE,FALSE,FALSE,4.11,"young",31,166,46,"f"
17,"CHEST PRESS",1,"Ecc03",2100,2080,2000,2000,2090,2000,0.043,90,2045,"Ecc",20,0,FALSE,FALSE,FALSE,4.5,"young",31,166,46,"f"
17,"CHEST PRESS",1,"Ecc04",2140,2140,2050,2000,2140,2025,0.054,115,2082.5,"Ecc",0,50,FALSE,FALSE,FALSE,5.68,"young",31,166,46,"f"
17,"CHEST PRESS",1,"Ecc05",1840,1840,1700,1700,1840,1700,0.076,140,1770,"Ecc",0,0,FALSE,FALSE,FALSE,8.24,"young",31,166,46,"f"
17,"CHEST PRESS",1,"Ecc06",1800,1800,1700,1700,1800,1700,0.056,100,1750,"Ecc",0,0,FALSE,FALSE,FALSE,5.88,"young",31,166,46,"f"
17,"CHEST PRESS",1,"Ecc07",1720,1720,1650,1650,1720,1650,0.041,70,1685,"Ecc",0,0,FALSE,FALSE,FALSE,4.24,"young",31,166,46,"f"
17,"CHEST PRESS",1,"Ecc08",2060,2040,2000,2000,2050,2000,0.024,50,2025,"Ecc",20,0,FALSE,FALSE,FALSE,2.5,"young",31,166,46,"f"
17,"CHEST PRESS",1,"Ecc09",1600,1580,1500,1500,1590,1500,0.057,90,1545,"Ecc",20,0,FALSE,FALSE,FALSE,6,"young",31,166,46,"f"
17,"CHEST PRESS",1,"Ecc10",2480,2500,2550,3150,2490,2850,0.145,-360,2670,"Ecc",-20,-600,TRUE,FALSE,TRUE,12.63,"young",31,166,46,"f"
17,"CHEST PRESS",2,"Ecc01",1960,1940,1900,1850,1950,1875,0.038,75,1912.5,"Ecc",20,50,FALSE,FALSE,FALSE,4,"young",31,166,46,"f"
17,"CHEST PRESS",2,"Ecc02",1800,1780,1700,1750,1790,1725,0.036,65,1757.5,"Ecc",20,-50,FALSE,FALSE,FALSE,3.77,"young",31,166,46,"f"
17,"CHEST PRESS",2,"Ecc03",1640,1620,1500,1600,1630,1550,0.049,80,1590,"Ecc",20,-100,FALSE,FALSE,FALSE,5.16,"young",31,166,46,"f"
17,"CHEST PRESS",2,"Ecc04",2060,2080,1950,1950,2070,1950,0.058,120,2010,"Ecc",-20,0,FALSE,FALSE,FALSE,6.15,"young",31,166,46,"f"
17,"CHEST PRESS",2,"Ecc05",1980,1960,1800,1900,1970,1850,0.061,120,1910,"Ecc",20,-100,FALSE,FALSE,FALSE,6.49,"young",31,166,46,"f"
17,"CHEST PRESS",2,"Ecc06",1900,1880,1800,1750,1890,1775,0.061,115,1832.5,"Ecc",20,50,FALSE,FALSE,FALSE,6.48,"young",31,166,46,"f"
17,"CHEST PRESS",2,"Ecc07",1560,1540,1550,1500,1550,1525,0.016,25,1537.5,"Ecc",20,50,FALSE,FALSE,FALSE,1.64,"young",31,166,46,"f"
17,"CHEST PRESS",2,"Ecc08",1440,1440,1400,1350,1440,1375,0.045,65,1407.5,"Ecc",0,50,FALSE,FALSE,FALSE,4.73,"young",31,166,46,"f"
17,"CHEST PRESS",2,"Ecc09",1780,1760,1650,1550,1770,1600,0.096,170,1685,"Ecc",20,100,FALSE,FALSE,FALSE,10.62,"young",31,166,46,"f"
17,"CHEST PRESS",2,"Ecc10",2300,2320,2300,2300,2310,2300,0.004,10,2305,"Ecc",-20,0,FALSE,FALSE,FALSE,0.43,"young",31,166,46,"f"
17,"CHEST PRESS",1,"Rep01",3740,3720,3650,3650,3730,3650,0.021,80,3690,"Rep",20,0,FALSE,FALSE,FALSE,2.19,"young",31,166,46,"f"
17,"CHEST PRESS",1,"Rep02",3200,3240,3200,3200,3220,3200,0.006,20,3210,"Rep",-40,0,FALSE,FALSE,FALSE,0.62,"young",31,166,46,"f"
17,"CHEST PRESS",1,"Rep03",3440,3400,3400,3400,3420,3400,0.006,20,3410,"Rep",40,0,FALSE,FALSE,FALSE,0.59,"young",31,166,46,"f"
17,"CHEST PRESS",1,"Rep04",3380,3400,3400,3350,3390,3375,0.004,15,3382.5,"Rep",-20,50,FALSE,FALSE,FALSE,0.44,"young",31,166,46,"f"
17,"CHEST PRESS",1,"Rep05",3080,3080,3050,3100,3080,3075,0.002,5,3077.5,"Rep",0,-50,FALSE,FALSE,FALSE,0.16,"young",31,166,46,"f"
17,"CHEST PRESS",1,"Rep06",3120,3120,3150,3150,3120,3150,0.01,-30,3135,"Rep",0,0,FALSE,FALSE,FALSE,0.95,"young",31,166,46,"f"
17,"CHEST PRESS",1,"Rep07",3000,3000,3050,3050,3000,3050,0.017,-50,3025,"Rep",0,0,FALSE,FALSE,FALSE,1.64,"young",31,166,46,"f"
17,"CHEST PRESS",1,"Rep08",3320,3300,3300,3300,3310,3300,0.003,10,3305,"Rep",20,0,FALSE,FALSE,FALSE,0.3,"young",31,166,46,"f"
17,"CHEST PRESS",1,"Rep09",2800,2800,2750,2750,2800,2750,0.018,50,2775,"Rep",0,0,FALSE,FALSE,FALSE,1.82,"young",31,166,46,"f"
17,"CHEST PRESS",1,"Rep10",3700,3720,3900,4500,3710,4200,0.132,-490,3955,"Rep",-20,-600,TRUE,FALSE,TRUE,11.67,"young",31,166,46,"f"
17,"CHEST PRESS",2,"Rep01",3400,3400,3300,3250,3400,3275,0.037,125,3337.5,"Rep",0,50,FALSE,FALSE,FALSE,3.82,"young",31,166,46,"f"
17,"CHEST PRESS",2,"Rep02",3020,3020,3000,3100,3020,3050,0.01,-30,3035,"Rep",0,-100,FALSE,FALSE,FALSE,0.98,"young",31,166,46,"f"
17,"CHEST PRESS",2,"Rep03",2860,2860,2850,2850,2860,2850,0.003,10,2855,"Rep",0,0,FALSE,FALSE,FALSE,0.35,"young",31,166,46,"f"
17,"CHEST PRESS",2,"Rep04",3320,3340,3350,3300,3330,3325,0.002,5,3327.5,"Rep",-20,50,FALSE,FALSE,FALSE,0.15,"young",31,166,46,"f"
17,"CHEST PRESS",2,"Rep05",3240,3220,3200,3250,3230,3225,0.002,5,3227.5,"Rep",20,-50,FALSE,FALSE,FALSE,0.16,"young",31,166,46,"f"
17,"CHEST PRESS",2,"Rep06",3240,3240,3300,3200,3240,3250,0.003,-10,3245,"Rep",0,100,FALSE,FALSE,FALSE,0.31,"young",31,166,46,"f"
17,"CHEST PRESS",2,"Rep07",2920,2920,2950,2950,2920,2950,0.01,-30,2935,"Rep",0,0,FALSE,FALSE,FALSE,1.02,"young",31,166,46,"f"
17,"CHEST PRESS",2,"Rep08",2840,2860,2850,2850,2850,2850,0,0,2850,"Rep",-20,0,FALSE,FALSE,FALSE,0,"young",31,166,46,"f"
17,"CHEST PRESS",2,"Rep09",2960,2960,2900,2850,2960,2875,0.029,85,2917.5,"Rep",0,50,FALSE,FALSE,FALSE,2.96,"young",31,166,46,"f"
17,"CHEST PRESS",2,"Rep10",3720,3720,3800,3900,3720,3850,0.035,-130,3785,"Rep",0,-100,FALSE,FALSE,FALSE,3.38,"young",31,166,46,"f"
17,"CHEST PRESS",1,"TuT",32780,32780,32850,33450,32780,33150,0.011,-370,32965,"TuT",0,-600,FALSE,FALSE,FALSE,1.12,"young",31,166,46,"f"
17,"CHEST PRESS",2,"TuT",31520,31540,31500,31500,31530,31500,0.001,30,31515,"TuT",-20,0,FALSE,FALSE,FALSE,0.1,"young",31,166,46,"f"
18,"LEG PRESS",1,"Con01",1320,1280,1500,1450,1300,1475,0.135,-175,1387.5,"Con",40,50,FALSE,FALSE,FALSE,11.86,"young",34,161,56,"f"
18,"LEG PRESS",1,"Con02",1020,1060,1150,1150,1040,1150,0.106,-110,1095,"Con",-40,0,FALSE,FALSE,FALSE,9.57,"young",34,161,56,"f"
18,"LEG PRESS",1,"Con03",1320,1340,1300,1350,1330,1325,0.004,5,1327.5,"Con",-20,-50,FALSE,FALSE,FALSE,0.38,"young",34,161,56,"f"
18,"LEG PRESS",1,"Con04",1120,1100,1250,1250,1110,1250,0.126,-140,1180,"Con",20,0,FALSE,FALSE,FALSE,11.2,"young",34,161,56,"f"
18,"LEG PRESS",1,"Con05",1100,1080,1150,1200,1090,1175,0.078,-85,1132.5,"Con",20,-50,FALSE,FALSE,FALSE,7.23,"young",34,161,56,"f"
18,"LEG PRESS",1,"Con06",1100,1100,1200,1250,1100,1225,0.114,-125,1162.5,"Con",0,-50,FALSE,FALSE,FALSE,10.2,"young",34,161,56,"f"
18,"LEG PRESS",1,"Con07",1080,1080,1150,1150,1080,1150,0.065,-70,1115,"Con",0,0,FALSE,FALSE,FALSE,6.09,"young",34,161,56,"f"
18,"LEG PRESS",1,"Con08",1060,1060,1200,1150,1060,1175,0.108,-115,1117.5,"Con",0,50,FALSE,FALSE,FALSE,9.79,"young",34,161,56,"f"
18,"LEG PRESS",1,"Con09",1060,1100,1350,1300,1080,1325,0.227,-245,1202.5,"Con",-40,50,FALSE,FALSE,FALSE,18.49,"young",34,161,56,"f"
18,"LEG PRESS",1,"Con10",1080,1080,1350,1350,1080,1350,0.25,-270,1215,"Con",0,0,FALSE,FALSE,FALSE,20,"young",34,161,56,"f"
18,"LEG PRESS",2,"Con01",1100,1080,1450,1250,1090,1350,0.239,-260,1220,"Con",20,200,FALSE,FALSE,TRUE,19.26,"young",34,161,56,"f"
18,"LEG PRESS",2,"Con02",980,980,1050,1050,980,1050,0.071,-70,1015,"Con",0,0,FALSE,FALSE,FALSE,6.67,"young",34,161,56,"f"
18,"LEG PRESS",2,"Con03",1060,1060,1050,1100,1060,1075,0.014,-15,1067.5,"Con",0,-50,FALSE,FALSE,FALSE,1.4,"young",34,161,56,"f"
18,"LEG PRESS",2,"Con04",1120,1080,1050,1100,1100,1075,0.023,25,1087.5,"Con",40,-50,FALSE,FALSE,FALSE,2.33,"young",34,161,56,"f"
18,"LEG PRESS",2,"Con05",1020,1040,1050,1000,1030,1025,0.005,5,1027.5,"Con",-20,50,FALSE,FALSE,FALSE,0.49,"young",34,161,56,"f"
18,"LEG PRESS",2,"Con06",1000,980,1050,1050,990,1050,0.061,-60,1020,"Con",20,0,FALSE,FALSE,FALSE,5.71,"young",34,161,56,"f"
18,"LEG PRESS",2,"Con07",1040,1060,1150,1100,1050,1125,0.071,-75,1087.5,"Con",-20,50,FALSE,FALSE,FALSE,6.67,"young",34,161,56,"f"
18,"LEG PRESS",2,"Con08",1000,960,1100,1100,980,1100,0.122,-120,1040,"Con",40,0,FALSE,FALSE,FALSE,10.91,"young",34,161,56,"f"
18,"LEG PRESS",2,"Con09",960,940,1100,1100,950,1100,0.158,-150,1025,"Con",20,0,FALSE,FALSE,FALSE,13.64,"young",34,161,56,"f"
18,"LEG PRESS",2,"Con10",1060,1040,1250,1250,1050,1250,0.19,-200,1150,"Con",20,0,FALSE,FALSE,FALSE,16,"young",34,161,56,"f"
18,"LEG PRESS",1,"Ecc01",2080,2100,1950,1950,2090,1950,0.067,140,2020,"Ecc",-20,0,FALSE,FALSE,FALSE,7.18,"young",34,161,56,"f"
18,"LEG PRESS",1,"Ecc02",1780,1740,1700,1700,1760,1700,0.034,60,1730,"Ecc",40,0,FALSE,FALSE,FALSE,3.53,"young",34,161,56,"f"
18,"LEG PRESS",1,"Ecc03",1580,1580,1550,1550,1580,1550,0.019,30,1565,"Ecc",0,0,FALSE,FALSE,FALSE,1.94,"young",34,161,56,"f"
18,"LEG PRESS",1,"Ecc04",1820,1840,1700,1650,1830,1675,0.085,155,1752.5,"Ecc",-20,50,FALSE,FALSE,FALSE,9.25,"young",34,161,56,"f"
18,"LEG PRESS",1,"Ecc05",1680,1700,1650,1600,1690,1625,0.038,65,1657.5,"Ecc",-20,50,FALSE,FALSE,FALSE,4,"young",34,161,56,"f"
18,"LEG PRESS",1,"Ecc06",1800,1780,1700,1650,1790,1675,0.064,115,1732.5,"Ecc",20,50,FALSE,FALSE,FALSE,6.87,"young",34,161,56,"f"
18,"LEG PRESS",1,"Ecc07",1760,1740,1650,1700,1750,1675,0.043,75,1712.5,"Ecc",20,-50,FALSE,FALSE,FALSE,4.48,"young",34,161,56,"f"
18,"LEG PRESS",1,"Ecc08",1780,1780,1600,1650,1780,1625,0.087,155,1702.5,"Ecc",0,-50,FALSE,FALSE,FALSE,9.54,"young",34,161,56,"f"
18,"LEG PRESS",1,"Ecc09",1880,1860,1600,1600,1870,1600,0.144,270,1735,"Ecc",20,0,FALSE,FALSE,FALSE,16.88,"young",34,161,56,"f"
18,"LEG PRESS",1,"Ecc10",2100,2100,1950,2000,2100,1975,0.06,125,2037.5,"Ecc",0,-50,FALSE,FALSE,FALSE,6.33,"young",34,161,56,"f"
18,"LEG PRESS",2,"Ecc01",1680,1680,1550,1600,1680,1575,0.062,105,1627.5,"Ecc",0,-50,FALSE,FALSE,FALSE,6.67,"young",34,161,56,"f"
18,"LEG PRESS",2,"Ecc02",1500,1480,1450,1450,1490,1450,0.027,40,1470,"Ecc",20,0,FALSE,FALSE,FALSE,2.76,"young",34,161,56,"f"
18,"LEG PRESS",2,"Ecc03",1500,1540,1550,1500,1520,1525,0.003,-5,1522.5,"Ecc",-40,50,FALSE,FALSE,FALSE,0.33,"young",34,161,56,"f"
18,"LEG PRESS",2,"Ecc04",1480,1500,1500,1500,1490,1500,0.007,-10,1495,"Ecc",-20,0,FALSE,FALSE,FALSE,0.67,"young",34,161,56,"f"
18,"LEG PRESS",2,"Ecc05",1580,1580,1550,1550,1580,1550,0.019,30,1565,"Ecc",0,0,FALSE,FALSE,FALSE,1.94,"young",34,161,56,"f"
18,"LEG PRESS",2,"Ecc06",1580,1580,1500,1550,1580,1525,0.035,55,1552.5,"Ecc",0,-50,FALSE,FALSE,FALSE,3.61,"young",34,161,56,"f"
18,"LEG PRESS",2,"Ecc07",1540,1540,1400,1450,1540,1425,0.075,115,1482.5,"Ecc",0,-50,FALSE,FALSE,FALSE,8.07,"young",34,161,56,"f"
18,"LEG PRESS",2,"Ecc08",1500,1540,1400,1350,1520,1375,0.095,145,1447.5,"Ecc",-40,50,FALSE,FALSE,FALSE,10.55,"young",34,161,56,"f"
18,"LEG PRESS",2,"Ecc09",1560,1580,1400,1400,1570,1400,0.108,170,1485,"Ecc",-20,0,FALSE,FALSE,FALSE,12.14,"young",34,161,56,"f"
18,"LEG PRESS",2,"Ecc10",1620,1620,2400,1600,1620,2000,0.235,-380,1810,"Ecc",0,800,TRUE,FALSE,TRUE,19,"young",34,161,56,"f"
18,"LEG PRESS",1,"Rep01",3400,3380,3450,3400,3390,3425,0.01,-35,3407.5,"Rep",20,50,FALSE,FALSE,FALSE,1.02,"young",34,161,56,"f"
18,"LEG PRESS",1,"Rep02",2800,2800,2850,2850,2800,2850,0.018,-50,2825,"Rep",0,0,FALSE,FALSE,FALSE,1.75,"young",34,161,56,"f"
18,"LEG PRESS",1,"Rep03",2900,2920,2850,2900,2910,2875,0.012,35,2892.5,"Rep",-20,-50,FALSE,FALSE,FALSE,1.22,"young",34,161,56,"f"
18,"LEG PRESS",1,"Rep04",2940,2940,2950,2900,2940,2925,0.005,15,2932.5,"Rep",0,50,FALSE,FALSE,FALSE,0.51,"young",34,161,56,"f"
18,"LEG PRESS",1,"Rep05",2780,2780,2800,2800,2780,2800,0.007,-20,2790,"Rep",0,0,FALSE,FALSE,FALSE,0.71,"young",34,161,56,"f"
18,"LEG PRESS",1,"Rep06",2900,2880,2900,2900,2890,2900,0.003,-10,2895,"Rep",20,0,FALSE,FALSE,FALSE,0.34,"young",34,161,56,"f"
18,"LEG PRESS",1,"Rep07",2840,2820,2800,2850,2830,2825,0.002,5,2827.5,"Rep",20,-50,FALSE,FALSE,FALSE,0.18,"young",34,161,56,"f"
18,"LEG PRESS",1,"Rep08",2840,2840,2800,2800,2840,2800,0.014,40,2820,"Rep",0,0,FALSE,FALSE,FALSE,1.43,"young",34,161,56,"f"
18,"LEG PRESS",1,"Rep09",2940,2960,2950,2900,2950,2925,0.008,25,2937.5,"Rep",-20,50,FALSE,FALSE,FALSE,0.85,"young",34,161,56,"f"
18,"LEG PRESS",1,"Rep10",3180,3180,3300,3350,3180,3325,0.046,-145,3252.5,"Rep",0,-50,TRUE,FALSE,FALSE,4.36,"young",34,161,56,"f"
18,"LEG PRESS",2,"Rep01",2780,2760,3000,2850,2770,2925,0.056,-155,2847.5,"Rep",20,150,TRUE,FALSE,TRUE,5.3,"young",34,161,56,"f"
18,"LEG PRESS",2,"Rep02",2480,2460,2500,2500,2470,2500,0.012,-30,2485,"Rep",20,0,FALSE,FALSE,FALSE,1.2,"young",34,161,56,"f"
18,"LEG PRESS",2,"Rep03",2560,2600,2600,2600,2580,2600,0.008,-20,2590,"Rep",-40,0,FALSE,FALSE,FALSE,0.77,"young",34,161,56,"f"
18,"LEG PRESS",2,"Rep04",2600,2580,2550,2600,2590,2575,0.006,15,2582.5,"Rep",20,-50,FALSE,FALSE,FALSE,0.58,"young",34,161,56,"f"
18,"LEG PRESS",2,"Rep05",2600,2620,2600,2550,2610,2575,0.013,35,2592.5,"Rep",-20,50,FALSE,FALSE,FALSE,1.36,"young",34,161,56,"f"
18,"LEG PRESS",2,"Rep06",2580,2560,2550,2600,2570,2575,0.002,-5,2572.5,"Rep",20,-50,FALSE,FALSE,FALSE,0.19,"young",34,161,56,"f"
18,"LEG PRESS",2,"Rep07",2580,2600,2550,2550,2590,2550,0.015,40,2570,"Rep",-20,0,FALSE,FALSE,FALSE,1.57,"young",34,161,56,"f"
18,"LEG PRESS",2,"Rep08",2500,2500,2500,2450,2500,2475,0.01,25,2487.5,"Rep",0,50,FALSE,FALSE,FALSE,1.01,"young",34,161,56,"f"
18,"LEG PRESS",2,"Rep09",2520,2520,2500,2500,2520,2500,0.008,20,2510,"Rep",0,0,FALSE,FALSE,FALSE,0.8,"young",34,161,56,"f"
18,"LEG PRESS",2,"Rep10",2680,2660,3650,2850,2670,3250,0.217,-580,2960,"Rep",20,800,TRUE,FALSE,TRUE,17.85,"young",34,161,56,"f"
18,"LEG PRESS",1,"TuT",29520,29500,29650,29650,29510,29650,0.005,-140,29580,"TuT",20,0,FALSE,FALSE,FALSE,0.47,"young",34,161,56,"f"
18,"LEG PRESS",2,"TuT",25880,25860,27000,26050,25870,26525,0.025,-655,26197.5,"TuT",20,950,TRUE,FALSE,TRUE,2.47,"young",34,161,56,"f"
18,"LEG EXTENSION",1,"Con01",1240,1260,1400,1250,1250,1325,0.06,-75,1287.5,"Con",-20,150,FALSE,FALSE,FALSE,5.66,"young",34,161,56,"f"
18,"LEG EXTENSION",1,"Con02",1160,1180,1200,1250,1170,1225,0.047,-55,1197.5,"Con",-20,-50,FALSE,FALSE,FALSE,4.49,"young",34,161,56,"f"
18,"LEG EXTENSION",1,"Con03",980,1000,1000,1050,990,1025,0.035,-35,1007.5,"Con",-20,-50,FALSE,FALSE,FALSE,3.41,"young",34,161,56,"f"
18,"LEG EXTENSION",1,"Con04",1020,1020,1050,1050,1020,1050,0.029,-30,1035,"Con",0,0,FALSE,FALSE,FALSE,2.86,"young",34,161,56,"f"
18,"LEG EXTENSION",1,"Con05",1060,1060,1100,1150,1060,1125,0.061,-65,1092.5,"Con",0,-50,FALSE,FALSE,FALSE,5.78,"young",34,161,56,"f"
18,"LEG EXTENSION",1,"Con06",960,960,1050,1000,960,1025,0.068,-65,992.5,"Con",0,50,FALSE,FALSE,FALSE,6.34,"young",34,161,56,"f"
18,"LEG EXTENSION",1,"Con07",980,980,1050,1000,980,1025,0.046,-45,1002.5,"Con",0,50,FALSE,FALSE,FALSE,4.39,"young",34,161,56,"f"
18,"LEG EXTENSION",1,"Con08",960,980,1100,1050,970,1075,0.108,-105,1022.5,"Con",-20,50,FALSE,FALSE,FALSE,9.77,"young",34,161,56,"f"
18,"LEG EXTENSION",1,"Con09",960,960,1050,1100,960,1075,0.12,-115,1017.5,"Con",0,-50,FALSE,FALSE,FALSE,10.7,"young",34,161,56,"f"
18,"LEG EXTENSION",1,"Con10",980,980,1100,1150,980,1125,0.148,-145,1052.5,"Con",0,-50,FALSE,FALSE,FALSE,12.89,"young",34,161,56,"f"
18,"LEG EXTENSION",2,"Con01",1040,1040,1150,1150,1040,1150,0.106,-110,1095,"Con",0,0,FALSE,FALSE,FALSE,9.57,"young",34,161,56,"f"
18,"LEG EXTENSION",2,"Con02",900,900,950,950,900,950,0.056,-50,925,"Con",0,0,FALSE,FALSE,FALSE,5.26,"young",34,161,56,"f"
18,"LEG EXTENSION",2,"Con03",940,940,1000,1000,940,1000,0.064,-60,970,"Con",0,0,FALSE,FALSE,FALSE,6,"young",34,161,56,"f"
18,"LEG EXTENSION",2,"Con04",940,960,1000,1000,950,1000,0.053,-50,975,"Con",-20,0,FALSE,FALSE,FALSE,5,"young",34,161,56,"f"
18,"LEG EXTENSION",2,"Con05",940,940,1050,1050,940,1050,0.117,-110,995,"Con",0,0,FALSE,FALSE,FALSE,10.48,"young",34,161,56,"f"
18,"LEG EXTENSION",2,"Con06",940,940,1000,1000,940,1000,0.064,-60,970,"Con",0,0,FALSE,FALSE,FALSE,6,"young",34,161,56,"f"
18,"LEG EXTENSION",2,"Con07",880,900,950,950,890,950,0.067,-60,920,"Con",-20,0,FALSE,FALSE,FALSE,6.32,"young",34,161,56,"f"
18,"LEG EXTENSION",2,"Con08",900,920,950,950,910,950,0.044,-40,930,"Con",-20,0,FALSE,FALSE,FALSE,4.21,"young",34,161,56,"f"
18,"LEG EXTENSION",2,"Con09",980,960,1100,1100,970,1100,0.134,-130,1035,"Con",20,0,FALSE,FALSE,FALSE,11.82,"young",34,161,56,"f"
18,"LEG EXTENSION",2,"Con10",1060,1060,1200,1200,1060,1200,0.132,-140,1130,"Con",0,0,FALSE,FALSE,FALSE,11.67,"young",34,161,56,"f"
18,"LEG EXTENSION",1,"Ecc01",2020,2000,1950,2000,2010,1975,0.017,35,1992.5,"Ecc",20,-50,FALSE,FALSE,FALSE,1.77,"young",34,161,56,"f"
18,"LEG EXTENSION",1,"Ecc02",2020,1980,2000,1950,2000,1975,0.012,25,1987.5,"Ecc",40,50,FALSE,TRUE,FALSE,1.27,"young",34,161,56,"f"
18,"LEG EXTENSION",1,"Ecc03",1860,1860,1850,1800,1860,1825,0.019,35,1842.5,"Ecc",0,50,FALSE,FALSE,FALSE,1.92,"young",34,161,56,"f"
18,"LEG EXTENSION",1,"Ecc04",1980,1960,1900,1900,1970,1900,0.036,70,1935,"Ecc",20,0,FALSE,FALSE,FALSE,3.68,"young",34,161,56,"f"
18,"LEG EXTENSION",1,"Ecc05",1900,1920,1850,1850,1910,1850,0.031,60,1880,"Ecc",-20,0,FALSE,FALSE,FALSE,3.24,"young",34,161,56,"f"
18,"LEG EXTENSION",1,"Ecc06",1760,1760,1700,1750,1760,1725,0.02,35,1742.5,"Ecc",0,-50,FALSE,FALSE,FALSE,2.03,"young",34,161,56,"f"
18,"LEG EXTENSION",1,"Ecc07",1660,1640,1550,1600,1650,1575,0.045,75,1612.5,"Ecc",20,-50,FALSE,FALSE,FALSE,4.76,"young",34,161,56,"f"
18,"LEG EXTENSION",1,"Ecc08",1720,1720,1600,1600,1720,1600,0.07,120,1660,"Ecc",0,0,FALSE,FALSE,FALSE,7.5,"young",34,161,56,"f"
18,"LEG EXTENSION",1,"Ecc09",1720,1720,1650,1600,1720,1625,0.055,95,1672.5,"Ecc",0,50,FALSE,FALSE,FALSE,5.85,"young",34,161,56,"f"
18,"LEG EXTENSION",1,"Ecc10",1780,1780,1750,1750,1780,1750,0.017,30,1765,"Ecc",0,0,FALSE,FALSE,FALSE,1.71,"young",34,161,56,"f"
18,"LEG EXTENSION",2,"Ecc01",1760,1760,1700,1700,1760,1700,0.034,60,1730,"Ecc",0,0,FALSE,FALSE,FALSE,3.53,"young",34,161,56,"f"
18,"LEG EXTENSION",2,"Ecc02",1800,1800,1750,1750,1800,1750,0.028,50,1775,"Ecc",0,0,FALSE,FALSE,FALSE,2.86,"young",34,161,56,"f"
18,"LEG EXTENSION",2,"Ecc03",1860,1860,1800,1800,1860,1800,0.032,60,1830,"Ecc",0,0,FALSE,FALSE,FALSE,3.33,"young",34,161,56,"f"
18,"LEG EXTENSION",2,"Ecc04",1780,1760,1700,1700,1770,1700,0.04,70,1735,"Ecc",20,0,FALSE,FALSE,FALSE,4.12,"young",34,161,56,"f"
18,"LEG EXTENSION",2,"Ecc05",1680,1680,1600,1600,1680,1600,0.048,80,1640,"Ecc",0,0,FALSE,FALSE,FALSE,5,"young",34,161,56,"f"
18,"LEG EXTENSION",2,"Ecc06",1620,1620,1550,1550,1620,1550,0.043,70,1585,"Ecc",0,0,FALSE,FALSE,FALSE,4.52,"young",34,161,56,"f"
18,"LEG EXTENSION",2,"Ecc07",1680,1660,1600,1600,1670,1600,0.042,70,1635,"Ecc",20,0,FALSE,FALSE,FALSE,4.38,"young",34,161,56,"f"
18,"LEG EXTENSION",2,"Ecc08",1540,1540,1450,1450,1540,1450,0.058,90,1495,"Ecc",0,0,FALSE,FALSE,FALSE,6.21,"young",34,161,56,"f"
18,"LEG EXTENSION",2,"Ecc09",1620,1620,1500,1500,1620,1500,0.074,120,1560,"Ecc",0,0,FALSE,FALSE,FALSE,8,"young",34,161,56,"f"
18,"LEG EXTENSION",2,"Ecc10",1540,1520,1500,1500,1530,1500,0.02,30,1515,"Ecc",20,0,FALSE,FALSE,FALSE,2,"young",34,161,56,"f"
18,"LEG EXTENSION",1,"Rep01",3260,3260,3350,3250,3260,3300,0.012,-40,3280,"Rep",0,100,FALSE,FALSE,FALSE,1.21,"young",34,161,56,"f"
18,"LEG EXTENSION",1,"Rep02",3180,3160,3200,3200,3170,3200,0.009,-30,3185,"Rep",20,0,FALSE,FALSE,FALSE,0.94,"young",34,161,56,"f"
18,"LEG EXTENSION",1,"Rep03",2840,2860,2850,2850,2850,2850,0,0,2850,"Rep",-20,0,FALSE,FALSE,FALSE,0,"young",34,161,56,"f"
18,"LEG EXTENSION",1,"Rep04",3000,2980,2950,2950,2990,2950,0.013,40,2970,"Rep",20,0,FALSE,FALSE,FALSE,1.36,"young",34,161,56,"f"
18,"LEG EXTENSION",1,"Rep05",2960,2980,2950,3000,2970,2975,0.002,-5,2972.5,"Rep",-20,-50,FALSE,FALSE,FALSE,0.17,"young",34,161,56,"f"
18,"LEG EXTENSION",1,"Rep06",2720,2720,2750,2750,2720,2750,0.011,-30,2735,"Rep",0,0,FALSE,FALSE,FALSE,1.09,"young",34,161,56,"f"
18,"LEG EXTENSION",1,"Rep07",2640,2620,2600,2600,2630,2600,0.011,30,2615,"Rep",20,0,FALSE,FALSE,FALSE,1.15,"young",34,161,56,"f"
18,"LEG EXTENSION",1,"Rep08",2680,2700,2700,2650,2690,2675,0.006,15,2682.5,"Rep",-20,50,FALSE,FALSE,FALSE,0.56,"young",34,161,56,"f"
18,"LEG EXTENSION",1,"Rep09",2680,2680,2700,2700,2680,2700,0.007,-20,2690,"Rep",0,0,FALSE,FALSE,FALSE,0.74,"young",34,161,56,"f"
18,"LEG EXTENSION",1,"Rep10",2760,2760,2850,2900,2760,2875,0.042,-115,2817.5,"Rep",0,-50,TRUE,FALSE,FALSE,4,"young",34,161,56,"f"
18,"LEG EXTENSION",2,"Rep01",2800,2800,2850,2850,2800,2850,0.018,-50,2825,"Rep",0,0,FALSE,FALSE,FALSE,1.75,"young",34,161,56,"f"
18,"LEG EXTENSION",2,"Rep02",2700,2700,2700,2700,2700,2700,0,0,2700,"Rep",0,0,FALSE,FALSE,FALSE,0,"young",34,161,56,"f"
18,"LEG EXTENSION",2,"Rep03",2800,2800,2800,2800,2800,2800,0,0,2800,"Rep",0,0,FALSE,FALSE,FALSE,0,"young",34,161,56,"f"
18,"LEG EXTENSION",2,"Rep04",2720,2720,2700,2700,2720,2700,0.007,20,2710,"Rep",0,0,FALSE,FALSE,FALSE,0.74,"young",34,161,56,"f"
18,"LEG EXTENSION",2,"Rep05",2620,2620,2650,2650,2620,2650,0.011,-30,2635,"Rep",0,0,FALSE,FALSE,FALSE,1.13,"young",34,161,56,"f"
18,"LEG EXTENSION",2,"Rep06",2560,2560,2550,2550,2560,2550,0.004,10,2555,"Rep",0,0,FALSE,FALSE,FALSE,0.39,"young",34,161,56,"f"
18,"LEG EXTENSION",2,"Rep07",2560,2560,2550,2550,2560,2550,0.004,10,2555,"Rep",0,0,FALSE,FALSE,FALSE,0.39,"young",34,161,56,"f"
18,"LEG EXTENSION",2,"Rep08",2440,2460,2400,2400,2450,2400,0.02,50,2425,"Rep",-20,0,FALSE,FALSE,FALSE,2.08,"young",34,161,56,"f"
18,"LEG EXTENSION",2,"Rep09",2600,2580,2600,2600,2590,2600,0.004,-10,2595,"Rep",20,0,FALSE,FALSE,FALSE,0.38,"young",34,161,56,"f"
18,"LEG EXTENSION",2,"Rep10",2600,2580,2700,2700,2590,2700,0.042,-110,2645,"Rep",20,0,TRUE,FALSE,FALSE,4.07,"young",34,161,56,"f"
18,"LEG EXTENSION",1,"TuT",28720,28720,28900,28850,28720,28875,0.005,-155,28797.5,"TuT",0,50,FALSE,FALSE,FALSE,0.54,"young",34,161,56,"f"
18,"LEG EXTENSION",2,"TuT",26400,26380,26500,26500,26390,26500,0.004,-110,26445,"TuT",20,0,FALSE,FALSE,FALSE,0.42,"young",34,161,56,"f"
18,"LEG CURL",1,"Con01",900,900,1050,1000,900,1025,0.139,-125,962.5,"Con",0,50,FALSE,FALSE,FALSE,12.2,"young",34,161,56,"f"
18,"LEG CURL",1,"Con02",1120,1160,1200,1200,1140,1200,0.053,-60,1170,"Con",-40,0,FALSE,FALSE,FALSE,5,"young",34,161,56,"f"
18,"LEG CURL",1,"Con03",1100,1080,1150,1100,1090,1125,0.032,-35,1107.5,"Con",20,50,FALSE,FALSE,FALSE,3.11,"young",34,161,56,"f"
18,"LEG CURL",1,"Con04",1060,1060,1000,1000,1060,1000,0.057,60,1030,"Con",0,0,FALSE,FALSE,FALSE,6,"young",34,161,56,"f"
18,"LEG CURL",1,"Con05",1000,1000,1000,1050,1000,1025,0.025,-25,1012.5,"Con",0,-50,FALSE,FALSE,FALSE,2.44,"young",34,161,56,"f"
18,"LEG CURL",1,"Con06",1080,1100,1050,1100,1090,1075,0.014,15,1082.5,"Con",-20,-50,FALSE,FALSE,FALSE,1.4,"young",34,161,56,"f"
18,"LEG CURL",1,"Con07",1040,1020,1100,1100,1030,1100,0.068,-70,1065,"Con",20,0,FALSE,FALSE,FALSE,6.36,"young",34,161,56,"f"
18,"LEG CURL",1,"Con08",1020,1060,1250,1250,1040,1250,0.202,-210,1145,"Con",-40,0,FALSE,FALSE,FALSE,16.8,"young",34,161,56,"f"
18,"LEG CURL",1,"Con09",1060,1040,1450,1450,1050,1450,0.381,-400,1250,"Con",20,0,TRUE,FALSE,FALSE,27.59,"young",34,161,56,"f"
18,"LEG CURL",1,"Con10",1140,1120,1500,1500,1130,1500,0.327,-370,1315,"Con",20,0,TRUE,FALSE,FALSE,24.67,"young",34,161,56,"f"
18,"LEG CURL",2,"Con01",1180,1160,1200,1150,1170,1175,0.004,-5,1172.5,"Con",20,50,FALSE,FALSE,FALSE,0.43,"young",34,161,56,"f"
18,"LEG CURL",2,"Con02",1080,1100,1150,1150,1090,1150,0.055,-60,1120,"Con",-20,0,FALSE,FALSE,FALSE,5.22,"young",34,161,56,"f"
18,"LEG CURL",2,"Con03",1000,1020,1050,1150,1010,1100,0.089,-90,1055,"Con",-20,-100,FALSE,FALSE,FALSE,8.18,"young",34,161,56,"f"
18,"LEG CURL",2,"Con04",1100,1100,1150,1300,1100,1225,0.114,-125,1162.5,"Con",0,-150,FALSE,FALSE,FALSE,10.2,"young",34,161,56,"f"
18,"LEG CURL",2,"Con05",1320,1300,1300,1450,1310,1375,0.05,-65,1342.5,"Con",20,-150,FALSE,FALSE,FALSE,4.73,"young",34,161,56,"f"
18,"LEG CURL",2,"Con06",1040,1040,1100,1050,1040,1075,0.034,-35,1057.5,"Con",0,50,FALSE,FALSE,FALSE,3.26,"young",34,161,56,"f"
18,"LEG CURL",2,"Con07",1000,1000,1200,1050,1000,1125,0.125,-125,1062.5,"Con",0,150,FALSE,FALSE,FALSE,11.11,"young",34,161,56,"f"
18,"LEG CURL",2,"Con08",1060,1060,1200,1150,1060,1175,0.108,-115,1117.5,"Con",0,50,FALSE,FALSE,FALSE,9.79,"young",34,161,56,"f"
18,"LEG CURL",2,"Con09",1060,1060,1250,1200,1060,1225,0.156,-165,1142.5,"Con",0,50,FALSE,FALSE,FALSE,13.47,"young",34,161,56,"f"
18,"LEG CURL",2,"Con10",1160,1160,1400,1400,1160,1400,0.207,-240,1280,"Con",0,0,TRUE,FALSE,FALSE,17.14,"young",34,161,56,"f"
18,"LEG CURL",1,"Ecc01",1720,1700,1650,1650,1710,1650,0.035,60,1680,"Ecc",20,0,FALSE,FALSE,FALSE,3.64,"young",34,161,56,"f"
18,"LEG CURL",1,"Ecc02",1980,1980,1900,1950,1980,1925,0.028,55,1952.5,"Ecc",0,-50,FALSE,FALSE,FALSE,2.86,"young",34,161,56,"f"
18,"LEG CURL",1,"Ecc03",2060,2060,2100,2100,2060,2100,0.019,-40,2080,"Ecc",0,0,FALSE,FALSE,FALSE,1.9,"young",34,161,56,"f"
18,"LEG CURL",1,"Ecc04",2000,2020,2000,2000,2010,2000,0.005,10,2005,"Ecc",-20,0,FALSE,FALSE,FALSE,0.5,"young",34,161,56,"f"
18,"LEG CURL",1,"Ecc05",1860,1840,1900,1850,1850,1875,0.014,-25,1862.5,"Ecc",20,50,FALSE,FALSE,FALSE,1.33,"young",34,161,56,"f"
18,"LEG CURL",1,"Ecc06",1740,1740,1700,1650,1740,1675,0.037,65,1707.5,"Ecc",0,50,FALSE,FALSE,FALSE,3.88,"young",34,161,56,"f"
18,"LEG CURL",1,"Ecc07",1820,1800,1650,1650,1810,1650,0.088,160,1730,"Ecc",20,0,FALSE,FALSE,FALSE,9.7,"young",34,161,56,"f"
18,"LEG CURL",1,"Ecc08",1960,1960,1600,1600,1960,1600,0.184,360,1780,"Ecc",0,0,TRUE,FALSE,FALSE,22.5,"young",34,161,56,"f"
18,"LEG CURL",1,"Ecc09",1780,1800,1400,1400,1790,1400,0.218,390,1595,"Ecc",-20,0,TRUE,FALSE,FALSE,27.86,"young",34,161,56,"f"
18,"LEG CURL",1,"Ecc10",1880,1880,1850,1850,1880,1850,0.016,30,1865,"Ecc",0,0,FALSE,FALSE,FALSE,1.62,"young",34,161,56,"f"
18,"LEG CURL",2,"Ecc01",2000,1980,1900,1950,1990,1925,0.033,65,1957.5,"Ecc",20,-50,FALSE,FALSE,FALSE,3.38,"young",34,161,56,"f"
18,"LEG CURL",2,"Ecc02",1880,1860,1850,1750,1870,1800,0.037,70,1835,"Ecc",20,100,FALSE,FALSE,FALSE,3.89,"young",34,161,56,"f"
18,"LEG CURL",2,"Ecc03",1940,1940,1900,1750,1940,1825,0.059,115,1882.5,"Ecc",0,150,FALSE,FALSE,FALSE,6.3,"young",34,161,56,"f"
18,"LEG CURL",2,"Ecc04",1880,1880,1850,1700,1880,1775,0.056,105,1827.5,"Ecc",0,150,FALSE,FALSE,FALSE,5.92,"young",34,161,56,"f"
18,"LEG CURL",2,"Ecc05",2120,2140,2150,2050,2130,2100,0.014,30,2115,"Ecc",-20,100,FALSE,FALSE,FALSE,1.43,"young",34,161,56,"f"
18,"LEG CURL",2,"Ecc06",1980,1980,1750,2000,1980,1875,0.053,105,1927.5,"Ecc",0,-250,FALSE,FALSE,TRUE,5.6,"young",34,161,56,"f"
18,"LEG CURL",2,"Ecc07",1920,1920,1800,1850,1920,1825,0.049,95,1872.5,"Ecc",0,-50,FALSE,FALSE,FALSE,5.21,"young",34,161,56,"f"
18,"LEG CURL",2,"Ecc08",1900,1900,1700,1750,1900,1725,0.092,175,1812.5,"Ecc",0,-50,FALSE,FALSE,FALSE,10.14,"young",34,161,56,"f"
18,"LEG CURL",2,"Ecc09",1920,1920,1700,1700,1920,1700,0.115,220,1810,"Ecc",0,0,FALSE,FALSE,FALSE,12.94,"young",34,161,56,"f"
18,"LEG CURL",2,"Ecc10",2060,2040,2050,2100,2050,2075,0.012,-25,2062.5,"Ecc",20,-50,FALSE,FALSE,FALSE,1.2,"young",34,161,56,"f"
18,"LEG CURL",1,"Rep01",2620,2600,2700,2650,2610,2675,0.025,-65,2642.5,"Rep",20,50,FALSE,FALSE,FALSE,2.43,"young",34,161,56,"f"
18,"LEG CURL",1,"Rep02",3100,3140,3100,3150,3120,3125,0.002,-5,3122.5,"Rep",-40,-50,FALSE,FALSE,FALSE,0.16,"young",34,161,56,"f"
18,"LEG CURL",1,"Rep03",3160,3140,3250,3200,3150,3225,0.024,-75,3187.5,"Rep",20,50,FALSE,FALSE,FALSE,2.33,"young",34,161,56,"f"
18,"LEG CURL",1,"Rep04",3060,3080,3000,3000,3070,3000,0.023,70,3035,"Rep",-20,0,FALSE,FALSE,FALSE,2.33,"young",34,161,56,"f"
18,"LEG CURL",1,"Rep05",2860,2840,2900,2900,2850,2900,0.018,-50,2875,"Rep",20,0,FALSE,FALSE,FALSE,1.72,"young",34,161,56,"f"
18,"LEG CURL",1,"Rep06",2820,2840,2750,2750,2830,2750,0.028,80,2790,"Rep",-20,0,FALSE,FALSE,FALSE,2.91,"young",34,161,56,"f"
18,"LEG CURL",1,"Rep07",2860,2820,2750,2750,2840,2750,0.032,90,2795,"Rep",40,0,FALSE,FALSE,FALSE,3.27,"young",34,161,56,"f"
18,"LEG CURL",1,"Rep08",2980,3020,2850,2850,3000,2850,0.05,150,2925,"Rep",-40,0,FALSE,FALSE,FALSE,5.26,"young",34,161,56,"f"
18,"LEG CURL",1,"Rep09",2840,2840,2850,2850,2840,2850,0.004,-10,2845,"Rep",0,0,FALSE,FALSE,FALSE,0.35,"young",34,161,56,"f"
18,"LEG CURL",1,"Rep10",3020,3000,3350,3350,3010,3350,0.113,-340,3180,"Rep",20,0,TRUE,FALSE,FALSE,10.15,"young",34,161,56,"f"
18,"LEG CURL",2,"Rep01",3180,3140,3100,3100,3160,3100,0.019,60,3130,"Rep",40,0,FALSE,FALSE,FALSE,1.94,"young",34,161,56,"f"
18,"LEG CURL",2,"Rep02",2960,2960,3000,2900,2960,2950,0.003,10,2955,"Rep",0,100,FALSE,FALSE,FALSE,0.34,"young",34,161,56,"f"
18,"LEG CURL",2,"Rep03",2940,2960,2950,2900,2950,2925,0.008,25,2937.5,"Rep",-20,50,FALSE,FALSE,FALSE,0.85,"young",34,161,56,"f"
18,"LEG CURL",2,"Rep04",2980,2980,3000,3000,2980,3000,0.007,-20,2990,"Rep",0,0,FALSE,FALSE,FALSE,0.67,"young",34,161,56,"f"
18,"LEG CURL",2,"Rep05",3440,3440,3450,3500,3440,3475,0.01,-35,3457.5,"Rep",0,-50,FALSE,FALSE,FALSE,1.01,"young",34,161,56,"f"
18,"LEG CURL",2,"Rep06",3020,3020,2850,3050,3020,2950,0.023,70,2985,"Rep",0,-200,FALSE,FALSE,TRUE,2.37,"young",34,161,56,"f"
18,"LEG CURL",2,"Rep07",2920,2920,3000,2900,2920,2950,0.01,-30,2935,"Rep",0,100,FALSE,FALSE,FALSE,1.02,"young",34,161,56,"f"
18,"LEG CURL",2,"Rep08",2960,2960,2900,2900,2960,2900,0.02,60,2930,"Rep",0,0,FALSE,FALSE,FALSE,2.07,"young",34,161,56,"f"
18,"LEG CURL",2,"Rep09",2980,2980,2950,2900,2980,2925,0.018,55,2952.5,"Rep",0,50,FALSE,FALSE,FALSE,1.88,"young",34,161,56,"f"
18,"LEG CURL",2,"Rep10",3220,3200,3450,3500,3210,3475,0.083,-265,3342.5,"Rep",20,-50,TRUE,FALSE,FALSE,7.63,"young",34,161,56,"f"
18,"LEG CURL",1,"TuT",29320,29320,29500,29450,29320,29475,0.005,-155,29397.5,"TuT",0,50,FALSE,FALSE,FALSE,0.53,"young",34,161,56,"f"
18,"LEG CURL",2,"TuT",30600,30560,30650,30650,30580,30650,0.002,-70,30615,"TuT",40,0,FALSE,TRUE,FALSE,0.23,"young",34,161,56,"f"
18,"ABDUCTOR",1,"Con01",720,720,1250,1400,720,1325,0.84,-605,1022.5,"Con",0,-150,TRUE,FALSE,FALSE,45.66,"young",34,161,56,"f"
18,"ABDUCTOR",1,"Con02",720,740,900,900,730,900,0.233,-170,815,"Con",-20,0,FALSE,FALSE,FALSE,18.89,"young",34,161,56,"f"
18,"ABDUCTOR",1,"Con03",700,720,1150,1050,710,1100,0.549,-390,905,"Con",-20,100,TRUE,FALSE,FALSE,35.45,"young",34,161,56,"f"
18,"ABDUCTOR",1,"Con04",760,740,1050,1000,750,1025,0.367,-275,887.5,"Con",20,50,FALSE,FALSE,FALSE,26.83,"young",34,161,56,"f"
18,"ABDUCTOR",1,"Con05",720,720,1100,1000,720,1050,0.458,-330,885,"Con",0,100,TRUE,FALSE,FALSE,31.43,"young",34,161,56,"f"
18,"ABDUCTOR",1,"Con06",660,680,950,950,670,950,0.418,-280,810,"Con",-20,0,FALSE,FALSE,FALSE,29.47,"young",34,161,56,"f"
18,"ABDUCTOR",1,"Con07",680,660,950,1000,670,975,0.455,-305,822.5,"Con",20,-50,TRUE,FALSE,FALSE,31.28,"young",34,161,56,"f"
18,"ABDUCTOR",1,"Con08",680,680,950,1050,680,1000,0.471,-320,840,"Con",0,-100,TRUE,FALSE,FALSE,32,"young",34,161,56,"f"
18,"ABDUCTOR",1,"Con09",680,720,1150,1300,700,1225,0.75,-525,962.5,"Con",-40,-150,TRUE,TRUE,FALSE,42.86,"young",34,161,56,"f"
18,"ABDUCTOR",1,"Con10",700,700,1100,1250,700,1175,0.679,-475,937.5,"Con",0,-150,TRUE,FALSE,FALSE,40.43,"young",34,161,56,"f"
18,"ABDUCTOR",2,"Con01",700,700,1350,1400,700,1375,0.964,-675,1037.5,"Con",0,-50,TRUE,FALSE,FALSE,49.09,"young",34,161,56,"f"
18,"ABDUCTOR",2,"Con02",660,640,950,950,650,950,0.462,-300,800,"Con",20,0,TRUE,FALSE,FALSE,31.58,"young",34,161,56,"f"
18,"ABDUCTOR",2,"Con03",620,620,1000,900,620,950,0.532,-330,785,"Con",0,100,TRUE,FALSE,FALSE,34.74,"young",34,161,56,"f"
18,"ABDUCTOR",2,"Con04",660,660,1000,950,660,975,0.477,-315,817.5,"Con",0,50,TRUE,FALSE,FALSE,32.31,"young",34,161,56,"f"
18,"ABDUCTOR",2,"Con05",620,620,1000,1050,620,1025,0.653,-405,822.5,"Con",0,-50,TRUE,FALSE,FALSE,39.51,"young",34,161,56,"f"
18,"ABDUCTOR",2,"Con06",660,680,1000,950,670,975,0.455,-305,822.5,"Con",-20,50,TRUE,FALSE,FALSE,31.28,"young",34,161,56,"f"
18,"ABDUCTOR",2,"Con07",700,700,1100,1150,700,1125,0.607,-425,912.5,"Con",0,-50,TRUE,FALSE,FALSE,37.78,"young",34,161,56,"f"
18,"ABDUCTOR",2,"Con08",600,620,1050,1100,610,1075,0.762,-465,842.5,"Con",-20,-50,TRUE,FALSE,FALSE,43.26,"young",34,161,56,"f"
18,"ABDUCTOR",2,"Con09",660,680,1050,1100,670,1075,0.604,-405,872.5,"Con",-20,-50,TRUE,FALSE,FALSE,37.67,"young",34,161,56,"f"
18,"ABDUCTOR",2,"Con10",680,680,1050,1100,680,1075,0.581,-395,877.5,"Con",0,-50,TRUE,FALSE,FALSE,36.74,"young",34,161,56,"f"
18,"ABDUCTOR",1,"Ecc01",1520,1520,1700,1600,1520,1650,0.086,-130,1585,"Ecc",0,100,FALSE,FALSE,FALSE,7.88,"young",34,161,56,"f"
18,"ABDUCTOR",1,"Ecc02",1260,1240,1300,1400,1250,1350,0.08,-100,1300,"Ecc",20,-100,FALSE,FALSE,FALSE,7.41,"young",34,161,56,"f"
18,"ABDUCTOR",1,"Ecc03",1400,1420,1350,1400,1410,1375,0.025,35,1392.5,"Ecc",-20,-50,FALSE,FALSE,FALSE,2.55,"young",34,161,56,"f"
18,"ABDUCTOR",1,"Ecc04",1500,1500,1300,1400,1500,1350,0.1,150,1425,"Ecc",0,-100,FALSE,FALSE,FALSE,11.11,"young",34,161,56,"f"
18,"ABDUCTOR",1,"Ecc05",1640,1640,1450,1500,1640,1475,0.101,165,1557.5,"Ecc",0,-50,FALSE,FALSE,FALSE,11.19,"young",34,161,56,"f"
18,"ABDUCTOR",1,"Ecc06",1520,1520,1600,1550,1520,1575,0.036,-55,1547.5,"Ecc",0,50,FALSE,FALSE,FALSE,3.49,"young",34,161,56,"f"
18,"ABDUCTOR",1,"Ecc07",1400,1400,1500,1400,1400,1450,0.036,-50,1425,"Ecc",0,100,FALSE,FALSE,FALSE,3.45,"young",34,161,56,"f"
18,"ABDUCTOR",1,"Ecc08",1380,1360,1350,1200,1370,1275,0.069,95,1322.5,"Ecc",20,150,FALSE,FALSE,FALSE,7.45,"young",34,161,56,"f"
18,"ABDUCTOR",1,"Ecc09",1380,1360,1300,1150,1370,1225,0.106,145,1297.5,"Ecc",20,150,FALSE,FALSE,FALSE,11.84,"young",34,161,56,"f"
18,"ABDUCTOR",1,"Ecc10",1520,1520,1250,1200,1520,1225,0.194,295,1372.5,"Ecc",0,50,FALSE,FALSE,FALSE,24.08,"young",34,161,56,"f"
18,"ABDUCTOR",2,"Ecc01",1160,1180,1600,1600,1170,1600,0.368,-430,1385,"Ecc",-20,0,TRUE,FALSE,FALSE,26.88,"young",34,161,56,"f"
18,"ABDUCTOR",2,"Ecc02",1340,1340,1350,1400,1340,1375,0.026,-35,1357.5,"Ecc",0,-50,FALSE,FALSE,FALSE,2.55,"young",34,161,56,"f"
18,"ABDUCTOR",2,"Ecc03",1220,1240,1400,1500,1230,1450,0.179,-220,1340,"Ecc",-20,-100,FALSE,FALSE,FALSE,15.17,"young",34,161,56,"f"
18,"ABDUCTOR",2,"Ecc04",1240,1220,1450,1450,1230,1450,0.179,-220,1340,"Ecc",20,0,FALSE,FALSE,FALSE,15.17,"young",34,161,56,"f"
18,"ABDUCTOR",2,"Ecc05",1240,1220,1250,1250,1230,1250,0.016,-20,1240,"Ecc",20,0,FALSE,FALSE,FALSE,1.6,"young",34,161,56,"f"
18,"ABDUCTOR",2,"Ecc06",1240,1220,1450,1400,1230,1425,0.159,-195,1327.5,"Ecc",20,50,FALSE,FALSE,FALSE,13.68,"young",34,161,56,"f"
18,"ABDUCTOR",2,"Ecc07",1320,1320,1150,1150,1320,1150,0.129,170,1235,"Ecc",0,0,FALSE,FALSE,FALSE,14.78,"young",34,161,56,"f"
18,"ABDUCTOR",2,"Ecc08",1360,1340,1300,1250,1350,1275,0.056,75,1312.5,"Ecc",20,50,FALSE,FALSE,FALSE,5.88,"young",34,161,56,"f"
18,"ABDUCTOR",2,"Ecc09",1420,1420,1350,1300,1420,1325,0.067,95,1372.5,"Ecc",0,50,FALSE,FALSE,FALSE,7.17,"young",34,161,56,"f"
18,"ABDUCTOR",2,"Ecc10",1480,1480,1500,1450,1480,1475,0.003,5,1477.5,"Ecc",0,50,FALSE,FALSE,FALSE,0.34,"young",34,161,56,"f"
18,"ABDUCTOR",1,"Rep01",2240,2240,2950,3000,2240,2975,0.328,-735,2607.5,"Rep",0,-50,TRUE,FALSE,FALSE,24.71,"young",34,161,56,"f"
18,"ABDUCTOR",1,"Rep02",1980,1980,2200,2300,1980,2250,0.136,-270,2115,"Rep",0,-100,FALSE,FALSE,FALSE,12,"young",34,161,56,"f"
18,"ABDUCTOR",1,"Rep03",2100,2140,2500,2450,2120,2475,0.167,-355,2297.5,"Rep",-40,50,TRUE,FALSE,FALSE,14.34,"young",34,161,56,"f"
18,"ABDUCTOR",1,"Rep04",2260,2240,2350,2400,2250,2375,0.056,-125,2312.5,"Rep",20,-50,FALSE,FALSE,FALSE,5.26,"young",34,161,56,"f"
18,"ABDUCTOR",1,"Rep05",2360,2360,2550,2500,2360,2525,0.07,-165,2442.5,"Rep",0,50,FALSE,FALSE,FALSE,6.53,"young",34,161,56,"f"
18,"ABDUCTOR",1,"Rep06",2180,2200,2550,2500,2190,2525,0.153,-335,2357.5,"Rep",-20,50,TRUE,FALSE,FALSE,13.27,"young",34,161,56,"f"
18,"ABDUCTOR",1,"Rep07",2080,2060,2450,2400,2070,2425,0.171,-355,2247.5,"Rep",20,50,TRUE,FALSE,FALSE,14.64,"young",34,161,56,"f"
18,"ABDUCTOR",1,"Rep08",2060,2040,2300,2250,2050,2275,0.11,-225,2162.5,"Rep",20,50,FALSE,FALSE,FALSE,9.89,"young",34,161,56,"f"
18,"ABDUCTOR",1,"Rep09",2060,2080,2450,2450,2070,2450,0.184,-380,2260,"Rep",-20,0,TRUE,FALSE,FALSE,15.51,"young",34,161,56,"f"
18,"ABDUCTOR",1,"Rep10",2220,2220,2350,2450,2220,2400,0.081,-180,2310,"Rep",0,-100,FALSE,FALSE,FALSE,7.5,"young",34,161,56,"f"
18,"ABDUCTOR",2,"Rep01",1860,1880,2950,3000,1870,2975,0.591,-1105,2422.5,"Rep",-20,-50,TRUE,FALSE,FALSE,37.14,"young",34,161,56,"f"
18,"ABDUCTOR",2,"Rep02",2000,1980,2300,2350,1990,2325,0.168,-335,2157.5,"Rep",20,-50,TRUE,FALSE,FALSE,14.41,"young",34,161,56,"f"
18,"ABDUCTOR",2,"Rep03",1840,1860,2400,2400,1850,2400,0.297,-550,2125,"Rep",-20,0,TRUE,FALSE,FALSE,22.92,"young",34,161,56,"f"
18,"ABDUCTOR",2,"Rep04",1900,1880,2450,2400,1890,2425,0.283,-535,2157.5,"Rep",20,50,TRUE,FALSE,FALSE,22.06,"young",34,161,56,"f"
18,"ABDUCTOR",2,"Rep05",1860,1840,2250,2300,1850,2275,0.23,-425,2062.5,"Rep",20,-50,TRUE,FALSE,FALSE,18.68,"young",34,161,56,"f"
18,"ABDUCTOR",2,"Rep06",1900,1900,2450,2350,1900,2400,0.263,-500,2150,"Rep",0,100,TRUE,FALSE,FALSE,20.83,"young",34,161,56,"f"
18,"ABDUCTOR",2,"Rep07",2020,2020,2250,2300,2020,2275,0.126,-255,2147.5,"Rep",0,-50,FALSE,FALSE,FALSE,11.21,"young",34,161,56,"f"
18,"ABDUCTOR",2,"Rep08",1960,1960,2350,2350,1960,2350,0.199,-390,2155,"Rep",0,0,TRUE,FALSE,FALSE,16.6,"young",34,161,56,"f"
18,"ABDUCTOR",2,"Rep09",2080,2100,2400,2400,2090,2400,0.148,-310,2245,"Rep",-20,0,TRUE,FALSE,FALSE,12.92,"young",34,161,56,"f"
18,"ABDUCTOR",2,"Rep10",2160,2160,2550,2550,2160,2550,0.181,-390,2355,"Rep",0,0,TRUE,FALSE,FALSE,15.29,"young",34,161,56,"f"
18,"ABDUCTOR",1,"TuT",21540,21560,24650,24700,21550,24675,0.145,-3125,23112.5,"TuT",-20,-50,TRUE,FALSE,FALSE,12.66,"young",34,161,56,"f"
18,"ABDUCTOR",2,"TuT",19580,19580,24350,24400,19580,24375,0.245,-4795,21977.5,"TuT",0,-50,TRUE,FALSE,FALSE,19.67,"young",34,161,56,"f"
18,"ADDUCTOR",1,"Con01",1380,1380,900,950,1380,925,0.33,455,1152.5,"Con",0,-50,FALSE,FALSE,FALSE,49.19,"young",34,161,56,"f"
18,"ADDUCTOR",1,"Con02",940,940,800,950,940,875,0.069,65,907.5,"Con",0,-150,FALSE,FALSE,FALSE,7.43,"young",34,161,56,"f"
18,"ADDUCTOR",1,"Con03",980,1000,750,850,990,800,0.192,190,895,"Con",-20,-100,FALSE,FALSE,FALSE,23.75,"young",34,161,56,"f"
18,"ADDUCTOR",1,"Con04",920,960,800,850,940,825,0.122,115,882.5,"Con",-40,-50,FALSE,TRUE,FALSE,13.94,"young",34,161,56,"f"
18,"ADDUCTOR",1,"Con05",1020,1020,900,850,1020,875,0.142,145,947.5,"Con",0,50,FALSE,FALSE,FALSE,16.57,"young",34,161,56,"f"
18,"ADDUCTOR",1,"Con06",920,900,800,800,910,800,0.121,110,855,"Con",20,0,FALSE,FALSE,FALSE,13.75,"young",34,161,56,"f"
18,"ADDUCTOR",1,"Con07",960,960,750,700,960,725,0.245,235,842.5,"Con",0,50,FALSE,FALSE,FALSE,32.41,"young",34,161,56,"f"
18,"ADDUCTOR",1,"Con08",940,940,850,800,940,825,0.122,115,882.5,"Con",0,50,FALSE,FALSE,FALSE,13.94,"young",34,161,56,"f"
18,"ADDUCTOR",1,"Con09",940,940,900,800,940,850,0.096,90,895,"Con",0,100,FALSE,FALSE,FALSE,10.59,"young",34,161,56,"f"
18,"ADDUCTOR",1,"Con10",920,920,950,900,920,925,0.005,-5,922.5,"Con",0,50,FALSE,FALSE,FALSE,0.54,"young",34,161,56,"f"
18,"ADDUCTOR",2,"Con01",1160,1160,850,750,1160,800,0.31,360,980,"Con",0,100,FALSE,FALSE,FALSE,45,"young",34,161,56,"f"
18,"ADDUCTOR",2,"Con02",980,940,800,750,960,775,0.193,185,867.5,"Con",40,50,FALSE,TRUE,FALSE,23.87,"young",34,161,56,"f"
18,"ADDUCTOR",2,"Con03",960,960,750,700,960,725,0.245,235,842.5,"Con",0,50,FALSE,FALSE,FALSE,32.41,"young",34,161,56,"f"
18,"ADDUCTOR",2,"Con04",1000,1000,700,750,1000,725,0.275,275,862.5,"Con",0,-50,FALSE,FALSE,FALSE,37.93,"young",34,161,56,"f"
18,"ADDUCTOR",2,"Con05",980,1000,700,700,990,700,0.293,290,845,"Con",-20,0,FALSE,FALSE,FALSE,41.43,"young",34,161,56,"f"
18,"ADDUCTOR",2,"Con06",940,920,700,750,930,725,0.22,205,827.5,"Con",20,-50,FALSE,FALSE,FALSE,28.28,"young",34,161,56,"f"
18,"ADDUCTOR",2,"Con07",1000,980,800,850,990,825,0.167,165,907.5,"Con",20,-50,FALSE,FALSE,FALSE,20,"young",34,161,56,"f"
18,"ADDUCTOR",2,"Con08",920,900,800,850,910,825,0.093,85,867.5,"Con",20,-50,FALSE,FALSE,FALSE,10.3,"young",34,161,56,"f"
18,"ADDUCTOR",2,"Con09",900,900,800,900,900,850,0.056,50,875,"Con",0,-100,FALSE,FALSE,FALSE,5.88,"young",34,161,56,"f"
18,"ADDUCTOR",2,"Con10",880,880,850,850,880,850,0.034,30,865,"Con",0,0,FALSE,FALSE,FALSE,3.53,"young",34,161,56,"f"
18,"ADDUCTOR",1,"Ecc01",1480,1480,1400,1200,1480,1300,0.122,180,1390,"Ecc",0,200,FALSE,FALSE,FALSE,13.85,"young",34,161,56,"f"
18,"ADDUCTOR",1,"Ecc02",1500,1480,1250,1150,1490,1200,0.195,290,1345,"Ecc",20,100,FALSE,FALSE,FALSE,24.17,"young",34,161,56,"f"
18,"ADDUCTOR",1,"Ecc03",1400,1380,1350,1250,1390,1300,0.065,90,1345,"Ecc",20,100,FALSE,FALSE,FALSE,6.92,"young",34,161,56,"f"
18,"ADDUCTOR",1,"Ecc04",1460,1440,1350,1400,1450,1375,0.052,75,1412.5,"Ecc",20,-50,FALSE,FALSE,FALSE,5.45,"young",34,161,56,"f"
18,"ADDUCTOR",1,"Ecc05",1460,1480,1500,1500,1470,1500,0.02,-30,1485,"Ecc",-20,0,FALSE,FALSE,FALSE,2,"young",34,161,56,"f"
18,"ADDUCTOR",1,"Ecc06",1600,1600,1400,1450,1600,1425,0.109,175,1512.5,"Ecc",0,-50,FALSE,FALSE,FALSE,12.28,"young",34,161,56,"f"
18,"ADDUCTOR",1,"Ecc07",1440,1440,1250,1300,1440,1275,0.115,165,1357.5,"Ecc",0,-50,FALSE,FALSE,FALSE,12.94,"young",34,161,56,"f"
18,"ADDUCTOR",1,"Ecc08",1540,1540,1200,1250,1540,1225,0.205,315,1382.5,"Ecc",0,-50,FALSE,FALSE,FALSE,25.71,"young",34,161,56,"f"
18,"ADDUCTOR",1,"Ecc09",1500,1500,1150,1250,1500,1200,0.2,300,1350,"Ecc",0,-100,FALSE,FALSE,FALSE,25,"young",34,161,56,"f"
18,"ADDUCTOR",1,"Ecc10",1260,1260,1500,1400,1260,1450,0.151,-190,1355,"Ecc",0,100,FALSE,FALSE,FALSE,13.1,"young",34,161,56,"f"
18,"ADDUCTOR",2,"Ecc01",1600,1640,1050,1150,1620,1100,0.321,520,1360,"Ecc",-40,-100,FALSE,TRUE,FALSE,47.27,"young",34,161,56,"f"
18,"ADDUCTOR",2,"Ecc02",1360,1380,1200,1200,1370,1200,0.124,170,1285,"Ecc",-20,0,FALSE,FALSE,FALSE,14.17,"young",34,161,56,"f"
18,"ADDUCTOR",2,"Ecc03",1420,1420,1150,1150,1420,1150,0.19,270,1285,"Ecc",0,0,FALSE,FALSE,FALSE,23.48,"young",34,161,56,"f"
18,"ADDUCTOR",2,"Ecc04",1480,1460,1150,1150,1470,1150,0.218,320,1310,"Ecc",20,0,FALSE,FALSE,FALSE,27.83,"young",34,161,56,"f"
18,"ADDUCTOR",2,"Ecc05",1280,1300,1200,1150,1290,1175,0.089,115,1232.5,"Ecc",-20,50,FALSE,FALSE,FALSE,9.79,"young",34,161,56,"f"
18,"ADDUCTOR",2,"Ecc06",1500,1500,1200,1150,1500,1175,0.217,325,1337.5,"Ecc",0,50,FALSE,FALSE,FALSE,27.66,"young",34,161,56,"f"
18,"ADDUCTOR",2,"Ecc07",1340,1380,1100,1050,1360,1075,0.21,285,1217.5,"Ecc",-40,50,FALSE,TRUE,FALSE,26.51,"young",34,161,56,"f"
18,"ADDUCTOR",2,"Ecc08",1420,1420,1200,1100,1420,1150,0.19,270,1285,"Ecc",0,100,FALSE,FALSE,FALSE,23.48,"young",34,161,56,"f"
18,"ADDUCTOR",2,"Ecc09",1480,1480,1300,1250,1480,1275,0.139,205,1377.5,"Ecc",0,50,FALSE,FALSE,FALSE,16.08,"young",34,161,56,"f"
18,"ADDUCTOR",2,"Ecc10",1540,1540,1250,1350,1540,1300,0.156,240,1420,"Ecc",0,-100,FALSE,FALSE,FALSE,18.46,"young",34,161,56,"f"
18,"ADDUCTOR",1,"Rep01",2860,2860,2300,2150,2860,2225,0.222,635,2542.5,"Rep",0,150,TRUE,FALSE,FALSE,28.54,"young",34,161,56,"f"
18,"ADDUCTOR",1,"Rep02",2440,2420,2050,2100,2430,2075,0.146,355,2252.5,"Rep",20,-50,FALSE,FALSE,FALSE,17.11,"young",34,161,56,"f"
18,"ADDUCTOR",1,"Rep03",2380,2380,2100,2100,2380,2100,0.118,280,2240,"Rep",0,0,FALSE,FALSE,FALSE,13.33,"young",34,161,56,"f"
18,"ADDUCTOR",1,"Rep04",2380,2400,2150,2250,2390,2200,0.079,190,2295,"Rep",-20,-100,FALSE,FALSE,FALSE,8.64,"young",34,161,56,"f"
18,"ADDUCTOR",1,"Rep05",2480,2500,2400,2350,2490,2375,0.046,115,2432.5,"Rep",-20,50,FALSE,FALSE,FALSE,4.84,"young",34,161,56,"f"
18,"ADDUCTOR",1,"Rep06",2520,2500,2200,2250,2510,2225,0.114,285,2367.5,"Rep",20,-50,FALSE,FALSE,FALSE,12.81,"young",34,161,56,"f"
18,"ADDUCTOR",1,"Rep07",2400,2400,2000,2000,2400,2000,0.167,400,2200,"Rep",0,0,TRUE,FALSE,FALSE,20,"young",34,161,56,"f"
18,"ADDUCTOR",1,"Rep08",2480,2480,2050,2050,2480,2050,0.173,430,2265,"Rep",0,0,TRUE,FALSE,FALSE,20.98,"young",34,161,56,"f"
18,"ADDUCTOR",1,"Rep09",2440,2440,2050,2050,2440,2050,0.16,390,2245,"Rep",0,0,TRUE,FALSE,FALSE,19.02,"young",34,161,56,"f"
18,"ADDUCTOR",1,"Rep10",2180,2180,2450,2300,2180,2375,0.089,-195,2277.5,"Rep",0,150,FALSE,FALSE,FALSE,8.21,"young",34,161,56,"f"
18,"ADDUCTOR",2,"Rep01",2760,2800,1900,1900,2780,1900,0.317,880,2340,"Rep",-40,0,TRUE,FALSE,FALSE,46.32,"young",34,161,56,"f"
18,"ADDUCTOR",2,"Rep02",2340,2320,2000,1950,2330,1975,0.152,355,2152.5,"Rep",20,50,FALSE,FALSE,FALSE,17.97,"young",34,161,56,"f"
18,"ADDUCTOR",2,"Rep03",2380,2380,1900,1850,2380,1875,0.212,505,2127.5,"Rep",0,50,TRUE,FALSE,FALSE,26.93,"young",34,161,56,"f"
18,"ADDUCTOR",2,"Rep04",2480,2460,1850,1900,2470,1875,0.241,595,2172.5,"Rep",20,-50,TRUE,FALSE,FALSE,31.73,"young",34,161,56,"f"
18,"ADDUCTOR",2,"Rep05",2260,2300,1900,1850,2280,1875,0.178,405,2077.5,"Rep",-40,50,TRUE,FALSE,FALSE,21.6,"young",34,161,56,"f"
18,"ADDUCTOR",2,"Rep06",2440,2420,1900,1900,2430,1900,0.218,530,2165,"Rep",20,0,TRUE,FALSE,FALSE,27.89,"young",34,161,56,"f"
18,"ADDUCTOR",2,"Rep07",2340,2360,1900,1900,2350,1900,0.191,450,2125,"Rep",-20,0,TRUE,FALSE,FALSE,23.68,"young",34,161,56,"f"
18,"ADDUCTOR",2,"Rep08",2340,2320,2000,1950,2330,1975,0.152,355,2152.5,"Rep",20,50,FALSE,FALSE,FALSE,17.97,"young",34,161,56,"f"
18,"ADDUCTOR",2,"Rep09",2380,2380,2100,2150,2380,2125,0.107,255,2252.5,"Rep",0,-50,FALSE,FALSE,FALSE,12,"young",34,161,56,"f"
18,"ADDUCTOR",2,"Rep10",2420,2420,2100,2200,2420,2150,0.112,270,2285,"Rep",0,-100,FALSE,FALSE,FALSE,12.56,"young",34,161,56,"f"
18,"ADDUCTOR",1,"TuT",24560,24560,21750,21600,24560,21675,0.117,2885,23117.5,"TuT",0,150,TRUE,FALSE,FALSE,13.31,"young",34,161,56,"f"
18,"ADDUCTOR",2,"TuT",24140,24160,19550,19550,24150,19550,0.19,4600,21850,"TuT",-20,0,TRUE,FALSE,FALSE,23.53,"young",34,161,56,"f"
18,"LOWER BACK",1,"Con01",1080,1120,1200,1150,1100,1175,0.068,-75,1137.5,"Con",-40,50,FALSE,TRUE,FALSE,6.38,"young",34,161,56,"f"
18,"LOWER BACK",1,"Con02",980,960,1000,1000,970,1000,0.031,-30,985,"Con",20,0,FALSE,FALSE,FALSE,3,"young",34,161,56,"f"
18,"LOWER BACK",1,"Con03",1220,1200,1200,1300,1210,1250,0.033,-40,1230,"Con",20,-100,FALSE,FALSE,FALSE,3.2,"young",34,161,56,"f"
18,"LOWER BACK",1,"Con04",1080,1100,1100,1150,1090,1125,0.032,-35,1107.5,"Con",-20,-50,FALSE,FALSE,FALSE,3.11,"young",34,161,56,"f"
18,"LOWER BACK",1,"Con05",1080,1080,1100,1150,1080,1125,0.042,-45,1102.5,"Con",0,-50,FALSE,FALSE,FALSE,4,"young",34,161,56,"f"
18,"LOWER BACK",1,"Con06",1180,1160,1250,1200,1170,1225,0.047,-55,1197.5,"Con",20,50,FALSE,FALSE,FALSE,4.49,"young",34,161,56,"f"
18,"LOWER BACK",1,"Con07",1160,1160,1250,1200,1160,1225,0.056,-65,1192.5,"Con",0,50,FALSE,FALSE,FALSE,5.31,"young",34,161,56,"f"
18,"LOWER BACK",1,"Con08",1140,1140,1250,1200,1140,1225,0.075,-85,1182.5,"Con",0,50,FALSE,FALSE,FALSE,6.94,"young",34,161,56,"f"
18,"LOWER BACK",1,"Con09",1140,1140,1250,1200,1140,1225,0.075,-85,1182.5,"Con",0,50,FALSE,FALSE,FALSE,6.94,"young",34,161,56,"f"
18,"LOWER BACK",1,"Con10",1260,1260,1450,1400,1260,1425,0.131,-165,1342.5,"Con",0,50,FALSE,FALSE,FALSE,11.58,"young",34,161,56,"f"
18,"LOWER BACK",2,"Con01",880,940,1050,1050,910,1050,0.154,-140,980,"Con",-60,0,FALSE,TRUE,FALSE,13.33,"young",34,161,56,"f"
18,"LOWER BACK",2,"Con02",940,960,1000,1000,950,1000,0.053,-50,975,"Con",-20,0,FALSE,FALSE,FALSE,5,"young",34,161,56,"f"
18,"LOWER BACK",2,"Con03",1060,1040,1050,1100,1050,1075,0.024,-25,1062.5,"Con",20,-50,FALSE,FALSE,FALSE,2.33,"young",34,161,56,"f"
18,"LOWER BACK",2,"Con04",1120,1140,1150,1150,1130,1150,0.018,-20,1140,"Con",-20,0,FALSE,FALSE,FALSE,1.74,"young",34,161,56,"f"
18,"LOWER BACK",2,"Con05",1160,1180,1200,1200,1170,1200,0.026,-30,1185,"Con",-20,0,FALSE,FALSE,FALSE,2.5,"young",34,161,56,"f"
18,"LOWER BACK",2,"Con06",1120,1140,1200,1150,1130,1175,0.04,-45,1152.5,"Con",-20,50,FALSE,FALSE,FALSE,3.83,"young",34,161,56,"f"
18,"LOWER BACK",2,"Con07",1100,1120,1150,1150,1110,1150,0.036,-40,1130,"Con",-20,0,FALSE,FALSE,FALSE,3.48,"young",34,161,56,"f"
18,"LOWER BACK",2,"Con08",1100,1120,1200,1150,1110,1175,0.059,-65,1142.5,"Con",-20,50,FALSE,FALSE,FALSE,5.53,"young",34,161,56,"f"
18,"LOWER BACK",2,"Con09",1160,1200,1300,1300,1180,1300,0.102,-120,1240,"Con",-40,0,FALSE,TRUE,FALSE,9.23,"young",34,161,56,"f"
18,"LOWER BACK",2,"Con10",1160,1160,1300,1300,1160,1300,0.121,-140,1230,"Con",0,0,FALSE,FALSE,FALSE,10.77,"young",34,161,56,"f"
18,"LOWER BACK",1,"Ecc01",1620,1600,1600,1600,1610,1600,0.006,10,1605,"Ecc",20,0,FALSE,FALSE,FALSE,0.62,"young",34,161,56,"f"
18,"LOWER BACK",1,"Ecc02",1620,1640,1600,1550,1630,1575,0.034,55,1602.5,"Ecc",-20,50,FALSE,FALSE,FALSE,3.49,"young",34,161,56,"f"
18,"LOWER BACK",1,"Ecc03",1680,1680,1700,1600,1680,1650,0.018,30,1665,"Ecc",0,100,FALSE,FALSE,FALSE,1.82,"young",34,161,56,"f"
18,"LOWER BACK",1,"Ecc04",1680,1680,1650,1600,1680,1625,0.033,55,1652.5,"Ecc",0,50,FALSE,FALSE,FALSE,3.38,"young",34,161,56,"f"
18,"LOWER BACK",1,"Ecc05",1740,1740,1700,1700,1740,1700,0.023,40,1720,"Ecc",0,0,FALSE,FALSE,FALSE,2.35,"young",34,161,56,"f"
18,"LOWER BACK",1,"Ecc06",1680,1700,1600,1650,1690,1625,0.038,65,1657.5,"Ecc",-20,-50,FALSE,FALSE,FALSE,4,"young",34,161,56,"f"
18,"LOWER BACK",1,"Ecc07",1660,1660,1550,1600,1660,1575,0.051,85,1617.5,"Ecc",0,-50,FALSE,FALSE,FALSE,5.4,"young",34,161,56,"f"
18,"LOWER BACK",1,"Ecc08",1680,1680,1550,1650,1680,1600,0.048,80,1640,"Ecc",0,-100,FALSE,FALSE,FALSE,5,"young",34,161,56,"f"
18,"LOWER BACK",1,"Ecc09",1580,1580,1450,1450,1580,1450,0.082,130,1515,"Ecc",0,0,FALSE,FALSE,FALSE,8.97,"young",34,161,56,"f"
18,"LOWER BACK",1,"Ecc10",1840,1860,1800,1850,1850,1825,0.014,25,1837.5,"Ecc",-20,-50,FALSE,FALSE,FALSE,1.37,"young",34,161,56,"f"
18,"LOWER BACK",2,"Ecc01",1940,1920,1900,1900,1930,1900,0.016,30,1915,"Ecc",20,0,FALSE,FALSE,FALSE,1.58,"young",34,161,56,"f"
18,"LOWER BACK",2,"Ecc02",1600,1600,1550,1500,1600,1525,0.047,75,1562.5,"Ecc",0,50,FALSE,FALSE,FALSE,4.92,"young",34,161,56,"f"
18,"LOWER BACK",2,"Ecc03",1520,1520,1500,1500,1520,1500,0.013,20,1510,"Ecc",0,0,FALSE,FALSE,FALSE,1.33,"young",34,161,56,"f"
18,"LOWER BACK",2,"Ecc04",1520,1500,1500,1500,1510,1500,0.007,10,1505,"Ecc",20,0,FALSE,FALSE,FALSE,0.67,"young",34,161,56,"f"
18,"LOWER BACK",2,"Ecc05",1620,1600,1550,1550,1610,1550,0.037,60,1580,"Ecc",20,0,FALSE,FALSE,FALSE,3.87,"young",34,161,56,"f"
18,"LOWER BACK",2,"Ecc06",1520,1500,1450,1500,1510,1475,0.023,35,1492.5,"Ecc",20,-50,FALSE,FALSE,FALSE,2.37,"young",34,161,56,"f"
18,"LOWER BACK",2,"Ecc07",1460,1440,1400,1400,1450,1400,0.034,50,1425,"Ecc",20,0,FALSE,FALSE,FALSE,3.57,"young",34,161,56,"f"
18,"LOWER BACK",2,"Ecc08",1480,1460,1350,1400,1470,1375,0.065,95,1422.5,"Ecc",20,-50,FALSE,FALSE,FALSE,6.91,"young",34,161,56,"f"
18,"LOWER BACK",2,"Ecc09",1460,1440,1300,1300,1450,1300,0.103,150,1375,"Ecc",20,0,FALSE,FALSE,FALSE,11.54,"young",34,161,56,"f"
18,"LOWER BACK",2,"Ecc10",1800,1800,1800,1800,1800,1800,0,0,1800,"Ecc",0,0,FALSE,FALSE,FALSE,0,"young",34,161,56,"f"
18,"LOWER BACK",1,"Rep01",2700,2720,2800,2750,2710,2775,0.024,-65,2742.5,"Rep",-20,50,FALSE,FALSE,FALSE,2.34,"young",34,161,56,"f"
18,"LOWER BACK",1,"Rep02",2600,2600,2600,2550,2600,2575,0.01,25,2587.5,"Rep",0,50,FALSE,FALSE,FALSE,0.97,"young",34,161,56,"f"
18,"LOWER BACK",1,"Rep03",2900,2880,2900,2900,2890,2900,0.003,-10,2895,"Rep",20,0,FALSE,FALSE,FALSE,0.34,"young",34,161,56,"f"
18,"LOWER BACK",1,"Rep04",2760,2780,2750,2750,2770,2750,0.007,20,2760,"Rep",-20,0,FALSE,FALSE,FALSE,0.73,"young",34,161,56,"f"
18,"LOWER BACK",1,"Rep05",2820,2820,2800,2850,2820,2825,0.002,-5,2822.5,"Rep",0,-50,FALSE,FALSE,FALSE,0.18,"young",34,161,56,"f"
18,"LOWER BACK",1,"Rep06",2860,2860,2850,2850,2860,2850,0.003,10,2855,"Rep",0,0,FALSE,FALSE,FALSE,0.35,"young",34,161,56,"f"
18,"LOWER BACK",1,"Rep07",2820,2820,2800,2800,2820,2800,0.007,20,2810,"Rep",0,0,FALSE,FALSE,FALSE,0.71,"young",34,161,56,"f"
18,"LOWER BACK",1,"Rep08",2820,2820,2800,2850,2820,2825,0.002,-5,2822.5,"Rep",0,-50,FALSE,FALSE,FALSE,0.18,"young",34,161,56,"f"
18,"LOWER BACK",1,"Rep09",2720,2720,2700,2650,2720,2675,0.017,45,2697.5,"Rep",0,50,FALSE,FALSE,FALSE,1.68,"young",34,161,56,"f"
18,"LOWER BACK",1,"Rep10",3100,3120,3250,3250,3110,3250,0.045,-140,3180,"Rep",-20,0,TRUE,FALSE,FALSE,4.31,"young",34,161,56,"f"
18,"LOWER BACK",2,"Rep01",2820,2860,2950,2950,2840,2950,0.039,-110,2895,"Rep",-40,0,TRUE,FALSE,FALSE,3.73,"young",34,161,56,"f"
18,"LOWER BACK",2,"Rep02",2540,2560,2550,2500,2550,2525,0.01,25,2537.5,"Rep",-20,50,FALSE,FALSE,FALSE,0.99,"young",34,161,56,"f"
18,"LOWER BACK",2,"Rep03",2580,2560,2550,2600,2570,2575,0.002,-5,2572.5,"Rep",20,-50,FALSE,FALSE,FALSE,0.19,"young",34,161,56,"f"
18,"LOWER BACK",2,"Rep04",2640,2640,2650,2650,2640,2650,0.004,-10,2645,"Rep",0,0,FALSE,FALSE,FALSE,0.38,"young",34,161,56,"f"
18,"LOWER BACK",2,"Rep05",2780,2780,2750,2750,2780,2750,0.011,30,2765,"Rep",0,0,FALSE,FALSE,FALSE,1.09,"young",34,161,56,"f"
18,"LOWER BACK",2,"Rep06",2640,2640,2650,2650,2640,2650,0.004,-10,2645,"Rep",0,0,FALSE,FALSE,FALSE,0.38,"young",34,161,56,"f"
18,"LOWER BACK",2,"Rep07",2560,2560,2550,2550,2560,2550,0.004,10,2555,"Rep",0,0,FALSE,FALSE,FALSE,0.39,"young",34,161,56,"f"
18,"LOWER BACK",2,"Rep08",2580,2580,2550,2550,2580,2550,0.012,30,2565,"Rep",0,0,FALSE,FALSE,FALSE,1.18,"young",34,161,56,"f"
18,"LOWER BACK",2,"Rep09",2620,2640,2600,2600,2630,2600,0.011,30,2615,"Rep",-20,0,FALSE,FALSE,FALSE,1.15,"young",34,161,56,"f"
18,"LOWER BACK",2,"Rep10",2960,2960,3100,3100,2960,3100,0.047,-140,3030,"Rep",0,0,TRUE,FALSE,FALSE,4.52,"young",34,161,56,"f"
18,"LOWER BACK",1,"TuT",28100,28140,28250,28200,28120,28225,0.004,-105,28172.5,"TuT",-40,50,FALSE,FALSE,FALSE,0.37,"young",34,161,56,"f"
18,"LOWER BACK",2,"TuT",26720,26780,26900,26900,26750,26900,0.006,-150,26825,"TuT",-60,0,FALSE,FALSE,FALSE,0.56,"young",34,161,56,"f"
18,"TOTAL ABDOMINAL",1,"Con01",920,920,1100,1000,920,1050,0.141,-130,985,"Con",0,100,FALSE,FALSE,FALSE,12.38,"young",34,161,56,"f"
18,"TOTAL ABDOMINAL",1,"Con02",900,900,900,950,900,925,0.028,-25,912.5,"Con",0,-50,FALSE,FALSE,FALSE,2.7,"young",34,161,56,"f"
18,"TOTAL ABDOMINAL",1,"Con03",1000,1000,1000,1050,1000,1025,0.025,-25,1012.5,"Con",0,-50,FALSE,FALSE,FALSE,2.44,"young",34,161,56,"f"
18,"TOTAL ABDOMINAL",1,"Con04",980,960,1000,1050,970,1025,0.057,-55,997.5,"Con",20,-50,FALSE,FALSE,FALSE,5.37,"young",34,161,56,"f"
18,"TOTAL ABDOMINAL",1,"Con05",1000,1000,1000,1000,1000,1000,0,0,1000,"Con",0,0,FALSE,FALSE,FALSE,0,"young",34,161,56,"f"
18,"TOTAL ABDOMINAL",1,"Con06",980,940,1050,1050,960,1050,0.094,-90,1005,"Con",40,0,FALSE,TRUE,FALSE,8.57,"young",34,161,56,"f"
18,"TOTAL ABDOMINAL",1,"Con07",920,940,1050,1000,930,1025,0.102,-95,977.5,"Con",-20,50,FALSE,FALSE,FALSE,9.27,"young",34,161,56,"f"
18,"TOTAL ABDOMINAL",1,"Con08",940,940,1050,1000,940,1025,0.09,-85,982.5,"Con",0,50,FALSE,FALSE,FALSE,8.29,"young",34,161,56,"f"
18,"TOTAL ABDOMINAL",1,"Con09",920,920,1050,1000,920,1025,0.114,-105,972.5,"Con",0,50,FALSE,FALSE,FALSE,10.24,"young",34,161,56,"f"
18,"TOTAL ABDOMINAL",1,"Con10",960,960,1050,1100,960,1075,0.12,-115,1017.5,"Con",0,-50,FALSE,FALSE,FALSE,10.7,"young",34,161,56,"f"
18,"TOTAL ABDOMINAL",2,"Con01",980,1000,1950,1050,990,1500,0.515,-510,1245,"Con",-20,900,TRUE,FALSE,TRUE,34,"young",34,161,56,"f"
18,"TOTAL ABDOMINAL",2,"Con02",1020,1060,1000,1100,1040,1050,0.01,-10,1045,"Con",-40,-100,FALSE,TRUE,FALSE,0.95,"young",34,161,56,"f"
18,"TOTAL ABDOMINAL",2,"Con03",980,960,950,1000,970,975,0.005,-5,972.5,"Con",20,-50,FALSE,FALSE,FALSE,0.51,"young",34,161,56,"f"
18,"TOTAL ABDOMINAL",2,"Con04",980,980,1000,1050,980,1025,0.046,-45,1002.5,"Con",0,-50,FALSE,FALSE,FALSE,4.39,"young",34,161,56,"f"
18,"TOTAL ABDOMINAL",2,"Con05",920,920,1000,950,920,975,0.06,-55,947.5,"Con",0,50,FALSE,FALSE,FALSE,5.64,"young",34,161,56,"f"
18,"TOTAL ABDOMINAL",2,"Con06",900,940,1000,950,920,975,0.06,-55,947.5,"Con",-40,50,FALSE,TRUE,FALSE,5.64,"young",34,161,56,"f"
18,"TOTAL ABDOMINAL",2,"Con07",920,940,1050,1000,930,1025,0.102,-95,977.5,"Con",-20,50,FALSE,FALSE,FALSE,9.27,"young",34,161,56,"f"
18,"TOTAL ABDOMINAL",2,"Con08",960,960,1100,1050,960,1075,0.12,-115,1017.5,"Con",0,50,FALSE,FALSE,FALSE,10.7,"young",34,161,56,"f"
18,"TOTAL ABDOMINAL",2,"Con09",880,860,1000,1000,870,1000,0.149,-130,935,"Con",20,0,FALSE,FALSE,FALSE,13,"young",34,161,56,"f"
18,"TOTAL ABDOMINAL",2,"Con10",1100,1120,1200,1250,1110,1225,0.104,-115,1167.5,"Con",-20,-50,FALSE,FALSE,FALSE,9.39,"young",34,161,56,"f"
18,"TOTAL ABDOMINAL",1,"Ecc01",1320,1320,1300,1300,1320,1300,0.015,20,1310,"Ecc",0,0,FALSE,FALSE,FALSE,1.54,"young",34,161,56,"f"
18,"TOTAL ABDOMINAL",1,"Ecc02",1440,1440,1450,1400,1440,1425,0.01,15,1432.5,"Ecc",0,50,FALSE,FALSE,FALSE,1.05,"young",34,161,56,"f"
18,"TOTAL ABDOMINAL",1,"Ecc03",1380,1400,1350,1300,1390,1325,0.047,65,1357.5,"Ecc",-20,50,FALSE,FALSE,FALSE,4.91,"young",34,161,56,"f"
18,"TOTAL ABDOMINAL",1,"Ecc04",1440,1420,1450,1400,1430,1425,0.003,5,1427.5,"Ecc",20,50,FALSE,FALSE,FALSE,0.35,"young",34,161,56,"f"
18,"TOTAL ABDOMINAL",1,"Ecc05",1420,1460,1350,1400,1440,1375,0.045,65,1407.5,"Ecc",-40,-50,FALSE,TRUE,FALSE,4.73,"young",34,161,56,"f"
18,"TOTAL ABDOMINAL",1,"Ecc06",1440,1460,1350,1350,1450,1350,0.069,100,1400,"Ecc",-20,0,FALSE,FALSE,FALSE,7.41,"young",34,161,56,"f"
18,"TOTAL ABDOMINAL",1,"Ecc07",1400,1380,1300,1350,1390,1325,0.047,65,1357.5,"Ecc",20,-50,FALSE,FALSE,FALSE,4.91,"young",34,161,56,"f"
18,"TOTAL ABDOMINAL",1,"Ecc08",1400,1400,1250,1300,1400,1275,0.089,125,1337.5,"Ecc",0,-50,FALSE,FALSE,FALSE,9.8,"young",34,161,56,"f"
18,"TOTAL ABDOMINAL",1,"Ecc09",1400,1400,1300,1300,1400,1300,0.071,100,1350,"Ecc",0,0,FALSE,FALSE,FALSE,7.69,"young",34,161,56,"f"
18,"TOTAL ABDOMINAL",1,"Ecc10",1680,1680,1750,1500,1680,1625,0.033,55,1652.5,"Ecc",0,250,FALSE,FALSE,TRUE,3.38,"young",34,161,56,"f"
18,"TOTAL ABDOMINAL",2,"Ecc01",1480,1440,1450,1450,1460,1450,0.007,10,1455,"Ecc",40,0,FALSE,TRUE,FALSE,0.69,"young",34,161,56,"f"
18,"TOTAL ABDOMINAL",2,"Ecc02",1620,1640,1700,1550,1630,1625,0.003,5,1627.5,"Ecc",-20,150,FALSE,FALSE,FALSE,0.31,"young",34,161,56,"f"
18,"TOTAL ABDOMINAL",2,"Ecc03",1540,1540,1500,1500,1540,1500,0.026,40,1520,"Ecc",0,0,FALSE,FALSE,FALSE,2.67,"young",34,161,56,"f"
18,"TOTAL ABDOMINAL",2,"Ecc04",1560,1560,1500,1500,1560,1500,0.038,60,1530,"Ecc",0,0,FALSE,FALSE,FALSE,4,"young",34,161,56,"f"
18,"TOTAL ABDOMINAL",2,"Ecc05",1540,1520,1450,1500,1530,1475,0.036,55,1502.5,"Ecc",20,-50,FALSE,FALSE,FALSE,3.73,"young",34,161,56,"f"
18,"TOTAL ABDOMINAL",2,"Ecc06",1520,1480,1400,1450,1500,1425,0.05,75,1462.5,"Ecc",40,-50,FALSE,TRUE,FALSE,5.26,"young",34,161,56,"f"
18,"TOTAL ABDOMINAL",2,"Ecc07",1380,1380,1250,1300,1380,1275,0.076,105,1327.5,"Ecc",0,-50,FALSE,FALSE,FALSE,8.24,"young",34,161,56,"f"
18,"TOTAL ABDOMINAL",2,"Ecc08",1400,1420,1250,1300,1410,1275,0.096,135,1342.5,"Ecc",-20,-50,FALSE,FALSE,FALSE,10.59,"young",34,161,56,"f"
18,"TOTAL ABDOMINAL",2,"Ecc09",1480,1480,1400,1350,1480,1375,0.071,105,1427.5,"Ecc",0,50,FALSE,FALSE,FALSE,7.64,"young",34,161,56,"f"
18,"TOTAL ABDOMINAL",2,"Ecc10",2340,2360,2150,2150,2350,2150,0.085,200,2250,"Ecc",-20,0,TRUE,FALSE,FALSE,9.3,"young",34,161,56,"f"
18,"TOTAL ABDOMINAL",1,"Rep01",2240,2240,2400,2300,2240,2350,0.049,-110,2295,"Rep",0,100,FALSE,FALSE,FALSE,4.68,"young",34,161,56,"f"
18,"TOTAL ABDOMINAL",1,"Rep02",2340,2340,2350,2350,2340,2350,0.004,-10,2345,"Rep",0,0,FALSE,FALSE,FALSE,0.43,"young",34,161,56,"f"
18,"TOTAL ABDOMINAL",1,"Rep03",2380,2400,2350,2350,2390,2350,0.017,40,2370,"Rep",-20,0,FALSE,FALSE,FALSE,1.7,"young",34,161,56,"f"
18,"TOTAL ABDOMINAL",1,"Rep04",2420,2380,2450,2450,2400,2450,0.021,-50,2425,"Rep",40,0,FALSE,FALSE,FALSE,2.04,"young",34,161,56,"f"
18,"TOTAL ABDOMINAL",1,"Rep05",2420,2460,2350,2400,2440,2375,0.027,65,2407.5,"Rep",-40,-50,FALSE,FALSE,FALSE,2.74,"young",34,161,56,"f"
18,"TOTAL ABDOMINAL",1,"Rep06",2420,2400,2400,2400,2410,2400,0.004,10,2405,"Rep",20,0,FALSE,FALSE,FALSE,0.42,"young",34,161,56,"f"
18,"TOTAL ABDOMINAL",1,"Rep07",2320,2320,2350,2350,2320,2350,0.013,-30,2335,"Rep",0,0,FALSE,FALSE,FALSE,1.28,"young",34,161,56,"f"
18,"TOTAL ABDOMINAL",1,"Rep08",2340,2340,2300,2300,2340,2300,0.017,40,2320,"Rep",0,0,FALSE,FALSE,FALSE,1.74,"young",34,161,56,"f"
18,"TOTAL ABDOMINAL",1,"Rep09",2320,2320,2350,2300,2320,2325,0.002,-5,2322.5,"Rep",0,50,FALSE,FALSE,FALSE,0.22,"young",34,161,56,"f"
18,"TOTAL ABDOMINAL",1,"Rep10",2640,2640,2800,2600,2640,2700,0.023,-60,2670,"Rep",0,200,FALSE,FALSE,TRUE,2.22,"young",34,161,56,"f"
18,"TOTAL ABDOMINAL",2,"Rep01",2460,2440,3400,2500,2450,2950,0.204,-500,2700,"Rep",20,900,TRUE,FALSE,TRUE,16.95,"young",34,161,56,"f"
18,"TOTAL ABDOMINAL",2,"Rep02",2640,2700,2700,2650,2670,2675,0.002,-5,2672.5,"Rep",-60,50,FALSE,FALSE,FALSE,0.19,"young",34,161,56,"f"
18,"TOTAL ABDOMINAL",2,"Rep03",2520,2500,2450,2500,2510,2475,0.014,35,2492.5,"Rep",20,-50,FALSE,FALSE,FALSE,1.41,"young",34,161,56,"f"
18,"TOTAL ABDOMINAL",2,"Rep04",2540,2540,2500,2550,2540,2525,0.006,15,2532.5,"Rep",0,-50,FALSE,FALSE,FALSE,0.59,"young",34,161,56,"f"
18,"TOTAL ABDOMINAL",2,"Rep05",2460,2440,2450,2450,2450,2450,0,0,2450,"Rep",20,0,FALSE,FALSE,FALSE,0,"young",34,161,56,"f"
18,"TOTAL ABDOMINAL",2,"Rep06",2420,2420,2400,2400,2420,2400,0.008,20,2410,"Rep",0,0,FALSE,FALSE,FALSE,0.83,"young",34,161,56,"f"
18,"TOTAL ABDOMINAL",2,"Rep07",2300,2320,2300,2300,2310,2300,0.004,10,2305,"Rep",-20,0,FALSE,FALSE,FALSE,0.43,"young",34,161,56,"f"
18,"TOTAL ABDOMINAL",2,"Rep08",2360,2380,2350,2350,2370,2350,0.008,20,2360,"Rep",-20,0,FALSE,FALSE,FALSE,0.85,"young",34,161,56,"f"
18,"TOTAL ABDOMINAL",2,"Rep09",2360,2340,2400,2350,2350,2375,0.011,-25,2362.5,"Rep",20,50,FALSE,FALSE,FALSE,1.05,"young",34,161,56,"f"
18,"TOTAL ABDOMINAL",2,"Rep10",3440,3480,3350,3400,3460,3375,0.025,85,3417.5,"Rep",-40,-50,FALSE,FALSE,FALSE,2.52,"young",34,161,56,"f"
18,"TOTAL ABDOMINAL",1,"TuT",23840,23840,24100,23800,23840,23950,0.005,-110,23895,"TuT",0,300,FALSE,FALSE,FALSE,0.46,"young",34,161,56,"f"
18,"TOTAL ABDOMINAL",2,"TuT",25500,25560,26300,25450,25530,25875,0.014,-345,25702.5,"TuT",-60,850,TRUE,TRUE,TRUE,1.33,"young",34,161,56,"f"
18,"VERTICAL TRACTION",1,"Con01",1340,1300,4350,2050,1320,3200,1.424,-1880,2260,"Con",40,2300,TRUE,FALSE,TRUE,58.75,"young",34,161,56,"f"
18,"VERTICAL TRACTION",1,"Con02",1180,1180,1300,1400,1180,1350,0.144,-170,1265,"Con",0,-100,FALSE,FALSE,FALSE,12.59,"young",34,161,56,"f"
18,"VERTICAL TRACTION",1,"Con03",1280,1300,1400,1450,1290,1425,0.105,-135,1357.5,"Con",-20,-50,FALSE,FALSE,FALSE,9.47,"young",34,161,56,"f"
18,"VERTICAL TRACTION",1,"Con04",1220,1220,1300,1350,1220,1325,0.086,-105,1272.5,"Con",0,-50,FALSE,FALSE,FALSE,7.92,"young",34,161,56,"f"
18,"VERTICAL TRACTION",1,"Con05",1320,1280,1300,1400,1300,1350,0.038,-50,1325,"Con",40,-100,FALSE,FALSE,FALSE,3.7,"young",34,161,56,"f"
18,"VERTICAL TRACTION",1,"Con06",1260,1240,1350,1350,1250,1350,0.08,-100,1300,"Con",20,0,FALSE,FALSE,FALSE,7.41,"young",34,161,56,"f"
18,"VERTICAL TRACTION",1,"Con07",1160,1140,1250,1250,1150,1250,0.087,-100,1200,"Con",20,0,FALSE,FALSE,FALSE,8,"young",34,161,56,"f"
18,"VERTICAL TRACTION",1,"Con08",1140,1140,1200,1100,1140,1150,0.009,-10,1145,"Con",0,100,FALSE,FALSE,FALSE,0.87,"young",34,161,56,"f"
18,"VERTICAL TRACTION",1,"Con09",1160,1140,1200,1150,1150,1175,0.022,-25,1162.5,"Con",20,50,FALSE,FALSE,FALSE,2.13,"young",34,161,56,"f"
18,"VERTICAL TRACTION",1,"Con10",1180,1180,1250,1200,1180,1225,0.038,-45,1202.5,"Con",0,50,FALSE,FALSE,FALSE,3.67,"young",34,161,56,"f"
18,"VERTICAL TRACTION",2,"Con01",1340,1340,4550,1350,1340,2950,1.201,-1610,2145,"Con",0,3200,TRUE,FALSE,TRUE,54.58,"young",34,161,56,"f"
18,"VERTICAL TRACTION",2,"Con02",1200,1160,1300,1250,1180,1275,0.081,-95,1227.5,"Con",40,50,FALSE,FALSE,FALSE,7.45,"young",34,161,56,"f"
18,"VERTICAL TRACTION",2,"Con03",1200,1180,1300,1250,1190,1275,0.071,-85,1232.5,"Con",20,50,FALSE,FALSE,FALSE,6.67,"young",34,161,56,"f"
18,"VERTICAL TRACTION",2,"Con04",1160,1160,1250,1250,1160,1250,0.078,-90,1205,"Con",0,0,FALSE,FALSE,FALSE,7.2,"young",34,161,56,"f"
18,"VERTICAL TRACTION",2,"Con05",1140,1140,1200,1200,1140,1200,0.053,-60,1170,"Con",0,0,FALSE,FALSE,FALSE,5,"young",34,161,56,"f"
18,"VERTICAL TRACTION",2,"Con06",1200,1180,1300,1250,1190,1275,0.071,-85,1232.5,"Con",20,50,FALSE,FALSE,FALSE,6.67,"young",34,161,56,"f"
18,"VERTICAL TRACTION",2,"Con07",1160,1140,1200,1200,1150,1200,0.043,-50,1175,"Con",20,0,FALSE,FALSE,FALSE,4.17,"young",34,161,56,"f"
18,"VERTICAL TRACTION",2,"Con08",1060,1060,1100,1200,1060,1150,0.085,-90,1105,"Con",0,-100,FALSE,FALSE,FALSE,7.83,"young",34,161,56,"f"
18,"VERTICAL TRACTION",2,"Con09",1240,1220,1250,1300,1230,1275,0.037,-45,1252.5,"Con",20,-50,FALSE,FALSE,FALSE,3.53,"young",34,161,56,"f"
18,"VERTICAL TRACTION",2,"Con10",1320,1320,1350,1350,1320,1350,0.023,-30,1335,"Con",0,0,FALSE,FALSE,FALSE,2.22,"young",34,161,56,"f"
18,"VERTICAL TRACTION",1,"Ecc01",2000,2020,1900,1850,2010,1875,0.067,135,1942.5,"Ecc",-20,50,FALSE,FALSE,FALSE,7.2,"young",34,161,56,"f"
18,"VERTICAL TRACTION",1,"Ecc02",1960,1960,1850,1750,1960,1800,0.082,160,1880,"Ecc",0,100,FALSE,FALSE,FALSE,8.89,"young",34,161,56,"f"
18,"VERTICAL TRACTION",1,"Ecc03",1800,1780,1700,1650,1790,1675,0.064,115,1732.5,"Ecc",20,50,FALSE,FALSE,FALSE,6.87,"young",34,161,56,"f"
18,"VERTICAL TRACTION",1,"Ecc04",1760,1800,1750,1700,1780,1725,0.031,55,1752.5,"Ecc",-40,50,FALSE,FALSE,FALSE,3.19,"young",34,161,56,"f"
18,"VERTICAL TRACTION",1,"Ecc05",1780,1800,1750,1700,1790,1725,0.036,65,1757.5,"Ecc",-20,50,FALSE,FALSE,FALSE,3.77,"young",34,161,56,"f"
18,"VERTICAL TRACTION",1,"Ecc06",1740,1780,1650,1650,1760,1650,0.062,110,1705,"Ecc",-40,0,FALSE,FALSE,FALSE,6.67,"young",34,161,56,"f"
18,"VERTICAL TRACTION",1,"Ecc07",1840,1800,1750,1800,1820,1775,0.025,45,1797.5,"Ecc",40,-50,FALSE,FALSE,FALSE,2.54,"young",34,161,56,"f"
18,"VERTICAL TRACTION",1,"Ecc08",1680,1720,1650,1750,1700,1700,0,0,1700,"Ecc",-40,-100,FALSE,FALSE,FALSE,0,"young",34,161,56,"f"
18,"VERTICAL TRACTION",1,"Ecc09",1780,1760,1700,1750,1770,1725,0.025,45,1747.5,"Ecc",20,-50,FALSE,FALSE,FALSE,2.61,"young",34,161,56,"f"
18,"VERTICAL TRACTION",1,"Ecc10",2460,2480,2500,2500,2470,2500,0.012,-30,2485,"Ecc",-20,0,FALSE,FALSE,FALSE,1.2,"young",34,161,56,"f"
18,"VERTICAL TRACTION",2,"Ecc01",1820,1840,1700,1750,1830,1725,0.057,105,1777.5,"Ecc",-20,-50,FALSE,FALSE,FALSE,6.09,"young",34,161,56,"f"
18,"VERTICAL TRACTION",2,"Ecc02",1600,1620,1500,1550,1610,1525,0.053,85,1567.5,"Ecc",-20,-50,FALSE,FALSE,FALSE,5.57,"young",34,161,56,"f"
18,"VERTICAL TRACTION",2,"Ecc03",1820,1840,1750,1750,1830,1750,0.044,80,1790,"Ecc",-20,0,FALSE,FALSE,FALSE,4.57,"young",34,161,56,"f"
18,"VERTICAL TRACTION",2,"Ecc04",1740,1740,1650,1700,1740,1675,0.037,65,1707.5,"Ecc",0,-50,FALSE,FALSE,FALSE,3.88,"young",34,161,56,"f"
18,"VERTICAL TRACTION",2,"Ecc05",1860,1880,1800,1800,1870,1800,0.037,70,1835,"Ecc",-20,0,FALSE,FALSE,FALSE,3.89,"young",34,161,56,"f"
18,"VERTICAL TRACTION",2,"Ecc06",1800,1800,1700,1750,1800,1725,0.042,75,1762.5,"Ecc",0,-50,FALSE,FALSE,FALSE,4.35,"young",34,161,56,"f"
18,"VERTICAL TRACTION",2,"Ecc07",1760,1780,1750,1650,1770,1700,0.04,70,1735,"Ecc",-20,100,FALSE,FALSE,FALSE,4.12,"young",34,161,56,"f"
18,"VERTICAL TRACTION",2,"Ecc08",1660,1680,1650,1600,1670,1625,0.027,45,1647.5,"Ecc",-20,50,FALSE,FALSE,FALSE,2.77,"young",34,161,56,"f"
18,"VERTICAL TRACTION",2,"Ecc09",1600,1600,1600,1550,1600,1575,0.016,25,1587.5,"Ecc",0,50,FALSE,FALSE,FALSE,1.59,"young",34,161,56,"f"
18,"VERTICAL TRACTION",2,"Ecc10",1560,1560,1550,1600,1560,1575,0.01,-15,1567.5,"Ecc",0,-50,FALSE,FALSE,FALSE,0.95,"young",34,161,56,"f"
18,"VERTICAL TRACTION",1,"Rep01",3340,3320,6250,3900,3330,5075,0.524,-1745,4202.5,"Rep",20,2350,TRUE,FALSE,TRUE,34.38,"young",34,161,56,"f"
18,"VERTICAL TRACTION",1,"Rep02",3140,3140,3150,3150,3140,3150,0.003,-10,3145,"Rep",0,0,FALSE,FALSE,FALSE,0.32,"young",34,161,56,"f"
18,"VERTICAL TRACTION",1,"Rep03",3080,3080,3100,3100,3080,3100,0.006,-20,3090,"Rep",0,0,FALSE,FALSE,FALSE,0.65,"young",34,161,56,"f"
18,"VERTICAL TRACTION",1,"Rep04",2980,3020,3050,3050,3000,3050,0.017,-50,3025,"Rep",-40,0,FALSE,FALSE,FALSE,1.64,"young",34,161,56,"f"
18,"VERTICAL TRACTION",1,"Rep05",3100,3080,3050,3100,3090,3075,0.005,15,3082.5,"Rep",20,-50,FALSE,FALSE,FALSE,0.49,"young",34,161,56,"f"
18,"VERTICAL TRACTION",1,"Rep06",3000,3020,3000,3000,3010,3000,0.003,10,3005,"Rep",-20,0,FALSE,FALSE,FALSE,0.33,"young",34,161,56,"f"
18,"VERTICAL TRACTION",1,"Rep07",3000,2940,3000,3050,2970,3025,0.019,-55,2997.5,"Rep",60,-50,FALSE,FALSE,FALSE,1.82,"young",34,161,56,"f"
18,"VERTICAL TRACTION",1,"Rep08",2820,2860,2850,2850,2840,2850,0.004,-10,2845,"Rep",-40,0,FALSE,FALSE,FALSE,0.35,"young",34,161,56,"f"
18,"VERTICAL TRACTION",1,"Rep09",2940,2900,2900,2900,2920,2900,0.007,20,2910,"Rep",40,0,FALSE,FALSE,FALSE,0.69,"young",34,161,56,"f"
18,"VERTICAL TRACTION",1,"Rep10",3640,3660,3750,3700,3650,3725,0.021,-75,3687.5,"Rep",-20,50,FALSE,FALSE,FALSE,2.01,"young",34,161,56,"f"
18,"VERTICAL TRACTION",2,"Rep01",3160,3180,6250,3100,3170,4675,0.475,-1505,3922.5,"Rep",-20,3150,TRUE,FALSE,TRUE,32.19,"young",34,161,56,"f"
18,"VERTICAL TRACTION",2,"Rep02",2800,2780,2800,2800,2790,2800,0.004,-10,2795,"Rep",20,0,FALSE,FALSE,FALSE,0.36,"young",34,161,56,"f"
18,"VERTICAL TRACTION",2,"Rep03",3020,3020,3050,3000,3020,3025,0.002,-5,3022.5,"Rep",0,50,FALSE,FALSE,FALSE,0.17,"young",34,161,56,"f"
18,"VERTICAL TRACTION",2,"Rep04",2900,2900,2900,2950,2900,2925,0.009,-25,2912.5,"Rep",0,-50,FALSE,FALSE,FALSE,0.85,"young",34,161,56,"f"
18,"VERTICAL TRACTION",2,"Rep05",3000,3020,3000,3000,3010,3000,0.003,10,3005,"Rep",-20,0,FALSE,FALSE,FALSE,0.33,"young",34,161,56,"f"
18,"VERTICAL TRACTION",2,"Rep06",3000,2980,3000,3000,2990,3000,0.003,-10,2995,"Rep",20,0,FALSE,FALSE,FALSE,0.33,"young",34,161,56,"f"
18,"VERTICAL TRACTION",2,"Rep07",2920,2920,2950,2850,2920,2900,0.007,20,2910,"Rep",0,100,FALSE,FALSE,FALSE,0.69,"young",34,161,56,"f"
18,"VERTICAL TRACTION",2,"Rep08",2720,2740,2750,2800,2730,2775,0.016,-45,2752.5,"Rep",-20,-50,FALSE,FALSE,FALSE,1.62,"young",34,161,56,"f"
18,"VERTICAL TRACTION",2,"Rep09",2840,2820,2850,2850,2830,2850,0.007,-20,2840,"Rep",20,0,FALSE,FALSE,FALSE,0.7,"young",34,161,56,"f"
18,"VERTICAL TRACTION",2,"Rep10",2880,2880,2900,2950,2880,2925,0.016,-45,2902.5,"Rep",0,-50,FALSE,FALSE,FALSE,1.54,"young",34,161,56,"f"
18,"VERTICAL TRACTION",1,"TuT",31040,31020,34100,31800,31030,32950,0.062,-1920,31990,"TuT",20,2300,FALSE,FALSE,TRUE,5.83,"young",34,161,56,"f"
18,"VERTICAL TRACTION",2,"TuT",29240,29240,32450,29300,29240,30875,0.056,-1635,30057.5,"TuT",0,3150,FALSE,FALSE,TRUE,5.3,"young",34,161,56,"f"
18,"CHEST PRESS",1,"Con01",1280,1280,2500,1350,1280,1925,0.504,-645,1602.5,"Con",0,1150,TRUE,FALSE,TRUE,33.51,"young",34,161,56,"f"
18,"CHEST PRESS",1,"Con02",980,960,1000,1100,970,1050,0.082,-80,1010,"Con",20,-100,FALSE,FALSE,FALSE,7.62,"young",34,161,56,"f"
18,"CHEST PRESS",1,"Con03",940,940,1050,1050,940,1050,0.117,-110,995,"Con",0,0,FALSE,FALSE,FALSE,10.48,"young",34,161,56,"f"
18,"CHEST PRESS",1,"Con04",1080,1060,1100,1100,1070,1100,0.028,-30,1085,"Con",20,0,FALSE,FALSE,FALSE,2.73,"young",34,161,56,"f"
18,"CHEST PRESS",1,"Con05",940,920,1000,1100,930,1050,0.129,-120,990,"Con",20,-100,FALSE,FALSE,FALSE,11.43,"young",34,161,56,"f"
18,"CHEST PRESS",1,"Con06",960,960,1050,1050,960,1050,0.094,-90,1005,"Con",0,0,FALSE,FALSE,FALSE,8.57,"young",34,161,56,"f"
18,"CHEST PRESS",1,"Con07",1000,1020,1150,1100,1010,1125,0.114,-115,1067.5,"Con",-20,50,FALSE,FALSE,FALSE,10.22,"young",34,161,56,"f"
18,"CHEST PRESS",1,"Con08",980,980,1100,1100,980,1100,0.122,-120,1040,"Con",0,0,FALSE,FALSE,FALSE,10.91,"young",34,161,56,"f"
18,"CHEST PRESS",1,"Con09",1020,980,1200,1150,1000,1175,0.175,-175,1087.5,"Con",40,50,FALSE,TRUE,FALSE,14.89,"young",34,161,56,"f"
18,"CHEST PRESS",1,"Con10",1240,1260,1500,1400,1250,1450,0.16,-200,1350,"Con",-20,100,FALSE,FALSE,FALSE,13.79,"young",34,161,56,"f"
18,"CHEST PRESS",2,"Con01",1280,1260,1400,1400,1270,1400,0.102,-130,1335,"Con",20,0,FALSE,FALSE,FALSE,9.29,"young",34,161,56,"f"
18,"CHEST PRESS",2,"Con02",920,940,1100,1000,930,1050,0.129,-120,990,"Con",-20,100,FALSE,FALSE,FALSE,11.43,"young",34,161,56,"f"
18,"CHEST PRESS",2,"Con03",1040,1020,1150,1150,1030,1150,0.117,-120,1090,"Con",20,0,FALSE,FALSE,FALSE,10.43,"young",34,161,56,"f"
18,"CHEST PRESS",2,"Con04",1000,980,1150,1150,990,1150,0.162,-160,1070,"Con",20,0,FALSE,FALSE,FALSE,13.91,"young",34,161,56,"f"
18,"CHEST PRESS",2,"Con05",1020,1040,1200,1200,1030,1200,0.165,-170,1115,"Con",-20,0,FALSE,FALSE,FALSE,14.17,"young",34,161,56,"f"
18,"CHEST PRESS",2,"Con06",1000,1000,1150,1200,1000,1175,0.175,-175,1087.5,"Con",0,-50,FALSE,FALSE,FALSE,14.89,"young",34,161,56,"f"
18,"CHEST PRESS",2,"Con07",1080,1060,1200,1200,1070,1200,0.121,-130,1135,"Con",20,0,FALSE,FALSE,FALSE,10.83,"young",34,161,56,"f"
18,"CHEST PRESS",2,"Con08",1000,980,1050,1100,990,1075,0.086,-85,1032.5,"Con",20,-50,FALSE,FALSE,FALSE,7.91,"young",34,161,56,"f"
18,"CHEST PRESS",2,"Con09",960,960,900,1000,960,950,0.01,10,955,"Con",0,-100,FALSE,FALSE,FALSE,1.05,"young",34,161,56,"f"
18,"CHEST PRESS",2,"Con10",1160,1160,1100,1100,1160,1100,0.052,60,1130,"Con",0,0,FALSE,FALSE,FALSE,5.45,"young",34,161,56,"f"
18,"CHEST PRESS",1,"Ecc01",2060,2060,2000,1950,2060,1975,0.041,85,2017.5,"Ecc",0,50,FALSE,FALSE,FALSE,4.3,"young",34,161,56,"f"
18,"CHEST PRESS",1,"Ecc02",1600,1620,1550,1450,1610,1500,0.068,110,1555,"Ecc",-20,100,FALSE,FALSE,FALSE,7.33,"young",34,161,56,"f"
18,"CHEST PRESS",1,"Ecc03",1740,1740,1700,1700,1740,1700,0.023,40,1720,"Ecc",0,0,FALSE,FALSE,FALSE,2.35,"young",34,161,56,"f"
18,"CHEST PRESS",1,"Ecc04",1660,1680,1600,1550,1670,1575,0.057,95,1622.5,"Ecc",-20,50,FALSE,FALSE,FALSE,6.03,"young",34,161,56,"f"
18,"CHEST PRESS",1,"Ecc05",1620,1640,1550,1500,1630,1525,0.064,105,1577.5,"Ecc",-20,50,FALSE,FALSE,FALSE,6.89,"young",34,161,56,"f"
18,"CHEST PRESS",1,"Ecc06",1580,1580,1450,1500,1580,1475,0.066,105,1527.5,"Ecc",0,-50,FALSE,FALSE,FALSE,7.12,"young",34,161,56,"f"
18,"CHEST PRESS",1,"Ecc07",1580,1560,1450,1450,1570,1450,0.076,120,1510,"Ecc",20,0,FALSE,FALSE,FALSE,8.28,"young",34,161,56,"f"
18,"CHEST PRESS",1,"Ecc08",1540,1560,1400,1450,1550,1425,0.081,125,1487.5,"Ecc",-20,-50,FALSE,FALSE,FALSE,8.77,"young",34,161,56,"f"
18,"CHEST PRESS",1,"Ecc09",1580,1600,1400,1450,1590,1425,0.104,165,1507.5,"Ecc",-20,-50,FALSE,FALSE,FALSE,11.58,"young",34,161,56,"f"
18,"CHEST PRESS",1,"Ecc10",2520,2500,2250,2400,2510,2325,0.074,185,2417.5,"Ecc",20,-150,FALSE,FALSE,FALSE,7.96,"young",34,161,56,"f"
18,"CHEST PRESS",2,"Ecc01",1740,1740,1500,1650,1740,1575,0.095,165,1657.5,"Ecc",0,-150,FALSE,FALSE,FALSE,10.48,"young",34,161,56,"f"
18,"CHEST PRESS",2,"Ecc02",1400,1380,1250,1300,1390,1275,0.083,115,1332.5,"Ecc",20,-50,FALSE,FALSE,FALSE,9.02,"young",34,161,56,"f"
18,"CHEST PRESS",2,"Ecc03",1480,1500,1350,1350,1490,1350,0.094,140,1420,"Ecc",-20,0,FALSE,FALSE,FALSE,10.37,"young",34,161,56,"f"
18,"CHEST PRESS",2,"Ecc04",1400,1400,1250,1250,1400,1250,0.107,150,1325,"Ecc",0,0,FALSE,FALSE,FALSE,12,"young",34,161,56,"f"
18,"CHEST PRESS",2,"Ecc05",1400,1400,1250,1200,1400,1225,0.125,175,1312.5,"Ecc",0,50,FALSE,FALSE,FALSE,14.29,"young",34,161,56,"f"
18,"CHEST PRESS",2,"Ecc06",1320,1320,1150,1150,1320,1150,0.129,170,1235,"Ecc",0,0,FALSE,FALSE,FALSE,14.78,"young",34,161,56,"f"
18,"CHEST PRESS",2,"Ecc07",1400,1440,1350,1300,1420,1325,0.067,95,1372.5,"Ecc",-40,50,FALSE,TRUE,FALSE,7.17,"young",34,161,56,"f"
18,"CHEST PRESS",2,"Ecc08",1320,1320,1300,1250,1320,1275,0.034,45,1297.5,"Ecc",0,50,FALSE,FALSE,FALSE,3.53,"young",34,161,56,"f"
18,"CHEST PRESS",2,"Ecc09",1440,1440,1500,1450,1440,1475,0.024,-35,1457.5,"Ecc",0,50,FALSE,FALSE,FALSE,2.37,"young",34,161,56,"f"
18,"CHEST PRESS",2,"Ecc10",1960,1960,1900,1950,1960,1925,0.018,35,1942.5,"Ecc",0,-50,FALSE,FALSE,FALSE,1.82,"young",34,161,56,"f"
18,"CHEST PRESS",1,"Rep01",3340,3340,4500,3300,3340,3900,0.168,-560,3620,"Rep",0,1200,TRUE,FALSE,TRUE,14.36,"young",34,161,56,"f"
18,"CHEST PRESS",1,"Rep02",2580,2580,2550,2550,2580,2550,0.012,30,2565,"Rep",0,0,FALSE,FALSE,FALSE,1.18,"young",34,161,56,"f"
18,"CHEST PRESS",1,"Rep03",2680,2680,2750,2750,2680,2750,0.026,-70,2715,"Rep",0,0,FALSE,FALSE,FALSE,2.55,"young",34,161,56,"f"
18,"CHEST PRESS",1,"Rep04",2740,2740,2700,2650,2740,2675,0.024,65,2707.5,"Rep",0,50,FALSE,FALSE,FALSE,2.43,"young",34,161,56,"f"
18,"CHEST PRESS",1,"Rep05",2560,2560,2550,2600,2560,2575,0.006,-15,2567.5,"Rep",0,-50,FALSE,FALSE,FALSE,0.58,"young",34,161,56,"f"
18,"CHEST PRESS",1,"Rep06",2540,2540,2500,2550,2540,2525,0.006,15,2532.5,"Rep",0,-50,FALSE,FALSE,FALSE,0.59,"young",34,161,56,"f"
18,"CHEST PRESS",1,"Rep07",2580,2580,2600,2550,2580,2575,0.002,5,2577.5,"Rep",0,50,FALSE,FALSE,FALSE,0.19,"young",34,161,56,"f"
18,"CHEST PRESS",1,"Rep08",2520,2540,2500,2550,2530,2525,0.002,5,2527.5,"Rep",-20,-50,FALSE,FALSE,FALSE,0.2,"young",34,161,56,"f"
18,"CHEST PRESS",1,"Rep09",2600,2580,2600,2600,2590,2600,0.004,-10,2595,"Rep",20,0,FALSE,FALSE,FALSE,0.38,"young",34,161,56,"f"
18,"CHEST PRESS",1,"Rep10",3760,3760,3750,3800,3760,3775,0.004,-15,3767.5,"Rep",0,-50,FALSE,FALSE,FALSE,0.4,"young",34,161,56,"f"
18,"CHEST PRESS",2,"Rep01",3020,3000,2900,3050,3010,2975,0.012,35,2992.5,"Rep",20,-150,FALSE,FALSE,FALSE,1.18,"young",34,161,56,"f"
18,"CHEST PRESS",2,"Rep02",2320,2320,2350,2300,2320,2325,0.002,-5,2322.5,"Rep",0,50,FALSE,FALSE,FALSE,0.22,"young",34,161,56,"f"
18,"CHEST PRESS",2,"Rep03",2520,2520,2500,2500,2520,2500,0.008,20,2510,"Rep",0,0,FALSE,FALSE,FALSE,0.8,"young",34,161,56,"f"
18,"CHEST PRESS",2,"Rep04",2400,2380,2400,2400,2390,2400,0.004,-10,2395,"Rep",20,0,FALSE,FALSE,FALSE,0.42,"young",34,161,56,"f"
18,"CHEST PRESS",2,"Rep05",2420,2440,2450,2400,2430,2425,0.002,5,2427.5,"Rep",-20,50,FALSE,FALSE,FALSE,0.21,"young",34,161,56,"f"
18,"CHEST PRESS",2,"Rep06",2320,2320,2300,2350,2320,2325,0.002,-5,2322.5,"Rep",0,-50,FALSE,FALSE,FALSE,0.22,"young",34,161,56,"f"
18,"CHEST PRESS",2,"Rep07",2480,2500,2550,2500,2490,2525,0.014,-35,2507.5,"Rep",-20,50,FALSE,FALSE,FALSE,1.39,"young",34,161,56,"f"
18,"CHEST PRESS",2,"Rep08",2320,2300,2350,2350,2310,2350,0.017,-40,2330,"Rep",20,0,FALSE,FALSE,FALSE,1.7,"young",34,161,56,"f"
18,"CHEST PRESS",2,"Rep09",2400,2400,2400,2450,2400,2425,0.01,-25,2412.5,"Rep",0,-50,FALSE,FALSE,FALSE,1.03,"young",34,161,56,"f"
18,"CHEST PRESS",2,"Rep10",3120,3120,3000,3050,3120,3025,0.03,95,3072.5,"Rep",0,-50,FALSE,FALSE,FALSE,3.14,"young",34,161,56,"f"
18,"CHEST PRESS",1,"TuT",27900,27900,29000,27900,27900,28450,0.02,-550,28175,"TuT",0,1100,FALSE,FALSE,TRUE,1.93,"young",34,161,56,"f"
18,"CHEST PRESS",2,"TuT",25320,25300,25200,25350,25310,25275,0.001,35,25292.5,"TuT",20,-150,FALSE,FALSE,FALSE,0.14,"young",34,161,56,"f"
19,"LEG PRESS",1,"Con01",1320,1280,1650,1450,1300,1550,0.192,-250,1425,"Con",40,200,FALSE,FALSE,TRUE,16.13,"young",40,181,92,"m"
19,"LEG PRESS",1,"Con02",960,960,1050,950,960,1000,0.042,-40,980,"Con",0,100,FALSE,FALSE,FALSE,4,"young",40,181,92,"m"
19,"LEG PRESS",1,"Con03",980,960,950,950,970,950,0.021,20,960,"Con",20,0,FALSE,FALSE,FALSE,2.11,"young",40,181,92,"m"
19,"LEG PRESS",1,"Con04",920,920,1000,950,920,975,0.06,-55,947.5,"Con",0,50,FALSE,FALSE,FALSE,5.64,"young",40,181,92,"m"
19,"LEG PRESS",1,"Con05",860,820,900,900,840,900,0.071,-60,870,"Con",40,0,FALSE,FALSE,FALSE,6.67,"young",40,181,92,"m"
19,"LEG PRESS",1,"Con06",880,860,900,900,870,900,0.034,-30,885,"Con",20,0,FALSE,FALSE,FALSE,3.33,"young",40,181,92,"m"
19,"LEG PRESS",1,"Con07",920,920,1000,1050,920,1025,0.114,-105,972.5,"Con",0,-50,FALSE,FALSE,FALSE,10.24,"young",40,181,92,"m"
19,"LEG PRESS",1,"Con08",880,880,1000,1050,880,1025,0.165,-145,952.5,"Con",0,-50,FALSE,FALSE,FALSE,14.15,"young",40,181,92,"m"
19,"LEG PRESS",1,"Con09",960,960,1000,1100,960,1050,0.094,-90,1005,"Con",0,-100,FALSE,FALSE,FALSE,8.57,"young",40,181,92,"m"
19,"LEG PRESS",1,"Con10",1060,1040,1200,1250,1050,1225,0.167,-175,1137.5,"Con",20,-50,FALSE,FALSE,FALSE,14.29,"young",40,181,92,"m"
19,"LEG PRESS",2,"Con01",1300,1260,1400,1350,1280,1375,0.074,-95,1327.5,"Con",40,50,FALSE,FALSE,FALSE,6.91,"young",40,181,92,"m"
19,"LEG PRESS",2,"Con02",860,860,900,900,860,900,0.047,-40,880,"Con",0,0,FALSE,FALSE,FALSE,4.44,"young",40,181,92,"m"
19,"LEG PRESS",2,"Con03",780,780,900,950,780,925,0.186,-145,852.5,"Con",0,-50,FALSE,FALSE,FALSE,15.68,"young",40,181,92,"m"
19,"LEG PRESS",2,"Con04",800,800,950,950,800,950,0.188,-150,875,"Con",0,0,FALSE,FALSE,FALSE,15.79,"young",40,181,92,"m"
19,"LEG PRESS",2,"Con05",780,740,850,900,760,875,0.151,-115,817.5,"Con",40,-50,FALSE,FALSE,FALSE,13.14,"young",40,181,92,"m"
19,"LEG PRESS",2,"Con06",800,800,850,900,800,875,0.094,-75,837.5,"Con",0,-50,FALSE,FALSE,FALSE,8.57,"young",40,181,92,"m"
19,"LEG PRESS",2,"Con07",840,800,900,900,820,900,0.098,-80,860,"Con",40,0,FALSE,FALSE,FALSE,8.89,"young",40,181,92,"m"
19,"LEG PRESS",2,"Con08",900,880,900,950,890,925,0.039,-35,907.5,"Con",20,-50,FALSE,FALSE,FALSE,3.78,"young",40,181,92,"m"
19,"LEG PRESS",2,"Con09",900,880,1000,950,890,975,0.096,-85,932.5,"Con",20,50,FALSE,FALSE,FALSE,8.72,"young",40,181,92,"m"
19,"LEG PRESS",2,"Con10",1040,1000,1150,1150,1020,1150,0.127,-130,1085,"Con",40,0,FALSE,FALSE,FALSE,11.3,"young",40,181,92,"m"
19,"LEG PRESS",1,"Ecc01",1980,1980,1750,1800,1980,1775,0.104,205,1877.5,"Ecc",0,-50,FALSE,FALSE,FALSE,11.55,"young",40,181,92,"m"
19,"LEG PRESS",1,"Ecc02",1340,1360,1350,1400,1350,1375,0.019,-25,1362.5,"Ecc",-20,-50,FALSE,FALSE,FALSE,1.82,"young",40,181,92,"m"
19,"LEG PRESS",1,"Ecc03",1500,1520,1450,1500,1510,1475,0.023,35,1492.5,"Ecc",-20,-50,FALSE,FALSE,FALSE,2.37,"young",40,181,92,"m"
19,"LEG PRESS",1,"Ecc04",1460,1460,1400,1400,1460,1400,0.041,60,1430,"Ecc",0,0,FALSE,FALSE,FALSE,4.29,"young",40,181,92,"m"
19,"LEG PRESS",1,"Ecc05",1380,1400,1350,1350,1390,1350,0.029,40,1370,"Ecc",-20,0,FALSE,FALSE,FALSE,2.96,"young",40,181,92,"m"
19,"LEG PRESS",1,"Ecc06",1400,1420,1350,1300,1410,1325,0.06,85,1367.5,"Ecc",-20,50,FALSE,FALSE,FALSE,6.42,"young",40,181,92,"m"
19,"LEG PRESS",1,"Ecc07",1420,1420,1300,1250,1420,1275,0.102,145,1347.5,"Ecc",0,50,FALSE,FALSE,FALSE,11.37,"young",40,181,92,"m"
19,"LEG PRESS",1,"Ecc08",1460,1460,1400,1350,1460,1375,0.058,85,1417.5,"Ecc",0,50,FALSE,FALSE,FALSE,6.18,"young",40,181,92,"m"
19,"LEG PRESS",1,"Ecc09",1320,1340,1250,1150,1330,1200,0.098,130,1265,"Ecc",-20,100,FALSE,FALSE,FALSE,10.83,"young",40,181,92,"m"
19,"LEG PRESS",1,"Ecc10",1460,1460,1450,1450,1460,1450,0.007,10,1455,"Ecc",0,0,FALSE,FALSE,FALSE,0.69,"young",40,181,92,"m"
19,"LEG PRESS",2,"Ecc01",1480,1480,1400,1450,1480,1425,0.037,55,1452.5,"Ecc",0,-50,FALSE,FALSE,FALSE,3.86,"young",40,181,92,"m"
19,"LEG PRESS",2,"Ecc02",1240,1240,1150,1100,1240,1125,0.093,115,1182.5,"Ecc",0,50,FALSE,FALSE,FALSE,10.22,"young",40,181,92,"m"
19,"LEG PRESS",2,"Ecc03",1120,1120,1000,1000,1120,1000,0.107,120,1060,"Ecc",0,0,FALSE,FALSE,FALSE,12,"young",40,181,92,"m"
19,"LEG PRESS",2,"Ecc04",1340,1360,1250,1200,1350,1225,0.093,125,1287.5,"Ecc",-20,50,FALSE,FALSE,FALSE,10.2,"young",40,181,92,"m"
19,"LEG PRESS",2,"Ecc05",1460,1480,1400,1350,1470,1375,0.065,95,1422.5,"Ecc",-20,50,FALSE,FALSE,FALSE,6.91,"young",40,181,92,"m"
19,"LEG PRESS",2,"Ecc06",1200,1220,1100,1100,1210,1100,0.091,110,1155,"Ecc",-20,0,FALSE,FALSE,FALSE,10,"young",40,181,92,"m"
19,"LEG PRESS",2,"Ecc07",1300,1320,1300,1250,1310,1275,0.027,35,1292.5,"Ecc",-20,50,FALSE,FALSE,FALSE,2.75,"young",40,181,92,"m"
19,"LEG PRESS",2,"Ecc08",1280,1320,1250,1250,1300,1250,0.038,50,1275,"Ecc",-40,0,FALSE,FALSE,FALSE,4,"young",40,181,92,"m"
19,"LEG PRESS",2,"Ecc09",1320,1340,1200,1250,1330,1225,0.079,105,1277.5,"Ecc",-20,-50,FALSE,FALSE,FALSE,8.57,"young",40,181,92,"m"
19,"LEG PRESS",2,"Ecc10",1720,1740,1800,1750,1730,1775,0.026,-45,1752.5,"Ecc",-20,50,FALSE,FALSE,FALSE,2.54,"young",40,181,92,"m"
19,"LEG PRESS",1,"Rep01",3300,3260,3400,3250,3280,3325,0.014,-45,3302.5,"Rep",40,150,FALSE,FALSE,TRUE,1.35,"young",40,181,92,"m"
19,"LEG PRESS",1,"Rep02",2300,2320,2400,2350,2310,2375,0.028,-65,2342.5,"Rep",-20,50,FALSE,FALSE,FALSE,2.74,"young",40,181,92,"m"
19,"LEG PRESS",1,"Rep03",2480,2480,2400,2450,2480,2425,0.022,55,2452.5,"Rep",0,-50,FALSE,FALSE,FALSE,2.27,"young",40,181,92,"m"
19,"LEG PRESS",1,"Rep04",2380,2380,2400,2350,2380,2375,0.002,5,2377.5,"Rep",0,50,FALSE,FALSE,FALSE,0.21,"young",40,181,92,"m"
19,"LEG PRESS",1,"Rep05",2240,2220,2250,2250,2230,2250,0.009,-20,2240,"Rep",20,0,FALSE,FALSE,FALSE,0.89,"young",40,181,92,"m"
19,"LEG PRESS",1,"Rep06",2280,2280,2250,2200,2280,2225,0.024,55,2252.5,"Rep",0,50,FALSE,FALSE,FALSE,2.47,"young",40,181,92,"m"
19,"LEG PRESS",1,"Rep07",2340,2340,2300,2300,2340,2300,0.017,40,2320,"Rep",0,0,FALSE,FALSE,FALSE,1.74,"young",40,181,92,"m"
19,"LEG PRESS",1,"Rep08",2340,2340,2400,2400,2340,2400,0.026,-60,2370,"Rep",0,0,FALSE,FALSE,FALSE,2.5,"young",40,181,92,"m"
19,"LEG PRESS",1,"Rep09",2280,2300,2250,2250,2290,2250,0.017,40,2270,"Rep",-20,0,FALSE,FALSE,FALSE,1.78,"young",40,181,92,"m"
19,"LEG PRESS",1,"Rep10",2520,2500,2650,2700,2510,2675,0.066,-165,2592.5,"Rep",20,-50,TRUE,FALSE,FALSE,6.17,"young",40,181,92,"m"
19,"LEG PRESS",2,"Rep01",2780,2740,2800,2800,2760,2800,0.014,-40,2780,"Rep",40,0,FALSE,FALSE,FALSE,1.43,"young",40,181,92,"m"
19,"LEG PRESS",2,"Rep02",2100,2100,2050,2000,2100,2025,0.036,75,2062.5,"Rep",0,50,FALSE,FALSE,FALSE,3.7,"young",40,181,92,"m"
19,"LEG PRESS",2,"Rep03",1900,1900,1900,1950,1900,1925,0.013,-25,1912.5,"Rep",0,-50,FALSE,FALSE,FALSE,1.3,"young",40,181,92,"m"
19,"LEG PRESS",2,"Rep04",2140,2160,2200,2150,2150,2175,0.012,-25,2162.5,"Rep",-20,50,FALSE,FALSE,FALSE,1.15,"young",40,181,92,"m"
19,"LEG PRESS",2,"Rep05",2240,2220,2250,2250,2230,2250,0.009,-20,2240,"Rep",20,0,FALSE,FALSE,FALSE,0.89,"young",40,181,92,"m"
19,"LEG PRESS",2,"Rep06",2000,2020,1950,2000,2010,1975,0.017,35,1992.5,"Rep",-20,-50,FALSE,FALSE,FALSE,1.77,"young",40,181,92,"m"
19,"LEG PRESS",2,"Rep07",2140,2120,2200,2150,2130,2175,0.021,-45,2152.5,"Rep",20,50,FALSE,FALSE,FALSE,2.07,"young",40,181,92,"m"
19,"LEG PRESS",2,"Rep08",2180,2200,2150,2200,2190,2175,0.007,15,2182.5,"Rep",-20,-50,FALSE,FALSE,FALSE,0.69,"young",40,181,92,"m"
19,"LEG PRESS",2,"Rep09",2220,2220,2200,2200,2220,2200,0.009,20,2210,"Rep",0,0,FALSE,FALSE,FALSE,0.91,"young",40,181,92,"m"
19,"LEG PRESS",2,"Rep10",2760,2740,2950,2900,2750,2925,0.064,-175,2837.5,"Rep",20,50,TRUE,FALSE,FALSE,5.98,"young",40,181,92,"m"
19,"LEG PRESS",1,"TuT",24460,24420,24700,24500,24440,24600,0.007,-160,24520,"TuT",40,200,FALSE,FALSE,FALSE,0.65,"young",40,181,92,"m"
19,"LEG PRESS",2,"TuT",22460,22420,22650,22600,22440,22625,0.008,-185,22532.5,"TuT",40,50,FALSE,FALSE,FALSE,0.82,"young",40,181,92,"m"
19,"LEG EXTENSION",1,"Con01",1040,1020,1050,1150,1030,1100,0.068,-70,1065,"Con",20,-100,FALSE,FALSE,FALSE,6.36,"young",40,181,92,"m"
19,"LEG EXTENSION",1,"Con02",760,760,850,800,760,825,0.086,-65,792.5,"Con",0,50,FALSE,FALSE,FALSE,7.88,"young",40,181,92,"m"
19,"LEG EXTENSION",1,"Con03",840,840,900,900,840,900,0.071,-60,870,"Con",0,0,FALSE,FALSE,FALSE,6.67,"young",40,181,92,"m"
19,"LEG EXTENSION",1,"Con04",760,760,900,850,760,875,0.151,-115,817.5,"Con",0,50,FALSE,FALSE,FALSE,13.14,"young",40,181,92,"m"
19,"LEG EXTENSION",1,"Con05",780,800,900,900,790,900,0.139,-110,845,"Con",-20,0,FALSE,FALSE,FALSE,12.22,"young",40,181,92,"m"
19,"LEG EXTENSION",1,"Con06",720,740,900,800,730,850,0.164,-120,790,"Con",-20,100,FALSE,FALSE,FALSE,14.12,"young",40,181,92,"m"
19,"LEG EXTENSION",1,"Con07",780,780,900,900,780,900,0.154,-120,840,"Con",0,0,FALSE,FALSE,FALSE,13.33,"young",40,181,92,"m"
19,"LEG EXTENSION",1,"Con08",800,780,900,950,790,925,0.171,-135,857.5,"Con",20,-50,FALSE,FALSE,FALSE,14.59,"young",40,181,92,"m"
19,"LEG EXTENSION",1,"Con09",820,840,950,1050,830,1000,0.205,-170,915,"Con",-20,-100,FALSE,FALSE,FALSE,17,"young",40,181,92,"m"
19,"LEG EXTENSION",1,"Con10",1320,1320,1200,1850,1320,1525,0.155,-205,1422.5,"Con",0,-650,TRUE,FALSE,TRUE,13.44,"young",40,181,92,"m"
19,"LEG EXTENSION",2,"Con01",840,860,1000,1050,850,1025,0.206,-175,937.5,"Con",-20,-50,FALSE,FALSE,FALSE,17.07,"young",40,181,92,"m"
19,"LEG EXTENSION",2,"Con02",660,660,750,750,660,750,0.136,-90,705,"Con",0,0,FALSE,FALSE,FALSE,12,"young",40,181,92,"m"
19,"LEG EXTENSION",2,"Con03",720,720,800,750,720,775,0.076,-55,747.5,"Con",0,50,FALSE,FALSE,FALSE,7.1,"young",40,181,92,"m"
19,"LEG EXTENSION",2,"Con04",780,760,850,850,770,850,0.104,-80,810,"Con",20,0,FALSE,FALSE,FALSE,9.41,"young",40,181,92,"m"
19,"LEG EXTENSION",2,"Con05",760,760,850,850,760,850,0.118,-90,805,"Con",0,0,FALSE,FALSE,FALSE,10.59,"young",40,181,92,"m"
19,"LEG EXTENSION",2,"Con06",700,680,850,850,690,850,0.232,-160,770,"Con",20,0,FALSE,FALSE,FALSE,18.82,"young",40,181,92,"m"
19,"LEG EXTENSION",2,"Con07",720,720,800,850,720,825,0.146,-105,772.5,"Con",0,-50,FALSE,FALSE,FALSE,12.73,"young",40,181,92,"m"
19,"LEG EXTENSION",2,"Con08",840,860,950,1000,850,975,0.147,-125,912.5,"Con",-20,-50,FALSE,FALSE,FALSE,12.82,"young",40,181,92,"m"
19,"LEG EXTENSION",2,"Con09",700,700,850,850,700,850,0.214,-150,775,"Con",0,0,FALSE,FALSE,FALSE,17.65,"young",40,181,92,"m"
19,"LEG EXTENSION",2,"Con10",940,940,1350,1350,940,1350,0.436,-410,1145,"Con",0,0,TRUE,FALSE,FALSE,30.37,"young",40,181,92,"m"
19,"LEG EXTENSION",1,"Ecc01",2020,2020,1950,1950,2020,1950,0.035,70,1985,"Ecc",0,0,FALSE,FALSE,FALSE,3.59,"young",40,181,92,"m"
19,"LEG EXTENSION",1,"Ecc02",1980,1980,1900,1950,1980,1925,0.028,55,1952.5,"Ecc",0,-50,FALSE,FALSE,FALSE,2.86,"young",40,181,92,"m"
19,"LEG EXTENSION",1,"Ecc03",1700,1700,1600,1600,1700,1600,0.059,100,1650,"Ecc",0,0,FALSE,FALSE,FALSE,6.25,"young",40,181,92,"m"
19,"LEG EXTENSION",1,"Ecc04",1780,1780,1650,1700,1780,1675,0.059,105,1727.5,"Ecc",0,-50,FALSE,FALSE,FALSE,6.27,"young",40,181,92,"m"
19,"LEG EXTENSION",1,"Ecc05",1920,1880,1750,1800,1900,1775,0.066,125,1837.5,"Ecc",40,-50,FALSE,TRUE,FALSE,7.04,"young",40,181,92,"m"
19,"LEG EXTENSION",1,"Ecc06",1780,1780,1650,1700,1780,1675,0.059,105,1727.5,"Ecc",0,-50,FALSE,FALSE,FALSE,6.27,"young",40,181,92,"m"
19,"LEG EXTENSION",1,"Ecc07",1800,1820,1700,1650,1810,1675,0.075,135,1742.5,"Ecc",-20,50,FALSE,FALSE,FALSE,8.06,"young",40,181,92,"m"
19,"LEG EXTENSION",1,"Ecc08",1880,1860,1750,1650,1870,1700,0.091,170,1785,"Ecc",20,100,FALSE,FALSE,FALSE,10,"young",40,181,92,"m"
19,"LEG EXTENSION",1,"Ecc09",1860,1860,1950,1350,1860,1650,0.113,210,1755,"Ecc",0,600,TRUE,FALSE,TRUE,12.73,"young",40,181,92,"m"
19,"LEG EXTENSION",1,"Ecc10",1500,1500,1500,1450,1500,1475,0.017,25,1487.5,"Ecc",0,50,FALSE,FALSE,FALSE,1.69,"young",40,181,92,"m"
19,"LEG EXTENSION",2,"Ecc01",1920,1920,1800,1800,1920,1800,0.062,120,1860,"Ecc",0,0,FALSE,FALSE,FALSE,6.67,"young",40,181,92,"m"
19,"LEG EXTENSION",2,"Ecc02",1640,1640,1550,1600,1640,1575,0.04,65,1607.5,"Ecc",0,-50,FALSE,FALSE,FALSE,4.13,"young",40,181,92,"m"
19,"LEG EXTENSION",2,"Ecc03",1820,1820,1750,1750,1820,1750,0.038,70,1785,"Ecc",0,0,FALSE,FALSE,FALSE,4,"young",40,181,92,"m"
19,"LEG EXTENSION",2,"Ecc04",1820,1860,1750,1750,1840,1750,0.049,90,1795,"Ecc",-40,0,FALSE,TRUE,FALSE,5.14,"young",40,181,92,"m"
19,"LEG EXTENSION",2,"Ecc05",1780,1780,1650,1650,1780,1650,0.073,130,1715,"Ecc",0,0,FALSE,FALSE,FALSE,7.88,"young",40,181,92,"m"
19,"LEG EXTENSION",2,"Ecc06",1680,1680,1550,1550,1680,1550,0.077,130,1615,"Ecc",0,0,FALSE,FALSE,FALSE,8.39,"young",40,181,92,"m"
19,"LEG EXTENSION",2,"Ecc07",1440,1440,1400,1300,1440,1350,0.062,90,1395,"Ecc",0,100,FALSE,FALSE,FALSE,6.67,"young",40,181,92,"m"
19,"LEG EXTENSION",2,"Ecc08",1680,1660,1500,1500,1670,1500,0.102,170,1585,"Ecc",20,0,FALSE,FALSE,FALSE,11.33,"young",40,181,92,"m"
19,"LEG EXTENSION",2,"Ecc09",1800,1780,1400,1450,1790,1425,0.204,365,1607.5,"Ecc",20,-50,TRUE,FALSE,FALSE,25.61,"young",40,181,92,"m"
19,"LEG EXTENSION",2,"Ecc10",1460,1480,1500,1450,1470,1475,0.003,-5,1472.5,"Ecc",-20,50,FALSE,FALSE,FALSE,0.34,"young",40,181,92,"m"
19,"LEG EXTENSION",1,"Rep01",3060,3040,3000,3100,3050,3050,0,0,3050,"Rep",20,-100,FALSE,FALSE,FALSE,0,"young",40,181,92,"m"
19,"LEG EXTENSION",1,"Rep02",2740,2740,2750,2750,2740,2750,0.004,-10,2745,"Rep",0,0,FALSE,FALSE,FALSE,0.36,"young",40,181,92,"m"
19,"LEG EXTENSION",1,"Rep03",2540,2540,2500,2500,2540,2500,0.016,40,2520,"Rep",0,0,FALSE,FALSE,FALSE,1.6,"young",40,181,92,"m"
19,"LEG EXTENSION",1,"Rep04",2540,2540,2550,2550,2540,2550,0.004,-10,2545,"Rep",0,0,FALSE,FALSE,FALSE,0.39,"young",40,181,92,"m"
19,"LEG EXTENSION",1,"Rep05",2700,2680,2650,2700,2690,2675,0.006,15,2682.5,"Rep",20,-50,FALSE,FALSE,FALSE,0.56,"young",40,181,92,"m"
19,"LEG EXTENSION",1,"Rep06",2500,2520,2550,2500,2510,2525,0.006,-15,2517.5,"Rep",-20,50,FALSE,FALSE,FALSE,0.59,"young",40,181,92,"m"
19,"LEG EXTENSION",1,"Rep07",2580,2600,2600,2550,2590,2575,0.006,15,2582.5,"Rep",-20,50,FALSE,FALSE,FALSE,0.58,"young",40,181,92,"m"
19,"LEG EXTENSION",1,"Rep08",2680,2640,2650,2600,2660,2625,0.013,35,2642.5,"Rep",40,50,FALSE,FALSE,FALSE,1.33,"young",40,181,92,"m"
19,"LEG EXTENSION",1,"Rep09",2680,2700,2900,2400,2690,2650,0.015,40,2670,"Rep",-20,500,FALSE,FALSE,TRUE,1.51,"young",40,181,92,"m"
19,"LEG EXTENSION",1,"Rep10",2820,2820,2700,3300,2820,3000,0.064,-180,2910,"Rep",0,-600,TRUE,FALSE,TRUE,6,"young",40,181,92,"m"
19,"LEG EXTENSION",2,"Rep01",2760,2780,2800,2850,2770,2825,0.02,-55,2797.5,"Rep",-20,-50,FALSE,FALSE,FALSE,1.95,"young",40,181,92,"m"
19,"LEG EXTENSION",2,"Rep02",2300,2300,2300,2350,2300,2325,0.011,-25,2312.5,"Rep",0,-50,FALSE,FALSE,FALSE,1.08,"young",40,181,92,"m"
19,"LEG EXTENSION",2,"Rep03",2540,2540,2550,2500,2540,2525,0.006,15,2532.5,"Rep",0,50,FALSE,FALSE,FALSE,0.59,"young",40,181,92,"m"
19,"LEG EXTENSION",2,"Rep04",2600,2620,2600,2600,2610,2600,0.004,10,2605,"Rep",-20,0,FALSE,FALSE,FALSE,0.38,"young",40,181,92,"m"
19,"LEG EXTENSION",2,"Rep05",2540,2540,2500,2500,2540,2500,0.016,40,2520,"Rep",0,0,FALSE,FALSE,FALSE,1.6,"young",40,181,92,"m"
19,"LEG EXTENSION",2,"Rep06",2380,2360,2400,2400,2370,2400,0.013,-30,2385,"Rep",20,0,FALSE,FALSE,FALSE,1.25,"young",40,181,92,"m"
19,"LEG EXTENSION",2,"Rep07",2160,2160,2200,2150,2160,2175,0.007,-15,2167.5,"Rep",0,50,FALSE,FALSE,FALSE,0.69,"young",40,181,92,"m"
19,"LEG EXTENSION",2,"Rep08",2520,2520,2450,2500,2520,2475,0.018,45,2497.5,"Rep",0,-50,FALSE,FALSE,FALSE,1.82,"young",40,181,92,"m"
19,"LEG EXTENSION",2,"Rep09",2500,2480,2250,2300,2490,2275,0.086,215,2382.5,"Rep",20,-50,TRUE,FALSE,FALSE,9.45,"young",40,181,92,"m"
19,"LEG EXTENSION",2,"Rep10",2400,2420,2850,2800,2410,2825,0.172,-415,2617.5,"Rep",-20,50,TRUE,FALSE,FALSE,14.69,"young",40,181,92,"m"
19,"LEG EXTENSION",1,"TuT",26840,26820,26850,26950,26830,26900,0.003,-70,26865,"TuT",20,-100,FALSE,FALSE,FALSE,0.26,"young",40,181,92,"m"
19,"LEG EXTENSION",2,"TuT",24700,24720,24900,24950,24710,24925,0.009,-215,24817.5,"TuT",-20,-50,TRUE,FALSE,FALSE,0.86,"young",40,181,92,"m"
19,"LEG CURL",2,"Con01",1260,1240,1400,1550,1250,1475,0.18,-225,1362.5,"Con",20,-150,FALSE,FALSE,FALSE,15.25,"young",40,181,92,"m"
19,"LEG CURL",2,"Con02",1060,1080,1100,1050,1070,1075,0.005,-5,1072.5,"Con",-20,50,FALSE,FALSE,FALSE,0.47,"young",40,181,92,"m"
19,"LEG CURL",2,"Con03",1120,1100,1150,1100,1110,1125,0.014,-15,1117.5,"Con",20,50,FALSE,FALSE,FALSE,1.33,"young",40,181,92,"m"
19,"LEG CURL",2,"Con04",1020,1000,1100,1050,1010,1075,0.064,-65,1042.5,"Con",20,50,FALSE,FALSE,FALSE,6.05,"young",40,181,92,"m"
19,"LEG CURL",2,"Con05",1080,1080,1100,1150,1080,1125,0.042,-45,1102.5,"Con",0,-50,FALSE,FALSE,FALSE,4,"young",40,181,92,"m"
19,"LEG CURL",2,"Con06",1120,1120,1100,1150,1120,1125,0.004,-5,1122.5,"Con",0,-50,FALSE,FALSE,FALSE,0.44,"young",40,181,92,"m"
19,"LEG CURL",2,"Con07",1000,980,1050,1100,990,1075,0.086,-85,1032.5,"Con",20,-50,FALSE,FALSE,FALSE,7.91,"young",40,181,92,"m"
19,"LEG CURL",2,"Con08",1100,1100,1250,1300,1100,1275,0.159,-175,1187.5,"Con",0,-50,FALSE,FALSE,FALSE,13.73,"young",40,181,92,"m"
19,"LEG CURL",2,"Con09",1040,1000,1900,1600,1020,1750,0.716,-730,1385,"Con",40,300,TRUE,FALSE,TRUE,41.71,"young",40,181,92,"m"
19,"LEG CURL",2,"Con10",1200,1200,1650,1800,1200,1725,0.438,-525,1462.5,"Con",0,-150,TRUE,FALSE,FALSE,30.43,"young",40,181,92,"m"
19,"LEG CURL",2,"Ecc01",1900,1880,1850,1850,1890,1850,0.021,40,1870,"Ecc",20,0,FALSE,FALSE,FALSE,2.16,"young",40,181,92,"m"
19,"LEG CURL",2,"Ecc02",2100,2120,2100,2150,2110,2125,0.007,-15,2117.5,"Ecc",-20,-50,FALSE,FALSE,FALSE,0.71,"young",40,181,92,"m"
19,"LEG CURL",2,"Ecc03",2000,2000,1900,1950,2000,1925,0.038,75,1962.5,"Ecc",0,-50,FALSE,FALSE,FALSE,3.9,"young",40,181,92,"m"
19,"LEG CURL",2,"Ecc04",2060,2060,2000,2000,2060,2000,0.029,60,2030,"Ecc",0,0,FALSE,FALSE,FALSE,3,"young",40,181,92,"m"
19,"LEG CURL",2,"Ecc05",1960,1960,2000,1950,1960,1975,0.008,-15,1967.5,"Ecc",0,50,FALSE,FALSE,FALSE,0.76,"young",40,181,92,"m"
19,"LEG CURL",2,"Ecc06",2080,2100,2050,2000,2090,2025,0.031,65,2057.5,"Ecc",-20,50,FALSE,FALSE,FALSE,3.21,"young",40,181,92,"m"
19,"LEG CURL",2,"Ecc07",2120,2120,2000,1950,2120,1975,0.068,145,2047.5,"Ecc",0,50,FALSE,FALSE,FALSE,7.34,"young",40,181,92,"m"
19,"LEG CURL",2,"Ecc08",2280,2300,1400,1700,2290,1550,0.323,740,1920,"Ecc",-20,-300,TRUE,FALSE,TRUE,47.74,"young",40,181,92,"m"
19,"LEG CURL",2,"Ecc09",2220,2240,1750,1600,2230,1675,0.249,555,1952.5,"Ecc",-20,150,TRUE,FALSE,FALSE,33.13,"young",40,181,92,"m"
19,"LEG CURL",2,"Ecc10",1900,1920,1950,1950,1910,1950,0.021,-40,1930,"Ecc",-20,0,FALSE,FALSE,FALSE,2.05,"young",40,181,92,"m"
19,"LEG CURL",2,"Rep01",3160,3120,3250,3400,3140,3325,0.059,-185,3232.5,"Rep",40,-150,TRUE,FALSE,FALSE,5.56,"young",40,181,92,"m"
19,"LEG CURL",2,"Rep02",3160,3200,3200,3200,3180,3200,0.006,-20,3190,"Rep",-40,0,FALSE,FALSE,FALSE,0.62,"young",40,181,92,"m"
19,"LEG CURL",2,"Rep03",3120,3100,3050,3050,3110,3050,0.019,60,3080,"Rep",20,0,FALSE,FALSE,FALSE,1.97,"young",40,181,92,"m"
19,"LEG CURL",2,"Rep04",3080,3060,3100,3050,3070,3075,0.002,-5,3072.5,"Rep",20,50,FALSE,FALSE,FALSE,0.16,"young",40,181,92,"m"
19,"LEG CURL",2,"Rep05",3040,3040,3100,3100,3040,3100,0.02,-60,3070,"Rep",0,0,FALSE,FALSE,FALSE,1.94,"young",40,181,92,"m"
19,"LEG CURL",2,"Rep06",3200,3220,3150,3150,3210,3150,0.019,60,3180,"Rep",-20,0,FALSE,FALSE,FALSE,1.9,"young",40,181,92,"m"
19,"LEG CURL",2,"Rep07",3120,3100,3050,3050,3110,3050,0.019,60,3080,"Rep",20,0,FALSE,FALSE,FALSE,1.97,"young",40,181,92,"m"
19,"LEG CURL",2,"Rep08",3380,3400,2650,3000,3390,2825,0.167,565,3107.5,"Rep",-20,-350,TRUE,FALSE,TRUE,20,"young",40,181,92,"m"
19,"LEG CURL",2,"Rep09",3260,3240,3650,3200,3250,3425,0.054,-175,3337.5,"Rep",20,450,TRUE,FALSE,TRUE,5.11,"young",40,181,92,"m"
19,"LEG CURL",2,"Rep10",3100,3120,3600,3750,3110,3675,0.182,-565,3392.5,"Rep",-20,-150,TRUE,FALSE,FALSE,15.37,"young",40,181,92,"m"
19,"LEG CURL",2,"TuT",31620,31600,31800,31950,31610,31875,0.008,-265,31742.5,"TuT",20,-150,FALSE,FALSE,FALSE,0.83,"young",40,181,92,"m"
19,"ABDUCTOR",1,"Con01",760,720,800,950,740,875,0.182,-135,807.5,"Con",40,-150,FALSE,TRUE,FALSE,15.43,"young",40,181,92,"m"
19,"ABDUCTOR",1,"Con02",600,600,650,750,600,700,0.167,-100,650,"Con",0,-100,FALSE,FALSE,FALSE,14.29,"young",40,181,92,"m"
19,"ABDUCTOR",1,"Con03",660,680,600,650,670,625,0.067,45,647.5,"Con",-20,-50,FALSE,FALSE,FALSE,7.2,"young",40,181,92,"m"
19,"ABDUCTOR",1,"Con04",720,720,700,750,720,725,0.007,-5,722.5,"Con",0,-50,FALSE,FALSE,FALSE,0.69,"young",40,181,92,"m"
19,"ABDUCTOR",1,"Con05",580,580,850,800,580,825,0.422,-245,702.5,"Con",0,50,FALSE,FALSE,FALSE,29.7,"young",40,181,92,"m"
19,"ABDUCTOR",1,"Con06",680,700,900,800,690,850,0.232,-160,770,"Con",-20,100,FALSE,FALSE,FALSE,18.82,"young",40,181,92,"m"
19,"ABDUCTOR",1,"Con07",700,700,850,750,700,800,0.143,-100,750,"Con",0,100,FALSE,FALSE,FALSE,12.5,"young",40,181,92,"m"
19,"ABDUCTOR",1,"Con08",560,580,850,900,570,875,0.535,-305,722.5,"Con",-20,-50,TRUE,FALSE,FALSE,34.86,"young",40,181,92,"m"
19,"ABDUCTOR",1,"Con09",580,580,1000,950,580,975,0.681,-395,777.5,"Con",0,50,TRUE,FALSE,FALSE,40.51,"young",40,181,92,"m"
19,"ABDUCTOR",1,"Con10",600,600,950,1100,600,1025,0.708,-425,812.5,"Con",0,-150,TRUE,FALSE,FALSE,41.46,"young",40,181,92,"m"
19,"ABDUCTOR",2,"Con01",680,700,800,750,690,775,0.123,-85,732.5,"Con",-20,50,FALSE,FALSE,FALSE,10.97,"young",40,181,92,"m"
19,"ABDUCTOR",2,"Con02",560,580,700,600,570,650,0.14,-80,610,"Con",-20,100,FALSE,FALSE,FALSE,12.31,"young",40,181,92,"m"
19,"ABDUCTOR",2,"Con03",680,700,650,700,690,675,0.022,15,682.5,"Con",-20,-50,FALSE,FALSE,FALSE,2.22,"young",40,181,92,"m"
19,"ABDUCTOR",2,"Con04",540,560,750,700,550,725,0.318,-175,637.5,"Con",-20,50,FALSE,FALSE,FALSE,24.14,"young",40,181,92,"m"
19,"ABDUCTOR",2,"Con05",760,740,750,750,750,750,0,0,750,"Con",20,0,FALSE,FALSE,FALSE,0,"young",40,181,92,"m"
19,"ABDUCTOR",2,"Con06",560,580,750,750,570,750,0.316,-180,660,"Con",-20,0,FALSE,FALSE,FALSE,24,"young",40,181,92,"m"
19,"ABDUCTOR",2,"Con07",540,520,800,800,530,800,0.509,-270,665,"Con",20,0,FALSE,FALSE,FALSE,33.75,"young",40,181,92,"m"
19,"ABDUCTOR",2,"Con08",560,560,750,750,560,750,0.339,-190,655,"Con",0,0,FALSE,FALSE,FALSE,25.33,"young",40,181,92,"m"
19,"ABDUCTOR",2,"Con09",700,660,800,750,680,775,0.14,-95,727.5,"Con",40,50,FALSE,TRUE,FALSE,12.26,"young",40,181,92,"m"
19,"ABDUCTOR",2,"Con10",680,680,900,900,680,900,0.324,-220,790,"Con",0,0,FALSE,FALSE,FALSE,24.44,"young",40,181,92,"m"
19,"ABDUCTOR",1,"Ecc01",1860,1880,1550,1500,1870,1525,0.184,345,1697.5,"Ecc",-20,50,TRUE,FALSE,FALSE,22.62,"young",40,181,92,"m"
19,"ABDUCTOR",1,"Ecc02",1680,1680,1400,1350,1680,1375,0.182,305,1527.5,"Ecc",0,50,TRUE,FALSE,FALSE,22.18,"young",40,181,92,"m"
19,"ABDUCTOR",1,"Ecc03",1540,1520,1500,1450,1530,1475,0.036,55,1502.5,"Ecc",20,50,FALSE,FALSE,FALSE,3.73,"young",40,181,92,"m"
19,"ABDUCTOR",1,"Ecc04",1880,1880,1500,1500,1880,1500,0.202,380,1690,"Ecc",0,0,TRUE,FALSE,FALSE,25.33,"young",40,181,92,"m"
19,"ABDUCTOR",1,"Ecc05",1740,1720,1500,1600,1730,1550,0.104,180,1640,"Ecc",20,-100,FALSE,FALSE,FALSE,11.61,"young",40,181,92,"m"
19,"ABDUCTOR",1,"Ecc06",1980,1980,1400,1450,1980,1425,0.28,555,1702.5,"Ecc",0,-50,TRUE,FALSE,FALSE,38.95,"young",40,181,92,"m"
19,"ABDUCTOR",1,"Ecc07",1980,1980,1500,1550,1980,1525,0.23,455,1752.5,"Ecc",0,-50,TRUE,FALSE,FALSE,29.84,"young",40,181,92,"m"
19,"ABDUCTOR",1,"Ecc08",1980,1980,1350,1350,1980,1350,0.318,630,1665,"Ecc",0,0,TRUE,FALSE,FALSE,46.67,"young",40,181,92,"m"
19,"ABDUCTOR",1,"Ecc09",2640,2620,1500,1450,2630,1475,0.439,1155,2052.5,"Ecc",20,50,TRUE,FALSE,FALSE,78.31,"young",40,181,92,"m"
19,"ABDUCTOR",1,"Ecc10",1660,1660,1550,1500,1660,1525,0.081,135,1592.5,"Ecc",0,50,FALSE,FALSE,FALSE,8.85,"young",40,181,92,"m"
19,"ABDUCTOR",2,"Ecc01",1620,1600,1050,1200,1610,1125,0.301,485,1367.5,"Ecc",20,-150,TRUE,FALSE,FALSE,43.11,"young",40,181,92,"m"
19,"ABDUCTOR",2,"Ecc02",1240,1200,1200,1150,1220,1175,0.037,45,1197.5,"Ecc",40,50,FALSE,TRUE,FALSE,3.83,"young",40,181,92,"m"
19,"ABDUCTOR",2,"Ecc03",1440,1420,1100,1150,1430,1125,0.213,305,1277.5,"Ecc",20,-50,TRUE,FALSE,FALSE,27.11,"young",40,181,92,"m"
19,"ABDUCTOR",2,"Ecc04",1580,1600,1200,1200,1590,1200,0.245,390,1395,"Ecc",-20,0,TRUE,FALSE,FALSE,32.5,"young",40,181,92,"m"
19,"ABDUCTOR",2,"Ecc05",1880,1860,1200,1200,1870,1200,0.358,670,1535,"Ecc",20,0,TRUE,FALSE,FALSE,55.83,"young",40,181,92,"m"
19,"ABDUCTOR",2,"Ecc06",1800,1820,1400,1400,1810,1400,0.227,410,1605,"Ecc",-20,0,TRUE,FALSE,FALSE,29.29,"young",40,181,92,"m"
19,"ABDUCTOR",2,"Ecc07",1820,1820,1400,1400,1820,1400,0.231,420,1610,"Ecc",0,0,TRUE,FALSE,FALSE,30,"young",40,181,92,"m"
19,"ABDUCTOR",2,"Ecc08",1660,1680,1300,1350,1670,1325,0.207,345,1497.5,"Ecc",-20,-50,TRUE,FALSE,FALSE,26.04,"young",40,181,92,"m"
19,"ABDUCTOR",2,"Ecc09",1780,1800,1350,1350,1790,1350,0.246,440,1570,"Ecc",-20,0,TRUE,FALSE,FALSE,32.59,"young",40,181,92,"m"
19,"ABDUCTOR",2,"Ecc10",1260,1260,1650,1600,1260,1625,0.29,-365,1442.5,"Ecc",0,50,TRUE,FALSE,FALSE,22.46,"young",40,181,92,"m"
19,"ABDUCTOR",1,"Rep01",2620,2600,2350,2450,2610,2400,0.08,210,2505,"Rep",20,-100,FALSE,FALSE,FALSE,8.75,"young",40,181,92,"m"
19,"ABDUCTOR",1,"Rep02",2280,2280,2050,2100,2280,2075,0.09,205,2177.5,"Rep",0,-50,FALSE,FALSE,FALSE,9.88,"young",40,181,92,"m"
19,"ABDUCTOR",1,"Rep03",2200,2200,2100,2100,2200,2100,0.045,100,2150,"Rep",0,0,FALSE,FALSE,FALSE,4.76,"young",40,181,92,"m"
19,"ABDUCTOR",1,"Rep04",2600,2600,2200,2250,2600,2225,0.144,375,2412.5,"Rep",0,-50,TRUE,FALSE,FALSE,16.85,"young",40,181,92,"m"
19,"ABDUCTOR",1,"Rep05",2320,2300,2350,2400,2310,2375,0.028,-65,2342.5,"Rep",20,-50,FALSE,FALSE,FALSE,2.74,"young",40,181,92,"m"
19,"ABDUCTOR",1,"Rep06",2660,2680,2300,2250,2670,2275,0.148,395,2472.5,"Rep",-20,50,TRUE,FALSE,FALSE,17.36,"young",40,181,92,"m"
19,"ABDUCTOR",1,"Rep07",2680,2680,2350,2300,2680,2325,0.132,355,2502.5,"Rep",0,50,TRUE,FALSE,FALSE,15.27,"young",40,181,92,"m"
19,"ABDUCTOR",1,"Rep08",2540,2560,2200,2250,2550,2225,0.127,325,2387.5,"Rep",-20,-50,TRUE,FALSE,FALSE,14.61,"young",40,181,92,"m"
19,"ABDUCTOR",1,"Rep09",3220,3200,2500,2400,3210,2450,0.237,760,2830,"Rep",20,100,TRUE,FALSE,FALSE,31.02,"young",40,181,92,"m"
19,"ABDUCTOR",1,"Rep10",2260,2260,2500,2600,2260,2550,0.128,-290,2405,"Rep",0,-100,FALSE,FALSE,FALSE,11.37,"young",40,181,92,"m"
19,"ABDUCTOR",2,"Rep01",2300,2300,1850,1950,2300,1900,0.174,400,2100,"Rep",0,-100,TRUE,FALSE,FALSE,21.05,"young",40,181,92,"m"
19,"ABDUCTOR",2,"Rep02",1800,1780,1900,1750,1790,1825,0.02,-35,1807.5,"Rep",20,150,FALSE,FALSE,FALSE,1.92,"young",40,181,92,"m"
19,"ABDUCTOR",2,"Rep03",2120,2120,1750,1850,2120,1800,0.151,320,1960,"Rep",0,-100,TRUE,FALSE,FALSE,17.78,"young",40,181,92,"m"
19,"ABDUCTOR",2,"Rep04",2120,2160,1950,1900,2140,1925,0.1,215,2032.5,"Rep",-40,50,FALSE,FALSE,FALSE,11.17,"young",40,181,92,"m"
19,"ABDUCTOR",2,"Rep05",2640,2600,1950,1950,2620,1950,0.256,670,2285,"Rep",40,0,TRUE,FALSE,FALSE,34.36,"young",40,181,92,"m"
19,"ABDUCTOR",2,"Rep06",2360,2400,2150,2150,2380,2150,0.097,230,2265,"Rep",-40,0,FALSE,FALSE,FALSE,10.7,"young",40,181,92,"m"
19,"ABDUCTOR",2,"Rep07",2360,2340,2200,2200,2350,2200,0.064,150,2275,"Rep",20,0,FALSE,FALSE,FALSE,6.82,"young",40,181,92,"m"
19,"ABDUCTOR",2,"Rep08",2220,2240,2050,2100,2230,2075,0.07,155,2152.5,"Rep",-20,-50,FALSE,FALSE,FALSE,7.47,"young",40,181,92,"m"
19,"ABDUCTOR",2,"Rep09",2480,2460,2150,2100,2470,2125,0.14,345,2297.5,"Rep",20,50,TRUE,FALSE,FALSE,16.24,"young",40,181,92,"m"
19,"ABDUCTOR",2,"Rep10",1940,1940,2550,2500,1940,2525,0.302,-585,2232.5,"Rep",0,50,TRUE,FALSE,FALSE,23.17,"young",40,181,92,"m"
19,"ABDUCTOR",1,"TuT",25380,25360,22900,23100,25370,23000,0.093,2370,24185,"TuT",20,-200,TRUE,FALSE,FALSE,10.3,"young",40,181,92,"m"
19,"ABDUCTOR",2,"TuT",22340,22340,20500,20450,22340,20475,0.083,1865,21407.5,"TuT",0,50,TRUE,FALSE,FALSE,9.11,"young",40,181,92,"m"
19,"ADDUCTOR",1,"Con01",760,760,750,900,760,825,0.086,-65,792.5,"Con",0,-150,FALSE,FALSE,FALSE,7.88,"young",40,181,92,"m"
19,"ADDUCTOR",1,"Con02",660,620,650,750,640,700,0.094,-60,670,"Con",40,-100,FALSE,TRUE,FALSE,8.57,"young",40,181,92,"m"
19,"ADDUCTOR",1,"Con03",680,700,750,700,690,725,0.051,-35,707.5,"Con",-20,50,FALSE,FALSE,FALSE,4.83,"young",40,181,92,"m"
19,"ADDUCTOR",1,"Con04",740,740,900,800,740,850,0.149,-110,795,"Con",0,100,FALSE,FALSE,FALSE,12.94,"young",40,181,92,"m"
19,"ADDUCTOR",1,"Con05",740,760,700,750,750,725,0.033,25,737.5,"Con",-20,-50,FALSE,FALSE,FALSE,3.45,"young",40,181,92,"m"
19,"ADDUCTOR",1,"Con06",700,680,800,850,690,825,0.196,-135,757.5,"Con",20,-50,FALSE,FALSE,FALSE,16.36,"young",40,181,92,"m"
19,"ADDUCTOR",1,"Con07",700,680,850,900,690,875,0.268,-185,782.5,"Con",20,-50,FALSE,FALSE,FALSE,21.14,"young",40,181,92,"m"
19,"ADDUCTOR",1,"Con08",760,760,850,750,760,800,0.053,-40,780,"Con",0,100,FALSE,FALSE,FALSE,5,"young",40,181,92,"m"
19,"ADDUCTOR",1,"Con09",760,780,700,750,770,725,0.058,45,747.5,"Con",-20,-50,FALSE,FALSE,FALSE,6.21,"young",40,181,92,"m"
19,"ADDUCTOR",1,"Con10",860,860,1000,2000,860,1500,0.744,-640,1180,"Con",0,-1000,TRUE,FALSE,TRUE,42.67,"young",40,181,92,"m"
19,"ADDUCTOR",2,"Con01",820,820,800,850,820,825,0.006,-5,822.5,"Con",0,-50,FALSE,FALSE,FALSE,0.61,"young",40,181,92,"m"
19,"ADDUCTOR",2,"Con02",620,640,700,700,630,700,0.111,-70,665,"Con",-20,0,FALSE,FALSE,FALSE,10,"young",40,181,92,"m"
19,"ADDUCTOR",2,"Con03",640,640,850,850,640,850,0.328,-210,745,"Con",0,0,FALSE,FALSE,FALSE,24.71,"young",40,181,92,"m"
19,"ADDUCTOR",2,"Con04",720,720,750,700,720,725,0.007,-5,722.5,"Con",0,50,FALSE,FALSE,FALSE,0.69,"young",40,181,92,"m"
19,"ADDUCTOR",2,"Con05",660,680,800,850,670,825,0.231,-155,747.5,"Con",-20,-50,FALSE,FALSE,FALSE,18.79,"young",40,181,92,"m"
19,"ADDUCTOR",2,"Con06",660,660,700,650,660,675,0.023,-15,667.5,"Con",0,50,FALSE,FALSE,FALSE,2.22,"young",40,181,92,"m"
19,"ADDUCTOR",2,"Con07",700,680,700,750,690,725,0.051,-35,707.5,"Con",20,-50,FALSE,FALSE,FALSE,4.83,"young",40,181,92,"m"
19,"ADDUCTOR",2,"Con08",760,760,700,750,760,725,0.046,35,742.5,"Con",0,-50,FALSE,FALSE,FALSE,4.83,"young",40,181,92,"m"
19,"ADDUCTOR",2,"Con09",820,820,850,850,820,850,0.037,-30,835,"Con",0,0,FALSE,FALSE,FALSE,3.53,"young",40,181,92,"m"
19,"ADDUCTOR",2,"Con10",780,800,750,850,790,800,0.013,-10,795,"Con",-20,-100,FALSE,FALSE,FALSE,1.25,"young",40,181,92,"m"
19,"ADDUCTOR",1,"Ecc01",1600,1620,1800,1750,1610,1775,0.102,-165,1692.5,"Ecc",-20,50,FALSE,FALSE,FALSE,9.3,"young",40,181,92,"m"
19,"ADDUCTOR",1,"Ecc02",1400,1400,1600,1600,1400,1600,0.143,-200,1500,"Ecc",0,0,FALSE,FALSE,FALSE,12.5,"young",40,181,92,"m"
19,"ADDUCTOR",1,"Ecc03",1380,1380,1350,1450,1380,1400,0.014,-20,1390,"Ecc",0,-100,FALSE,FALSE,FALSE,1.43,"young",40,181,92,"m"
19,"ADDUCTOR",1,"Ecc04",1560,1560,1800,1800,1560,1800,0.154,-240,1680,"Ecc",0,0,FALSE,FALSE,FALSE,13.33,"young",40,181,92,"m"
19,"ADDUCTOR",1,"Ecc05",1700,1680,1600,1550,1690,1575,0.068,115,1632.5,"Ecc",20,50,FALSE,FALSE,FALSE,7.3,"young",40,181,92,"m"
19,"ADDUCTOR",1,"Ecc06",1560,1580,1850,1800,1570,1825,0.162,-255,1697.5,"Ecc",-20,50,FALSE,FALSE,FALSE,13.97,"young",40,181,92,"m"
19,"ADDUCTOR",1,"Ecc07",1640,1660,1700,1750,1650,1725,0.045,-75,1687.5,"Ecc",-20,-50,FALSE,FALSE,FALSE,4.35,"young",40,181,92,"m"
19,"ADDUCTOR",1,"Ecc08",1560,1560,1850,1850,1560,1850,0.186,-290,1705,"Ecc",0,0,FALSE,FALSE,FALSE,15.68,"young",40,181,92,"m"
19,"ADDUCTOR",1,"Ecc09",1580,1560,2200,1200,1570,1700,0.083,-130,1635,"Ecc",20,1000,FALSE,FALSE,TRUE,7.65,"young",40,181,92,"m"
19,"ADDUCTOR",1,"Ecc10",1520,1520,1700,1400,1520,1550,0.02,-30,1535,"Ecc",0,300,FALSE,FALSE,FALSE,1.94,"young",40,181,92,"m"
19,"ADDUCTOR",2,"Ecc01",1140,1140,1500,1450,1140,1475,0.294,-335,1307.5,"Ecc",0,50,FALSE,FALSE,FALSE,22.71,"young",40,181,92,"m"
19,"ADDUCTOR",2,"Ecc02",1220,1200,1100,1100,1210,1100,0.091,110,1155,"Ecc",20,0,FALSE,FALSE,FALSE,10,"young",40,181,92,"m"
19,"ADDUCTOR",2,"Ecc03",1140,1140,1200,1250,1140,1225,0.075,-85,1182.5,"Ecc",0,-50,FALSE,FALSE,FALSE,6.94,"young",40,181,92,"m"
19,"ADDUCTOR",2,"Ecc04",1260,1240,1500,1500,1250,1500,0.2,-250,1375,"Ecc",20,0,FALSE,FALSE,FALSE,16.67,"young",40,181,92,"m"
19,"ADDUCTOR",2,"Ecc05",1280,1280,1750,1750,1280,1750,0.367,-470,1515,"Ecc",0,0,FALSE,FALSE,FALSE,26.86,"young",40,181,92,"m"
19,"ADDUCTOR",2,"Ecc06",1500,1500,1650,1650,1500,1650,0.1,-150,1575,"Ecc",0,0,FALSE,FALSE,FALSE,9.09,"young",40,181,92,"m"
19,"ADDUCTOR",2,"Ecc07",1500,1520,1700,1600,1510,1650,0.093,-140,1580,"Ecc",-20,100,FALSE,FALSE,FALSE,8.48,"young",40,181,92,"m"
19,"ADDUCTOR",2,"Ecc08",1240,1220,1500,1500,1230,1500,0.22,-270,1365,"Ecc",20,0,FALSE,FALSE,FALSE,18,"young",40,181,92,"m"
19,"ADDUCTOR",2,"Ecc09",1360,1360,1650,1600,1360,1625,0.195,-265,1492.5,"Ecc",0,50,FALSE,FALSE,FALSE,16.31,"young",40,181,92,"m"
19,"ADDUCTOR",2,"Ecc10",1600,1600,1400,1250,1600,1325,0.172,275,1462.5,"Ecc",0,150,FALSE,FALSE,FALSE,20.75,"young",40,181,92,"m"
19,"ADDUCTOR",1,"Rep01",2360,2380,2550,2650,2370,2600,0.097,-230,2485,"Rep",-20,-100,FALSE,FALSE,FALSE,8.85,"young",40,181,92,"m"
19,"ADDUCTOR",1,"Rep02",2060,2020,2250,2350,2040,2300,0.127,-260,2170,"Rep",40,-100,FALSE,FALSE,FALSE,11.3,"young",40,181,92,"m"
19,"ADDUCTOR",1,"Rep03",2060,2080,2100,2150,2070,2125,0.027,-55,2097.5,"Rep",-20,-50,FALSE,FALSE,FALSE,2.59,"young",40,181,92,"m"
19,"ADDUCTOR",1,"Rep04",2300,2300,2700,2600,2300,2650,0.152,-350,2475,"Rep",0,100,FALSE,FALSE,FALSE,13.21,"young",40,181,92,"m"
19,"ADDUCTOR",1,"Rep05",2440,2440,2300,2300,2440,2300,0.057,140,2370,"Rep",0,0,FALSE,FALSE,FALSE,6.09,"young",40,181,92,"m"
19,"ADDUCTOR",1,"Rep06",2260,2260,2650,2650,2260,2650,0.173,-390,2455,"Rep",0,0,TRUE,FALSE,FALSE,14.72,"young",40,181,92,"m"
19,"ADDUCTOR",1,"Rep07",2340,2340,2550,2650,2340,2600,0.111,-260,2470,"Rep",0,-100,FALSE,FALSE,FALSE,10,"young",40,181,92,"m"
19,"ADDUCTOR",1,"Rep08",2320,2320,2700,2600,2320,2650,0.142,-330,2485,"Rep",0,100,FALSE,FALSE,FALSE,12.45,"young",40,181,92,"m"
19,"ADDUCTOR",1,"Rep09",2340,2340,2900,1950,2340,2425,0.036,-85,2382.5,"Rep",0,950,FALSE,FALSE,TRUE,3.51,"young",40,181,92,"m"
19,"ADDUCTOR",1,"Rep10",2380,2380,2700,3400,2380,3050,0.282,-670,2715,"Rep",0,-700,TRUE,FALSE,TRUE,21.97,"young",40,181,92,"m"
19,"ADDUCTOR",2,"Rep01",1960,1960,2300,2300,1960,2300,0.173,-340,2130,"Rep",0,0,FALSE,FALSE,FALSE,14.78,"young",40,181,92,"m"
19,"ADDUCTOR",2,"Rep02",1840,1840,1800,1800,1840,1800,0.022,40,1820,"Rep",0,0,FALSE,FALSE,FALSE,2.22,"young",40,181,92,"m"
19,"ADDUCTOR",2,"Rep03",1780,1780,2050,2100,1780,2075,0.166,-295,1927.5,"Rep",0,-50,FALSE,FALSE,FALSE,14.22,"young",40,181,92,"m"
19,"ADDUCTOR",2,"Rep04",1980,1960,2250,2200,1970,2225,0.129,-255,2097.5,"Rep",20,50,FALSE,FALSE,FALSE,11.46,"young",40,181,92,"m"
19,"ADDUCTOR",2,"Rep05",1940,1960,2550,2600,1950,2575,0.321,-625,2262.5,"Rep",-20,-50,TRUE,FALSE,FALSE,24.27,"young",40,181,92,"m"
19,"ADDUCTOR",2,"Rep06",2160,2160,2350,2300,2160,2325,0.076,-165,2242.5,"Rep",0,50,FALSE,FALSE,FALSE,7.1,"young",40,181,92,"m"
19,"ADDUCTOR",2,"Rep07",2200,2200,2400,2350,2200,2375,0.08,-175,2287.5,"Rep",0,50,FALSE,FALSE,FALSE,7.37,"young",40,181,92,"m"
19,"ADDUCTOR",2,"Rep08",2000,1980,2200,2250,1990,2225,0.118,-235,2107.5,"Rep",20,-50,FALSE,FALSE,FALSE,10.56,"young",40,181,92,"m"
19,"ADDUCTOR",2,"Rep09",2180,2180,2500,2450,2180,2475,0.135,-295,2327.5,"Rep",0,50,FALSE,FALSE,FALSE,11.92,"young",40,181,92,"m"
19,"ADDUCTOR",2,"Rep10",2380,2400,2150,2100,2390,2125,0.111,265,2257.5,"Rep",-20,50,FALSE,FALSE,FALSE,12.47,"young",40,181,92,"m"
19,"ADDUCTOR",1,"TuT",22860,22860,25400,25300,22860,25350,0.109,-2490,24105,"TuT",0,100,TRUE,FALSE,FALSE,9.82,"young",40,181,92,"m"
19,"ADDUCTOR",2,"TuT",20420,20420,22550,22450,20420,22500,0.102,-2080,21460,"TuT",0,100,TRUE,FALSE,FALSE,9.24,"young",40,181,92,"m"
19,"LOWER BACK",1,"Con01",1080,1080,1150,1150,1080,1150,0.065,-70,1115,"Con",0,0,FALSE,FALSE,FALSE,6.09,"young",40,181,92,"m"
19,"LOWER BACK",1,"Con02",900,900,900,950,900,925,0.028,-25,912.5,"Con",0,-50,FALSE,FALSE,FALSE,2.7,"young",40,181,92,"m"
19,"LOWER BACK",1,"Con03",940,960,1000,1050,950,1025,0.079,-75,987.5,"Con",-20,-50,FALSE,FALSE,FALSE,7.32,"young",40,181,92,"m"
19,"LOWER BACK",1,"Con04",1020,1020,1150,1100,1020,1125,0.103,-105,1072.5,"Con",0,50,FALSE,FALSE,FALSE,9.33,"young",40,181,92,"m"
19,"LOWER BACK",1,"Con05",1040,1040,1100,1100,1040,1100,0.058,-60,1070,"Con",0,0,FALSE,FALSE,FALSE,5.45,"young",40,181,92,"m"
19,"LOWER BACK",1,"Con06",1000,1000,1150,1100,1000,1125,0.125,-125,1062.5,"Con",0,50,FALSE,FALSE,FALSE,11.11,"young",40,181,92,"m"
19,"LOWER BACK",1,"Con07",980,960,1100,1100,970,1100,0.134,-130,1035,"Con",20,0,FALSE,FALSE,FALSE,11.82,"young",40,181,92,"m"
19,"LOWER BACK",1,"Con08",980,980,1050,1050,980,1050,0.071,-70,1015,"Con",0,0,FALSE,FALSE,FALSE,6.67,"young",40,181,92,"m"
19,"LOWER BACK",1,"Con09",1100,1120,1250,1350,1110,1300,0.171,-190,1205,"Con",-20,-100,TRUE,FALSE,FALSE,14.62,"young",40,181,92,"m"
19,"LOWER BACK",1,"Con10",1240,1240,1500,1550,1240,1525,0.23,-285,1382.5,"Con",0,-50,TRUE,FALSE,FALSE,18.69,"young",40,181,92,"m"
19,"LOWER BACK",2,"Con01",1140,1140,1300,1300,1140,1300,0.14,-160,1220,"Con",0,0,FALSE,FALSE,FALSE,12.31,"young",40,181,92,"m"
19,"LOWER BACK",2,"Con02",820,840,900,950,830,925,0.114,-95,877.5,"Con",-20,-50,FALSE,FALSE,FALSE,10.27,"young",40,181,92,"m"
19,"LOWER BACK",2,"Con03",1080,1100,1000,1000,1090,1000,0.083,90,1045,"Con",-20,0,FALSE,FALSE,FALSE,9,"young",40,181,92,"m"
19,"LOWER BACK",2,"Con04",980,960,1050,1000,970,1025,0.057,-55,997.5,"Con",20,50,FALSE,FALSE,FALSE,5.37,"young",40,181,92,"m"
19,"LOWER BACK",2,"Con05",960,940,1050,1000,950,1025,0.079,-75,987.5,"Con",20,50,FALSE,FALSE,FALSE,7.32,"young",40,181,92,"m"
19,"LOWER BACK",2,"Con06",1060,1080,1200,1150,1070,1175,0.098,-105,1122.5,"Con",-20,50,FALSE,FALSE,FALSE,8.94,"young",40,181,92,"m"
19,"LOWER BACK",2,"Con07",1020,1020,1100,1200,1020,1150,0.127,-130,1085,"Con",0,-100,FALSE,FALSE,FALSE,11.3,"young",40,181,92,"m"
19,"LOWER BACK",2,"Con08",1140,1120,1300,1300,1130,1300,0.15,-170,1215,"Con",20,0,FALSE,FALSE,FALSE,13.08,"young",40,181,92,"m"
19,"LOWER BACK",2,"Con09",960,960,1100,1100,960,1100,0.146,-140,1030,"Con",0,0,FALSE,FALSE,FALSE,12.73,"young",40,181,92,"m"
19,"LOWER BACK",2,"Con10",1240,1240,1450,1450,1240,1450,0.169,-210,1345,"Con",0,0,TRUE,FALSE,FALSE,14.48,"young",40,181,92,"m"
19,"LOWER BACK",1,"Ecc01",1460,1460,1450,1400,1460,1425,0.024,35,1442.5,"Ecc",0,50,FALSE,FALSE,FALSE,2.46,"young",40,181,92,"m"
19,"LOWER BACK",1,"Ecc02",2360,2340,2300,2250,2350,2275,0.032,75,2312.5,"Ecc",20,50,FALSE,FALSE,FALSE,3.3,"young",40,181,92,"m"
19,"LOWER BACK",1,"Ecc03",1960,1960,1850,1850,1960,1850,0.056,110,1905,"Ecc",0,0,FALSE,FALSE,FALSE,5.95,"young",40,181,92,"m"
19,"LOWER BACK",1,"Ecc04",1940,1940,1850,1900,1940,1875,0.034,65,1907.5,"Ecc",0,-50,FALSE,FALSE,FALSE,3.47,"young",40,181,92,"m"
19,"LOWER BACK",1,"Ecc05",1880,1880,1750,1800,1880,1775,0.056,105,1827.5,"Ecc",0,-50,FALSE,FALSE,FALSE,5.92,"young",40,181,92,"m"
19,"LOWER BACK",1,"Ecc06",2020,2040,1900,1900,2030,1900,0.064,130,1965,"Ecc",-20,0,FALSE,FALSE,FALSE,6.84,"young",40,181,92,"m"
19,"LOWER BACK",1,"Ecc07",2040,2040,1950,1950,2040,1950,0.044,90,1995,"Ecc",0,0,FALSE,FALSE,FALSE,4.62,"young",40,181,92,"m"
19,"LOWER BACK",1,"Ecc08",2100,2080,2000,1900,2090,1950,0.067,140,2020,"Ecc",20,100,FALSE,FALSE,FALSE,7.18,"young",40,181,92,"m"
19,"LOWER BACK",1,"Ecc09",2100,2100,1850,1750,2100,1800,0.143,300,1950,"Ecc",0,100,TRUE,FALSE,FALSE,16.67,"young",40,181,92,"m"
19,"LOWER BACK",1,"Ecc10",1940,1940,1950,1900,1940,1925,0.008,15,1932.5,"Ecc",0,50,FALSE,FALSE,FALSE,0.78,"young",40,181,92,"m"
19,"LOWER BACK",2,"Ecc01",1820,1800,1750,1700,1810,1725,0.047,85,1767.5,"Ecc",20,50,FALSE,FALSE,FALSE,4.93,"young",40,181,92,"m"
19,"LOWER BACK",2,"Ecc02",1780,1780,1850,1850,1780,1850,0.039,-70,1815,"Ecc",0,0,FALSE,FALSE,FALSE,3.78,"young",40,181,92,"m"
19,"LOWER BACK",2,"Ecc03",1760,1740,1700,1750,1750,1725,0.014,25,1737.5,"Ecc",20,-50,FALSE,FALSE,FALSE,1.45,"young",40,181,92,"m"
19,"LOWER BACK",2,"Ecc04",1700,1720,1600,1650,1710,1625,0.05,85,1667.5,"Ecc",-20,-50,FALSE,FALSE,FALSE,5.23,"young",40,181,92,"m"
19,"LOWER BACK",2,"Ecc05",1800,1820,1700,1750,1810,1725,0.047,85,1767.5,"Ecc",-20,-50,FALSE,FALSE,FALSE,4.93,"young",40,181,92,"m"
19,"LOWER BACK",2,"Ecc06",1860,1840,1750,1700,1850,1725,0.068,125,1787.5,"Ecc",20,50,FALSE,FALSE,FALSE,7.25,"young",40,181,92,"m"
19,"LOWER BACK",2,"Ecc07",1760,1780,1600,1550,1770,1575,0.11,195,1672.5,"Ecc",-20,50,TRUE,FALSE,FALSE,12.38,"young",40,181,92,"m"
19,"LOWER BACK",2,"Ecc08",1620,1600,1500,1500,1610,1500,0.068,110,1555,"Ecc",20,0,FALSE,FALSE,FALSE,7.33,"young",40,181,92,"m"
19,"LOWER BACK",2,"Ecc09",1860,1880,1650,1650,1870,1650,0.118,220,1760,"Ecc",-20,0,TRUE,FALSE,FALSE,13.33,"young",40,181,92,"m"
19,"LOWER BACK",2,"Ecc10",1420,1420,1450,1400,1420,1425,0.004,-5,1422.5,"Ecc",0,50,FALSE,FALSE,FALSE,0.35,"young",40,181,92,"m"
19,"LOWER BACK",1,"Rep01",2540,2540,2600,2550,2540,2575,0.014,-35,2557.5,"Rep",0,50,FALSE,FALSE,FALSE,1.36,"young",40,181,92,"m"
19,"LOWER BACK",1,"Rep02",3260,3240,3200,3200,3250,3200,0.015,50,3225,"Rep",20,0,FALSE,FALSE,FALSE,1.56,"young",40,181,92,"m"
19,"LOWER BACK",1,"Rep03",2900,2920,2850,2900,2910,2875,0.012,35,2892.5,"Rep",-20,-50,FALSE,FALSE,FALSE,1.22,"young",40,181,92,"m"
19,"LOWER BACK",1,"Rep04",2960,2960,3000,3000,2960,3000,0.014,-40,2980,"Rep",0,0,FALSE,FALSE,FALSE,1.33,"young",40,181,92,"m"
19,"LOWER BACK",1,"Rep05",2920,2920,2850,2900,2920,2875,0.015,45,2897.5,"Rep",0,-50,FALSE,FALSE,FALSE,1.57,"young",40,181,92,"m"
19,"LOWER BACK",1,"Rep06",3020,3040,3050,3000,3030,3025,0.002,5,3027.5,"Rep",-20,50,FALSE,FALSE,FALSE,0.17,"young",40,181,92,"m"
19,"LOWER BACK",1,"Rep07",3020,3000,3050,3050,3010,3050,0.013,-40,3030,"Rep",20,0,FALSE,FALSE,FALSE,1.31,"young",40,181,92,"m"
19,"LOWER BACK",1,"Rep08",3080,3060,3050,2950,3070,3000,0.023,70,3035,"Rep",20,100,FALSE,FALSE,FALSE,2.33,"young",40,181,92,"m"
19,"LOWER BACK",1,"Rep09",3200,3220,3100,3100,3210,3100,0.034,110,3155,"Rep",-20,0,TRUE,FALSE,FALSE,3.55,"young",40,181,92,"m"
19,"LOWER BACK",1,"Rep10",3180,3180,3450,3450,3180,3450,0.085,-270,3315,"Rep",0,0,TRUE,FALSE,FALSE,7.83,"young",40,181,92,"m"
19,"LOWER BACK",2,"Rep01",2960,2940,3050,3000,2950,3025,0.025,-75,2987.5,"Rep",20,50,FALSE,FALSE,FALSE,2.48,"young",40,181,92,"m"
19,"LOWER BACK",2,"Rep02",2600,2620,2750,2800,2610,2775,0.063,-165,2692.5,"Rep",-20,-50,TRUE,FALSE,FALSE,5.95,"young",40,181,92,"m"
19,"LOWER BACK",2,"Rep03",2840,2840,2700,2750,2840,2725,0.04,115,2782.5,"Rep",0,-50,TRUE,FALSE,FALSE,4.22,"young",40,181,92,"m"
19,"LOWER BACK",2,"Rep04",2680,2680,2650,2650,2680,2650,0.011,30,2665,"Rep",0,0,FALSE,FALSE,FALSE,1.13,"young",40,181,92,"m"
19,"LOWER BACK",2,"Rep05",2760,2760,2750,2750,2760,2750,0.004,10,2755,"Rep",0,0,FALSE,FALSE,FALSE,0.36,"young",40,181,92,"m"
19,"LOWER BACK",2,"Rep06",2920,2920,2950,2850,2920,2900,0.007,20,2910,"Rep",0,100,FALSE,FALSE,FALSE,0.69,"young",40,181,92,"m"
19,"LOWER BACK",2,"Rep07",2780,2800,2700,2750,2790,2725,0.023,65,2757.5,"Rep",-20,-50,FALSE,FALSE,FALSE,2.39,"young",40,181,92,"m"
19,"LOWER BACK",2,"Rep08",2760,2720,2800,2800,2740,2800,0.022,-60,2770,"Rep",40,0,FALSE,FALSE,FALSE,2.14,"young",40,181,92,"m"
19,"LOWER BACK",2,"Rep09",2820,2840,2750,2750,2830,2750,0.028,80,2790,"Rep",-20,0,FALSE,FALSE,FALSE,2.91,"young",40,181,92,"m"
19,"LOWER BACK",2,"Rep10",2660,2660,2900,2850,2660,2875,0.081,-215,2767.5,"Rep",0,50,TRUE,FALSE,FALSE,7.48,"young",40,181,92,"m"
19,"LOWER BACK",1,"TuT",30080,30080,30200,30100,30080,30150,0.002,-70,30115,"TuT",0,100,FALSE,FALSE,FALSE,0.23,"young",40,181,92,"m"
19,"LOWER BACK",2,"TuT",27780,27780,28000,27950,27780,27975,0.007,-195,27877.5,"TuT",0,50,FALSE,FALSE,FALSE,0.7,"young",40,181,92,"m"
19,"TOTAL ABDOMINAL",1,"Con01",1040,1020,1150,950,1030,1050,0.019,-20,1040,"Con",20,200,FALSE,FALSE,TRUE,1.9,"young",40,181,92,"m"
19,"TOTAL ABDOMINAL",1,"Con02",780,780,800,750,780,775,0.006,5,777.5,"Con",0,50,FALSE,FALSE,FALSE,0.65,"young",40,181,92,"m"
19,"TOTAL ABDOMINAL",1,"Con03",840,820,850,800,830,825,0.006,5,827.5,"Con",20,50,FALSE,FALSE,FALSE,0.61,"young",40,181,92,"m"
19,"TOTAL ABDOMINAL",1,"Con04",840,860,900,900,850,900,0.059,-50,875,"Con",-20,0,FALSE,FALSE,FALSE,5.56,"young",40,181,92,"m"
19,"TOTAL ABDOMINAL",1,"Con05",780,800,850,850,790,850,0.076,-60,820,"Con",-20,0,FALSE,FALSE,FALSE,7.06,"young",40,181,92,"m"
19,"TOTAL ABDOMINAL",1,"Con06",820,820,850,850,820,850,0.037,-30,835,"Con",0,0,FALSE,FALSE,FALSE,3.53,"young",40,181,92,"m"
19,"TOTAL ABDOMINAL",1,"Con07",920,900,1000,1000,910,1000,0.099,-90,955,"Con",20,0,FALSE,FALSE,FALSE,9,"young",40,181,92,"m"
19,"TOTAL ABDOMINAL",1,"Con08",820,820,1050,1150,820,1100,0.341,-280,960,"Con",0,-100,TRUE,FALSE,FALSE,25.45,"young",40,181,92,"m"
19,"TOTAL ABDOMINAL",1,"Con09",820,820,1050,1100,820,1075,0.311,-255,947.5,"Con",0,-50,TRUE,FALSE,FALSE,23.72,"young",40,181,92,"m"
19,"TOTAL ABDOMINAL",1,"Con10",1200,1160,1300,1350,1180,1325,0.123,-145,1252.5,"Con",40,-50,TRUE,TRUE,FALSE,10.94,"young",40,181,92,"m"
19,"TOTAL ABDOMINAL",2,"Con01",1080,1080,1350,900,1080,1125,0.042,-45,1102.5,"Con",0,450,FALSE,FALSE,TRUE,4,"young",40,181,92,"m"
19,"TOTAL ABDOMINAL",2,"Con02",680,660,750,800,670,775,0.157,-105,722.5,"Con",20,-50,FALSE,FALSE,FALSE,13.55,"young",40,181,92,"m"
19,"TOTAL ABDOMINAL",2,"Con03",780,800,800,800,790,800,0.013,-10,795,"Con",-20,0,FALSE,FALSE,FALSE,1.25,"young",40,181,92,"m"
19,"TOTAL ABDOMINAL",2,"Con04",760,760,800,800,760,800,0.053,-40,780,"Con",0,0,FALSE,FALSE,FALSE,5,"young",40,181,92,"m"
19,"TOTAL ABDOMINAL",2,"Con05",940,940,850,850,940,850,0.096,90,895,"Con",0,0,FALSE,FALSE,FALSE,10.59,"young",40,181,92,"m"
19,"TOTAL ABDOMINAL",2,"Con06",740,760,850,850,750,850,0.133,-100,800,"Con",-20,0,FALSE,FALSE,FALSE,11.76,"young",40,181,92,"m"
19,"TOTAL ABDOMINAL",2,"Con07",860,840,950,1000,850,975,0.147,-125,912.5,"Con",20,-50,FALSE,FALSE,FALSE,12.82,"young",40,181,92,"m"
19,"TOTAL ABDOMINAL",2,"Con08",860,860,1000,1000,860,1000,0.163,-140,930,"Con",0,0,FALSE,FALSE,FALSE,14,"young",40,181,92,"m"
19,"TOTAL ABDOMINAL",2,"Con09",840,840,1050,1000,840,1025,0.22,-185,932.5,"Con",0,50,TRUE,FALSE,FALSE,18.05,"young",40,181,92,"m"
19,"TOTAL ABDOMINAL",2,"Con10",860,880,1100,1050,870,1075,0.236,-205,972.5,"Con",-20,50,TRUE,FALSE,FALSE,19.07,"young",40,181,92,"m"
19,"TOTAL ABDOMINAL",1,"Ecc01",1600,1600,1550,1650,1600,1600,0,0,1600,"Ecc",0,-100,FALSE,FALSE,FALSE,0,"young",40,181,92,"m"
19,"TOTAL ABDOMINAL",1,"Ecc02",1320,1340,1300,1300,1330,1300,0.023,30,1315,"Ecc",-20,0,FALSE,FALSE,FALSE,2.31,"young",40,181,92,"m"
19,"TOTAL ABDOMINAL",1,"Ecc03",1320,1300,1250,1300,1310,1275,0.027,35,1292.5,"Ecc",20,-50,FALSE,FALSE,FALSE,2.75,"young",40,181,92,"m"
19,"TOTAL ABDOMINAL",1,"Ecc04",1360,1340,1300,1300,1350,1300,0.037,50,1325,"Ecc",20,0,FALSE,FALSE,FALSE,3.85,"young",40,181,92,"m"
19,"TOTAL ABDOMINAL",1,"Ecc05",1420,1420,1400,1350,1420,1375,0.032,45,1397.5,"Ecc",0,50,FALSE,FALSE,FALSE,3.27,"young",40,181,92,"m"
19,"TOTAL ABDOMINAL",1,"Ecc06",1360,1360,1300,1350,1360,1325,0.026,35,1342.5,"Ecc",0,-50,FALSE,FALSE,FALSE,2.64,"young",40,181,92,"m"
19,"TOTAL ABDOMINAL",1,"Ecc07",1440,1460,1250,1150,1450,1200,0.172,250,1325,"Ecc",-20,100,TRUE,FALSE,FALSE,20.83,"young",40,181,92,"m"
19,"TOTAL ABDOMINAL",1,"Ecc08",1400,1400,1150,1100,1400,1125,0.196,275,1262.5,"Ecc",0,50,TRUE,FALSE,FALSE,24.44,"young",40,181,92,"m"
19,"TOTAL ABDOMINAL",1,"Ecc09",1340,1380,1200,1150,1360,1175,0.136,185,1267.5,"Ecc",-40,50,TRUE,TRUE,FALSE,15.74,"young",40,181,92,"m"
19,"TOTAL ABDOMINAL",1,"Ecc10",2280,2280,2350,2300,2280,2325,0.02,-45,2302.5,"Ecc",0,50,FALSE,FALSE,FALSE,1.94,"young",40,181,92,"m"
19,"TOTAL ABDOMINAL",2,"Ecc01",1960,1960,1850,1850,1960,1850,0.056,110,1905,"Ecc",0,0,FALSE,FALSE,FALSE,5.95,"young",40,181,92,"m"
19,"TOTAL ABDOMINAL",2,"Ecc02",1400,1400,1400,1350,1400,1375,0.018,25,1387.5,"Ecc",0,50,FALSE,FALSE,FALSE,1.82,"young",40,181,92,"m"
19,"TOTAL ABDOMINAL",2,"Ecc03",1400,1400,1350,1350,1400,1350,0.036,50,1375,"Ecc",0,0,FALSE,FALSE,FALSE,3.7,"young",40,181,92,"m"
19,"TOTAL ABDOMINAL",2,"Ecc04",1200,1200,1300,1300,1200,1300,0.083,-100,1250,"Ecc",0,0,FALSE,FALSE,FALSE,7.69,"young",40,181,92,"m"
19,"TOTAL ABDOMINAL",2,"Ecc05",1240,1220,1150,1150,1230,1150,0.065,80,1190,"Ecc",20,0,FALSE,FALSE,FALSE,6.96,"young",40,181,92,"m"
19,"TOTAL ABDOMINAL",2,"Ecc06",1260,1280,1150,1150,1270,1150,0.094,120,1210,"Ecc",-20,0,FALSE,FALSE,FALSE,10.43,"young",40,181,92,"m"
19,"TOTAL ABDOMINAL",2,"Ecc07",1100,1100,1000,950,1100,975,0.114,125,1037.5,"Ecc",0,50,FALSE,FALSE,FALSE,12.82,"young",40,181,92,"m"
19,"TOTAL ABDOMINAL",2,"Ecc08",1220,1220,1000,1050,1220,1025,0.16,195,1122.5,"Ecc",0,-50,TRUE,FALSE,FALSE,19.02,"young",40,181,92,"m"
19,"TOTAL ABDOMINAL",2,"Ecc09",1160,1140,950,1000,1150,975,0.152,175,1062.5,"Ecc",20,-50,TRUE,FALSE,FALSE,17.95,"young",40,181,92,"m"
19,"TOTAL ABDOMINAL",2,"Ecc10",1460,1480,1450,1500,1470,1475,0.003,-5,1472.5,"Ecc",-20,-50,FALSE,FALSE,FALSE,0.34,"young",40,181,92,"m"
19,"TOTAL ABDOMINAL",1,"Rep01",2640,2620,2700,2600,2630,2650,0.008,-20,2640,"Rep",20,100,FALSE,FALSE,FALSE,0.75,"young",40,181,92,"m"
19,"TOTAL ABDOMINAL",1,"Rep02",2100,2120,2100,2050,2110,2075,0.017,35,2092.5,"Rep",-20,50,FALSE,FALSE,FALSE,1.69,"young",40,181,92,"m"
19,"TOTAL ABDOMINAL",1,"Rep03",2160,2120,2100,2100,2140,2100,0.019,40,2120,"Rep",40,0,FALSE,FALSE,FALSE,1.9,"young",40,181,92,"m"
19,"TOTAL ABDOMINAL",1,"Rep04",2200,2200,2200,2200,2200,2200,0,0,2200,"Rep",0,0,FALSE,FALSE,FALSE,0,"young",40,181,92,"m"
19,"TOTAL ABDOMINAL",1,"Rep05",2200,2220,2250,2200,2210,2225,0.007,-15,2217.5,"Rep",-20,50,FALSE,FALSE,FALSE,0.67,"young",40,181,92,"m"
19,"TOTAL ABDOMINAL",1,"Rep06",2180,2180,2150,2200,2180,2175,0.002,5,2177.5,"Rep",0,-50,FALSE,FALSE,FALSE,0.23,"young",40,181,92,"m"
19,"TOTAL ABDOMINAL",1,"Rep07",2360,2360,2250,2150,2360,2200,0.068,160,2280,"Rep",0,100,TRUE,FALSE,FALSE,7.27,"young",40,181,92,"m"
19,"TOTAL ABDOMINAL",1,"Rep08",2220,2220,2200,2250,2220,2225,0.002,-5,2222.5,"Rep",0,-50,FALSE,FALSE,FALSE,0.22,"young",40,181,92,"m"
19,"TOTAL ABDOMINAL",1,"Rep09",2160,2200,2250,2250,2180,2250,0.032,-70,2215,"Rep",-40,0,FALSE,FALSE,FALSE,3.11,"young",40,181,92,"m"
19,"TOTAL ABDOMINAL",1,"Rep10",3480,3440,3650,3650,3460,3650,0.055,-190,3555,"Rep",40,0,TRUE,FALSE,FALSE,5.21,"young",40,181,92,"m"
19,"TOTAL ABDOMINAL",2,"Rep01",3040,3040,3200,2750,3040,2975,0.021,65,3007.5,"Rep",0,450,FALSE,FALSE,TRUE,2.18,"young",40,181,92,"m"
19,"TOTAL ABDOMINAL",2,"Rep02",2080,2060,2150,2150,2070,2150,0.039,-80,2110,"Rep",20,0,FALSE,FALSE,FALSE,3.72,"young",40,181,92,"m"
19,"TOTAL ABDOMINAL",2,"Rep03",2180,2200,2150,2150,2190,2150,0.018,40,2170,"Rep",-20,0,FALSE,FALSE,FALSE,1.86,"young",40,181,92,"m"
19,"TOTAL ABDOMINAL",2,"Rep04",1960,1960,2100,2100,1960,2100,0.071,-140,2030,"Rep",0,0,TRUE,FALSE,FALSE,6.67,"young",40,181,92,"m"
19,"TOTAL ABDOMINAL",2,"Rep05",2180,2160,2000,2000,2170,2000,0.078,170,2085,"Rep",20,0,TRUE,FALSE,FALSE,8.5,"young",40,181,92,"m"
19,"TOTAL ABDOMINAL",2,"Rep06",2000,2040,2000,2000,2020,2000,0.01,20,2010,"Rep",-40,0,FALSE,FALSE,FALSE,1,"young",40,181,92,"m"
19,"TOTAL ABDOMINAL",2,"Rep07",1960,1940,1950,1950,1950,1950,0,0,1950,"Rep",20,0,FALSE,FALSE,FALSE,0,"young",40,181,92,"m"
19,"TOTAL ABDOMINAL",2,"Rep08",2080,2080,2000,2050,2080,2025,0.026,55,2052.5,"Rep",0,-50,FALSE,FALSE,FALSE,2.72,"young",40,181,92,"m"
19,"TOTAL ABDOMINAL",2,"Rep09",2000,1980,2000,2000,1990,2000,0.005,-10,1995,"Rep",20,0,FALSE,FALSE,FALSE,0.5,"young",40,181,92,"m"
19,"TOTAL ABDOMINAL",2,"Rep10",2320,2360,2550,2550,2340,2550,0.09,-210,2445,"Rep",-40,0,TRUE,FALSE,FALSE,8.24,"young",40,181,92,"m"
19,"TOTAL ABDOMINAL",1,"TuT",23700,23680,23850,23650,23690,23750,0.003,-60,23720,"TuT",20,200,FALSE,FALSE,FALSE,0.25,"young",40,181,92,"m"
19,"TOTAL ABDOMINAL",2,"TuT",21800,21820,22100,21700,21810,21900,0.004,-90,21855,"TuT",-20,400,FALSE,FALSE,TRUE,0.41,"young",40,181,92,"m"
19,"VERTICAL TRACTION",1,"Con01",1100,1080,2300,2100,1090,2200,1.018,-1110,1645,"Con",20,200,TRUE,FALSE,TRUE,50.45,"young",40,181,92,"m"
19,"VERTICAL TRACTION",1,"Con02",920,940,1150,1000,930,1075,0.156,-145,1002.5,"Con",-20,150,FALSE,FALSE,FALSE,13.49,"young",40,181,92,"m"
19,"VERTICAL TRACTION",1,"Con03",940,940,1200,1000,940,1100,0.17,-160,1020,"Con",0,200,FALSE,FALSE,TRUE,14.55,"young",40,181,92,"m"
19,"VERTICAL TRACTION",1,"Con04",980,1000,1150,1150,990,1150,0.162,-160,1070,"Con",-20,0,FALSE,FALSE,FALSE,13.91,"young",40,181,92,"m"
19,"VERTICAL TRACTION",1,"Con05",960,960,1000,1400,960,1200,0.25,-240,1080,"Con",0,-400,FALSE,FALSE,TRUE,20,"young",40,181,92,"m"
19,"VERTICAL TRACTION",1,"Con06",1000,1000,950,1150,1000,1050,0.05,-50,1025,"Con",0,-200,FALSE,FALSE,TRUE,4.76,"young",40,181,92,"m"
19,"VERTICAL TRACTION",1,"Con07",1060,1080,1100,1100,1070,1100,0.028,-30,1085,"Con",-20,0,FALSE,FALSE,FALSE,2.73,"young",40,181,92,"m"
19,"VERTICAL TRACTION",1,"Con08",1160,1160,1100,1200,1160,1150,0.009,10,1155,"Con",0,-100,FALSE,FALSE,FALSE,0.87,"young",40,181,92,"m"
19,"VERTICAL TRACTION",1,"Con09",1000,980,1250,1000,990,1125,0.136,-135,1057.5,"Con",20,250,FALSE,FALSE,TRUE,12,"young",40,181,92,"m"
19,"VERTICAL TRACTION",1,"Con10",1040,1040,1500,1650,1040,1575,0.514,-535,1307.5,"Con",0,-150,TRUE,FALSE,FALSE,33.97,"young",40,181,92,"m"
19,"VERTICAL TRACTION",2,"Con01",1120,1120,1700,1350,1120,1525,0.362,-405,1322.5,"Con",0,350,TRUE,FALSE,TRUE,26.56,"young",40,181,92,"m"
19,"VERTICAL TRACTION",2,"Con02",880,900,950,850,890,900,0.011,-10,895,"Con",-20,100,FALSE,FALSE,FALSE,1.11,"young",40,181,92,"m"
19,"VERTICAL TRACTION",2,"Con03",980,980,950,850,980,900,0.082,80,940,"Con",0,100,FALSE,FALSE,FALSE,8.89,"young",40,181,92,"m"
19,"VERTICAL TRACTION",2,"Con04",1020,1000,950,1000,1010,975,0.035,35,992.5,"Con",20,-50,FALSE,FALSE,FALSE,3.59,"young",40,181,92,"m"
19,"VERTICAL TRACTION",2,"Con05",1020,1040,1350,1200,1030,1275,0.238,-245,1152.5,"Con",-20,150,FALSE,FALSE,FALSE,19.22,"young",40,181,92,"m"
19,"VERTICAL TRACTION",2,"Con06",1080,1060,1300,1250,1070,1275,0.192,-205,1172.5,"Con",20,50,FALSE,FALSE,FALSE,16.08,"young",40,181,92,"m"
19,"VERTICAL TRACTION",2,"Con07",1020,980,1250,1450,1000,1350,0.35,-350,1175,"Con",40,-200,TRUE,FALSE,TRUE,25.93,"young",40,181,92,"m"
19,"VERTICAL TRACTION",2,"Con08",1000,980,1550,1600,990,1575,0.591,-585,1282.5,"Con",20,-50,TRUE,FALSE,FALSE,37.14,"young",40,181,92,"m"
19,"VERTICAL TRACTION",2,"Con09",1080,1060,1550,1900,1070,1725,0.612,-655,1397.5,"Con",20,-350,TRUE,FALSE,TRUE,37.97,"young",40,181,92,"m"
19,"VERTICAL TRACTION",2,"Con10",1180,1180,1500,2150,1180,1825,0.547,-645,1502.5,"Con",0,-650,TRUE,FALSE,TRUE,35.34,"young",40,181,92,"m"
19,"VERTICAL TRACTION",1,"Ecc01",1580,1560,1400,1500,1570,1450,0.076,120,1510,"Ecc",20,-100,FALSE,FALSE,FALSE,8.28,"young",40,181,92,"m"
19,"VERTICAL TRACTION",1,"Ecc02",1680,1680,1450,1650,1680,1550,0.077,130,1615,"Ecc",0,-200,FALSE,FALSE,TRUE,8.39,"young",40,181,92,"m"
19,"VERTICAL TRACTION",1,"Ecc03",1980,1960,1750,1800,1970,1775,0.099,195,1872.5,"Ecc",20,-50,FALSE,FALSE,FALSE,10.99,"young",40,181,92,"m"
19,"VERTICAL TRACTION",1,"Ecc04",1880,1880,1800,1450,1880,1625,0.136,255,1752.5,"Ecc",0,350,FALSE,FALSE,TRUE,15.69,"young",40,181,92,"m"
19,"VERTICAL TRACTION",1,"Ecc05",1900,1900,1950,1750,1900,1850,0.026,50,1875,"Ecc",0,200,FALSE,FALSE,TRUE,2.7,"young",40,181,92,"m"
19,"VERTICAL TRACTION",1,"Ecc06",1820,1800,1800,1750,1810,1775,0.019,35,1792.5,"Ecc",20,50,FALSE,FALSE,FALSE,1.97,"young",40,181,92,"m"
19,"VERTICAL TRACTION",1,"Ecc07",1840,1820,1850,1800,1830,1825,0.003,5,1827.5,"Ecc",20,50,FALSE,FALSE,FALSE,0.27,"young",40,181,92,"m"
19,"VERTICAL TRACTION",1,"Ecc08",2040,2060,1850,2000,2050,1925,0.061,125,1987.5,"Ecc",-20,-150,FALSE,FALSE,FALSE,6.49,"young",40,181,92,"m"
19,"VERTICAL TRACTION",1,"Ecc09",2020,2040,1550,1500,2030,1525,0.249,505,1777.5,"Ecc",-20,50,TRUE,FALSE,FALSE,33.11,"young",40,181,92,"m"
19,"VERTICAL TRACTION",1,"Ecc10",2300,2320,2400,2300,2310,2350,0.017,-40,2330,"Ecc",-20,100,FALSE,FALSE,FALSE,1.7,"young",40,181,92,"m"
19,"VERTICAL TRACTION",2,"Ecc01",1780,1760,1700,1750,1770,1725,0.025,45,1747.5,"Ecc",20,-50,FALSE,FALSE,FALSE,2.61,"young",40,181,92,"m"
19,"VERTICAL TRACTION",2,"Ecc02",1640,1640,1650,1750,1640,1700,0.037,-60,1670,"Ecc",0,-100,FALSE,FALSE,FALSE,3.53,"young",40,181,92,"m"
19,"VERTICAL TRACTION",2,"Ecc03",1720,1740,1800,1800,1730,1800,0.04,-70,1765,"Ecc",-20,0,FALSE,FALSE,FALSE,3.89,"young",40,181,92,"m"
19,"VERTICAL TRACTION",2,"Ecc04",2060,2040,1750,1850,2050,1800,0.122,250,1925,"Ecc",20,-100,FALSE,FALSE,FALSE,13.89,"young",40,181,92,"m"
19,"VERTICAL TRACTION",2,"Ecc05",2060,2080,1800,1900,2070,1850,0.106,220,1960,"Ecc",-20,-100,FALSE,FALSE,FALSE,11.89,"young",40,181,92,"m"
19,"VERTICAL TRACTION",2,"Ecc06",1960,2000,1800,1550,1980,1675,0.154,305,1827.5,"Ecc",-40,250,TRUE,FALSE,TRUE,18.21,"young",40,181,92,"m"
19,"VERTICAL TRACTION",2,"Ecc07",1960,1960,1400,1350,1960,1375,0.298,585,1667.5,"Ecc",0,50,TRUE,FALSE,FALSE,42.55,"young",40,181,92,"m"
19,"VERTICAL TRACTION",2,"Ecc08",2180,2220,1700,1400,2200,1550,0.295,650,1875,"Ecc",-40,300,TRUE,FALSE,TRUE,41.94,"young",40,181,92,"m"
19,"VERTICAL TRACTION",2,"Ecc09",2440,2440,2150,1450,2440,1800,0.262,640,2120,"Ecc",0,700,TRUE,FALSE,TRUE,35.56,"young",40,181,92,"m"
19,"VERTICAL TRACTION",2,"Ecc10",1760,1760,1750,1600,1760,1675,0.048,85,1717.5,"Ecc",0,150,FALSE,FALSE,FALSE,5.07,"young",40,181,92,"m"
19,"VERTICAL TRACTION",1,"Rep01",2680,2640,3700,3600,2660,3650,0.372,-990,3155,"Rep",40,100,TRUE,FALSE,FALSE,27.12,"young",40,181,92,"m"
19,"VERTICAL TRACTION",1,"Rep02",2600,2620,2600,2650,2610,2625,0.006,-15,2617.5,"Rep",-20,-50,FALSE,FALSE,FALSE,0.57,"young",40,181,92,"m"
19,"VERTICAL TRACTION",1,"Rep03",2920,2900,2950,2800,2910,2875,0.012,35,2892.5,"Rep",20,150,FALSE,FALSE,FALSE,1.22,"young",40,181,92,"m"
19,"VERTICAL TRACTION",1,"Rep04",2860,2880,2950,2600,2870,2775,0.033,95,2822.5,"Rep",-20,350,FALSE,FALSE,TRUE,3.42,"young",40,181,92,"m"
19,"VERTICAL TRACTION",1,"Rep05",2860,2860,2950,3150,2860,3050,0.066,-190,2955,"Rep",0,-200,TRUE,FALSE,TRUE,6.23,"young",40,181,92,"m"
19,"VERTICAL TRACTION",1,"Rep06",2820,2800,2750,2900,2810,2825,0.005,-15,2817.5,"Rep",20,-150,FALSE,FALSE,FALSE,0.53,"young",40,181,92,"m"
19,"VERTICAL TRACTION",1,"Rep07",2900,2900,2950,2900,2900,2925,0.009,-25,2912.5,"Rep",0,50,FALSE,FALSE,FALSE,0.85,"young",40,181,92,"m"
19,"VERTICAL TRACTION",1,"Rep08",3200,3220,2950,3200,3210,3075,0.042,135,3142.5,"Rep",-20,-250,FALSE,FALSE,TRUE,4.39,"young",40,181,92,"m"
19,"VERTICAL TRACTION",1,"Rep09",3020,3020,2800,2500,3020,2650,0.123,370,2835,"Rep",0,300,TRUE,FALSE,TRUE,13.96,"young",40,181,92,"m"
19,"VERTICAL TRACTION",1,"Rep10",3340,3360,3900,3950,3350,3925,0.172,-575,3637.5,"Rep",-20,-50,TRUE,FALSE,FALSE,14.65,"young",40,181,92,"m"
19,"VERTICAL TRACTION",2,"Rep01",2900,2880,3400,3100,2890,3250,0.125,-360,3070,"Rep",20,300,TRUE,FALSE,TRUE,11.08,"young",40,181,92,"m"
19,"VERTICAL TRACTION",2,"Rep02",2520,2540,2600,2600,2530,2600,0.028,-70,2565,"Rep",-20,0,FALSE,FALSE,FALSE,2.69,"young",40,181,92,"m"
19,"VERTICAL TRACTION",2,"Rep03",2700,2720,2750,2650,2710,2700,0.004,10,2705,"Rep",-20,100,FALSE,FALSE,FALSE,0.37,"young",40,181,92,"m"
19,"VERTICAL TRACTION",2,"Rep04",3080,3040,2700,2850,3060,2775,0.093,285,2917.5,"Rep",40,-150,TRUE,FALSE,FALSE,10.27,"young",40,181,92,"m"
19,"VERTICAL TRACTION",2,"Rep05",3080,3120,3150,3100,3100,3125,0.008,-25,3112.5,"Rep",-40,50,FALSE,FALSE,FALSE,0.8,"young",40,181,92,"m"
19,"VERTICAL TRACTION",2,"Rep06",3040,3060,3100,2800,3050,2950,0.033,100,3000,"Rep",-20,300,FALSE,FALSE,TRUE,3.39,"young",40,181,92,"m"
19,"VERTICAL TRACTION",2,"Rep07",2980,2940,2650,2800,2960,2725,0.079,235,2842.5,"Rep",40,-150,TRUE,FALSE,FALSE,8.62,"young",40,181,92,"m"
19,"VERTICAL TRACTION",2,"Rep08",3180,3200,3250,3000,3190,3125,0.02,65,3157.5,"Rep",-20,250,FALSE,FALSE,TRUE,2.08,"young",40,181,92,"m"
19,"VERTICAL TRACTION",2,"Rep09",3520,3500,3700,3350,3510,3525,0.004,-15,3517.5,"Rep",20,350,FALSE,FALSE,TRUE,0.43,"young",40,181,92,"m"
19,"VERTICAL TRACTION",2,"Rep10",2940,2940,3250,3750,2940,3500,0.19,-560,3220,"Rep",0,-500,TRUE,FALSE,TRUE,16,"young",40,181,92,"m"
19,"VERTICAL TRACTION",1,"TuT",29200,29200,30500,30250,29200,30375,0.04,-1175,29787.5,"TuT",0,250,FALSE,FALSE,FALSE,3.87,"young",40,181,92,"m"
19,"VERTICAL TRACTION",2,"TuT",29940,29940,30550,30000,29940,30275,0.011,-335,30107.5,"TuT",0,550,FALSE,FALSE,FALSE,1.11,"young",40,181,92,"m"
19,"CHEST PRESS",1,"Con01",1600,1560,2100,1550,1580,1825,0.155,-245,1702.5,"Con",40,550,FALSE,TRUE,TRUE,13.42,"young",40,181,92,"m"
19,"CHEST PRESS",1,"Con02",1020,1000,1150,1100,1010,1125,0.114,-115,1067.5,"Con",20,50,FALSE,FALSE,FALSE,10.22,"young",40,181,92,"m"
19,"CHEST PRESS",1,"Con03",1040,1040,1150,1150,1040,1150,0.106,-110,1095,"Con",0,0,FALSE,FALSE,FALSE,9.57,"young",40,181,92,"m"
19,"CHEST PRESS",1,"Con04",1040,1020,1200,1100,1030,1150,0.117,-120,1090,"Con",20,100,FALSE,FALSE,FALSE,10.43,"young",40,181,92,"m"
19,"CHEST PRESS",1,"Con05",1100,1080,1150,1150,1090,1150,0.055,-60,1120,"Con",20,0,FALSE,FALSE,FALSE,5.22,"young",40,181,92,"m"
19,"CHEST PRESS",1,"Con06",1080,1100,1050,1100,1090,1075,0.014,15,1082.5,"Con",-20,-50,FALSE,FALSE,FALSE,1.4,"young",40,181,92,"m"
19,"CHEST PRESS",1,"Con07",1120,1120,1100,1100,1120,1100,0.018,20,1110,"Con",0,0,FALSE,FALSE,FALSE,1.82,"young",40,181,92,"m"
19,"CHEST PRESS",1,"Con08",1080,1080,1100,1100,1080,1100,0.019,-20,1090,"Con",0,0,FALSE,FALSE,FALSE,1.82,"young",40,181,92,"m"
19,"CHEST PRESS",1,"Con09",1260,1280,1300,1400,1270,1350,0.063,-80,1310,"Con",-20,-100,FALSE,FALSE,FALSE,5.93,"young",40,181,92,"m"
19,"CHEST PRESS",1,"Con10",1460,1460,1750,1700,1460,1725,0.182,-265,1592.5,"Con",0,50,FALSE,FALSE,FALSE,15.36,"young",40,181,92,"m"
19,"CHEST PRESS",2,"Con01",1060,1080,1200,1150,1070,1175,0.098,-105,1122.5,"Con",-20,50,FALSE,FALSE,FALSE,8.94,"young",40,181,92,"m"
19,"CHEST PRESS",2,"Con02",1000,1000,1000,900,1000,950,0.05,50,975,"Con",0,100,FALSE,FALSE,FALSE,5.26,"young",40,181,92,"m"
19,"CHEST PRESS",2,"Con03",1060,1100,1000,1000,1080,1000,0.074,80,1040,"Con",-40,0,FALSE,TRUE,FALSE,8,"young",40,181,92,"m"
19,"CHEST PRESS",2,"Con04",1040,1100,1050,1000,1070,1025,0.042,45,1047.5,"Con",-60,50,FALSE,TRUE,FALSE,4.39,"young",40,181,92,"m"
19,"CHEST PRESS",2,"Con05",1060,1080,1100,1100,1070,1100,0.028,-30,1085,"Con",-20,0,FALSE,FALSE,FALSE,2.73,"young",40,181,92,"m"
19,"CHEST PRESS",2,"Con06",1080,1100,1050,1150,1090,1100,0.009,-10,1095,"Con",-20,-100,FALSE,FALSE,FALSE,0.91,"young",40,181,92,"m"
19,"CHEST PRESS",2,"Con07",1100,1120,1250,1300,1110,1275,0.149,-165,1192.5,"Con",-20,-50,FALSE,FALSE,FALSE,12.94,"young",40,181,92,"m"
19,"CHEST PRESS",2,"Con08",1080,1100,1400,1450,1090,1425,0.307,-335,1257.5,"Con",-20,-50,FALSE,FALSE,FALSE,23.51,"young",40,181,92,"m"
19,"CHEST PRESS",2,"Con09",1180,1220,1350,1400,1200,1375,0.146,-175,1287.5,"Con",-40,-50,FALSE,TRUE,FALSE,12.73,"young",40,181,92,"m"
19,"CHEST PRESS",2,"Con10",1580,1600,1800,1850,1590,1825,0.148,-235,1707.5,"Con",-20,-50,FALSE,FALSE,FALSE,12.88,"young",40,181,92,"m"
19,"CHEST PRESS",1,"Ecc01",1700,1720,1600,1700,1710,1650,0.035,60,1680,"Ecc",-20,-100,FALSE,FALSE,FALSE,3.64,"young",40,181,92,"m"
19,"CHEST PRESS",1,"Ecc02",1580,1580,1450,1450,1580,1450,0.082,130,1515,"Ecc",0,0,FALSE,FALSE,FALSE,8.97,"young",40,181,92,"m"
19,"CHEST PRESS",1,"Ecc03",1600,1620,1450,1550,1610,1500,0.068,110,1555,"Ecc",-20,-100,FALSE,FALSE,FALSE,7.33,"young",40,181,92,"m"
19,"CHEST PRESS",1,"Ecc04",1540,1560,1450,1500,1550,1475,0.048,75,1512.5,"Ecc",-20,-50,FALSE,FALSE,FALSE,5.08,"young",40,181,92,"m"
19,"CHEST PRESS",1,"Ecc05",1660,1640,1650,1600,1650,1625,0.015,25,1637.5,"Ecc",20,50,FALSE,FALSE,FALSE,1.54,"young",40,181,92,"m"
19,"CHEST PRESS",1,"Ecc06",1540,1540,1550,1550,1540,1550,0.006,-10,1545,"Ecc",0,0,FALSE,FALSE,FALSE,0.65,"young",40,181,92,"m"
19,"CHEST PRESS",1,"Ecc07",1640,1640,1650,1650,1640,1650,0.006,-10,1645,"Ecc",0,0,FALSE,FALSE,FALSE,0.61,"young",40,181,92,"m"
19,"CHEST PRESS",1,"Ecc08",1520,1520,1500,1450,1520,1475,0.03,45,1497.5,"Ecc",0,50,FALSE,FALSE,FALSE,3.05,"young",40,181,92,"m"
19,"CHEST PRESS",1,"Ecc09",1560,1540,1400,1350,1550,1375,0.113,175,1462.5,"Ecc",20,50,FALSE,FALSE,FALSE,12.73,"young",40,181,92,"m"
19,"CHEST PRESS",1,"Ecc10",2960,2980,4250,4250,2970,4250,0.431,-1280,3610,"Ecc",-20,0,TRUE,FALSE,FALSE,30.12,"young",40,181,92,"m"
19,"CHEST PRESS",2,"Ecc01",1500,1500,1350,1500,1500,1425,0.05,75,1462.5,"Ecc",0,-150,FALSE,FALSE,FALSE,5.26,"young",40,181,92,"m"
19,"CHEST PRESS",2,"Ecc02",1280,1260,1350,1400,1270,1375,0.083,-105,1322.5,"Ecc",20,-50,FALSE,FALSE,FALSE,7.64,"young",40,181,92,"m"
19,"CHEST PRESS",2,"Ecc03",1500,1460,1550,1550,1480,1550,0.047,-70,1515,"Ecc",40,0,FALSE,TRUE,FALSE,4.52,"young",40,181,92,"m"
19,"CHEST PRESS",2,"Ecc04",1460,1420,1400,1450,1440,1425,0.01,15,1432.5,"Ecc",40,-50,FALSE,TRUE,FALSE,1.05,"young",40,181,92,"m"
19,"CHEST PRESS",2,"Ecc05",1380,1360,1450,1350,1370,1400,0.022,-30,1385,"Ecc",20,100,FALSE,FALSE,FALSE,2.14,"young",40,181,92,"m"
19,"CHEST PRESS",2,"Ecc06",1500,1460,1350,1300,1480,1325,0.105,155,1402.5,"Ecc",40,50,FALSE,TRUE,FALSE,11.7,"young",40,181,92,"m"
19,"CHEST PRESS",2,"Ecc07",1460,1440,1250,1200,1450,1225,0.155,225,1337.5,"Ecc",20,50,FALSE,FALSE,FALSE,18.37,"young",40,181,92,"m"
19,"CHEST PRESS",2,"Ecc08",1540,1520,1300,1250,1530,1275,0.167,255,1402.5,"Ecc",20,50,FALSE,FALSE,FALSE,20,"young",40,181,92,"m"
19,"CHEST PRESS",2,"Ecc09",1520,1480,1350,1300,1500,1325,0.117,175,1412.5,"Ecc",40,50,FALSE,TRUE,FALSE,13.21,"young",40,181,92,"m"
19,"CHEST PRESS",2,"Ecc10",2020,2020,1850,2150,2020,2000,0.01,20,2010,"Ecc",0,-300,FALSE,FALSE,TRUE,1,"young",40,181,92,"m"
19,"CHEST PRESS",1,"Rep01",3300,3280,3700,3250,3290,3475,0.056,-185,3382.5,"Rep",20,450,TRUE,FALSE,TRUE,5.32,"young",40,181,92,"m"
19,"CHEST PRESS",1,"Rep02",2600,2580,2600,2550,2590,2575,0.006,15,2582.5,"Rep",20,50,FALSE,FALSE,FALSE,0.58,"young",40,181,92,"m"
19,"CHEST PRESS",1,"Rep03",2640,2660,2600,2700,2650,2650,0,0,2650,"Rep",-20,-100,FALSE,FALSE,FALSE,0,"young",40,181,92,"m"
19,"CHEST PRESS",1,"Rep04",2580,2580,2650,2600,2580,2625,0.017,-45,2602.5,"Rep",0,50,FALSE,FALSE,FALSE,1.71,"young",40,181,92,"m"
19,"CHEST PRESS",1,"Rep05",2760,2720,2800,2750,2740,2775,0.013,-35,2757.5,"Rep",40,50,FALSE,FALSE,FALSE,1.26,"young",40,181,92,"m"
19,"CHEST PRESS",1,"Rep06",2620,2640,2600,2650,2630,2625,0.002,5,2627.5,"Rep",-20,-50,FALSE,FALSE,FALSE,0.19,"young",40,181,92,"m"
19,"CHEST PRESS",1,"Rep07",2760,2760,2750,2750,2760,2750,0.004,10,2755,"Rep",0,0,FALSE,FALSE,FALSE,0.36,"young",40,181,92,"m"
19,"CHEST PRESS",1,"Rep08",2600,2600,2600,2550,2600,2575,0.01,25,2587.5,"Rep",0,50,FALSE,FALSE,FALSE,0.97,"young",40,181,92,"m"
19,"CHEST PRESS",1,"Rep09",2820,2820,2700,2750,2820,2725,0.034,95,2772.5,"Rep",0,-50,FALSE,FALSE,FALSE,3.49,"young",40,181,92,"m"
19,"CHEST PRESS",1,"Rep10",4420,4440,6000,5950,4430,5975,0.349,-1545,5202.5,"Rep",-20,50,TRUE,FALSE,FALSE,25.86,"young",40,181,92,"m"
19,"CHEST PRESS",2,"Rep01",2560,2580,2550,2650,2570,2600,0.012,-30,2585,"Rep",-20,-100,FALSE,FALSE,FALSE,1.15,"young",40,181,92,"m"
19,"CHEST PRESS",2,"Rep02",2280,2260,2350,2300,2270,2325,0.024,-55,2297.5,"Rep",20,50,FALSE,FALSE,FALSE,2.37,"young",40,181,92,"m"
19,"CHEST PRESS",2,"Rep03",2560,2560,2550,2550,2560,2550,0.004,10,2555,"Rep",0,0,FALSE,FALSE,FALSE,0.39,"young",40,181,92,"m"
19,"CHEST PRESS",2,"Rep04",2500,2520,2450,2450,2510,2450,0.024,60,2480,"Rep",-20,0,FALSE,FALSE,FALSE,2.45,"young",40,181,92,"m"
19,"CHEST PRESS",2,"Rep05",2440,2440,2550,2450,2440,2500,0.025,-60,2470,"Rep",0,100,FALSE,FALSE,FALSE,2.4,"young",40,181,92,"m"
19,"CHEST PRESS",2,"Rep06",2580,2560,2400,2450,2570,2425,0.056,145,2497.5,"Rep",20,-50,TRUE,FALSE,FALSE,5.98,"young",40,181,92,"m"
19,"CHEST PRESS",2,"Rep07",2560,2560,2500,2500,2560,2500,0.023,60,2530,"Rep",0,0,FALSE,FALSE,FALSE,2.4,"young",40,181,92,"m"
19,"CHEST PRESS",2,"Rep08",2620,2620,2700,2700,2620,2700,0.031,-80,2660,"Rep",0,0,FALSE,FALSE,FALSE,2.96,"young",40,181,92,"m"
19,"CHEST PRESS",2,"Rep09",2700,2700,2700,2700,2700,2700,0,0,2700,"Rep",0,0,FALSE,FALSE,FALSE,0,"young",40,181,92,"m"
19,"CHEST PRESS",2,"Rep10",3600,3620,3650,4000,3610,3825,0.06,-215,3717.5,"Rep",-20,-350,TRUE,FALSE,TRUE,5.62,"young",40,181,92,"m"
19,"CHEST PRESS",1,"TuT",29100,29080,31000,30500,29090,30750,0.057,-1660,29920,"TuT",20,500,FALSE,FALSE,FALSE,5.4,"young",40,181,92,"m"
19,"CHEST PRESS",2,"TuT",26400,26420,26400,26750,26410,26575,0.006,-165,26492.5,"TuT",-20,-350,FALSE,FALSE,FALSE,0.62,"young",40,181,92,"m"
20,"LEG PRESS",1,"Con01",1760,1780,1950,1800,1770,1875,0.059,-105,1822.5,"Con",-20,150,FALSE,FALSE,FALSE,5.6,"old",63,178,74,"m"
20,"LEG PRESS",1,"Con02",1520,1540,1600,1600,1530,1600,0.046,-70,1565,"Con",-20,0,FALSE,FALSE,FALSE,4.38,"old",63,178,74,"m"
20,"LEG PRESS",1,"Con03",1560,1560,1550,1450,1560,1500,0.038,60,1530,"Con",0,100,FALSE,FALSE,FALSE,4,"old",63,178,74,"m"
20,"LEG PRESS",1,"Con04",1400,1360,1400,1350,1380,1375,0.004,5,1377.5,"Con",40,50,FALSE,FALSE,FALSE,0.36,"old",63,178,74,"m"
20,"LEG PRESS",1,"Con05",1240,1260,1300,1300,1250,1300,0.04,-50,1275,"Con",-20,0,FALSE,FALSE,FALSE,3.85,"old",63,178,74,"m"
20,"LEG PRESS",1,"Con06",1200,1220,1250,1250,1210,1250,0.033,-40,1230,"Con",-20,0,FALSE,FALSE,FALSE,3.2,"old",63,178,74,"m"
20,"LEG PRESS",1,"Con07",1160,1180,1200,1250,1170,1225,0.047,-55,1197.5,"Con",-20,-50,FALSE,FALSE,FALSE,4.49,"old",63,178,74,"m"
20,"LEG PRESS",1,"Con08",1300,1280,1400,1450,1290,1425,0.105,-135,1357.5,"Con",20,-50,FALSE,FALSE,FALSE,9.47,"old",63,178,74,"m"
20,"LEG PRESS",1,"Con09",1160,1140,1350,1400,1150,1375,0.196,-225,1262.5,"Con",20,-50,FALSE,FALSE,FALSE,16.36,"old",63,178,74,"m"
20,"LEG PRESS",1,"Con10",1240,1240,1450,1550,1240,1500,0.21,-260,1370,"Con",0,-100,FALSE,FALSE,FALSE,17.33,"old",63,178,74,"m"
20,"LEG PRESS",2,"Con01",1620,1620,1850,2100,1620,1975,0.219,-355,1797.5,"Con",0,-250,TRUE,FALSE,TRUE,17.97,"old",63,178,74,"m"
20,"LEG PRESS",2,"Con02",1400,1380,1400,1350,1390,1375,0.011,15,1382.5,"Con",20,50,FALSE,FALSE,FALSE,1.09,"old",63,178,74,"m"
20,"LEG PRESS",2,"Con03",1220,1220,1250,1200,1220,1225,0.004,-5,1222.5,"Con",0,50,FALSE,FALSE,FALSE,0.41,"old",63,178,74,"m"
20,"LEG PRESS",2,"Con04",1200,1220,1250,1200,1210,1225,0.012,-15,1217.5,"Con",-20,50,FALSE,FALSE,FALSE,1.22,"old",63,178,74,"m"
20,"LEG PRESS",2,"Con05",1140,1160,1200,1200,1150,1200,0.043,-50,1175,"Con",-20,0,FALSE,FALSE,FALSE,4.17,"old",63,178,74,"m"
20,"LEG PRESS",2,"Con06",1120,1160,1200,1250,1140,1225,0.075,-85,1182.5,"Con",-40,-50,FALSE,FALSE,FALSE,6.94,"old",63,178,74,"m"
20,"LEG PRESS",2,"Con07",1120,1120,1250,1250,1120,1250,0.116,-130,1185,"Con",0,0,FALSE,FALSE,FALSE,10.4,"old",63,178,74,"m"
20,"LEG PRESS",2,"Con08",1120,1120,1250,1250,1120,1250,0.116,-130,1185,"Con",0,0,FALSE,FALSE,FALSE,10.4,"old",63,178,74,"m"
20,"LEG PRESS",2,"Con09",1180,1180,1350,1350,1180,1350,0.144,-170,1265,"Con",0,0,FALSE,FALSE,FALSE,12.59,"old",63,178,74,"m"
20,"LEG PRESS",2,"Con10",1140,1160,1350,1350,1150,1350,0.174,-200,1250,"Con",-20,0,FALSE,FALSE,FALSE,14.81,"old",63,178,74,"m"
20,"LEG PRESS",1,"Ecc01",3200,3200,3150,3150,3200,3150,0.016,50,3175,"Ecc",0,0,FALSE,FALSE,FALSE,1.59,"old",63,178,74,"m"
20,"LEG PRESS",1,"Ecc02",2180,2200,2200,2250,2190,2225,0.016,-35,2207.5,"Ecc",-20,-50,FALSE,FALSE,FALSE,1.57,"old",63,178,74,"m"
20,"LEG PRESS",1,"Ecc03",1880,1880,1850,1950,1880,1900,0.011,-20,1890,"Ecc",0,-100,FALSE,FALSE,FALSE,1.05,"old",63,178,74,"m"
20,"LEG PRESS",1,"Ecc04",1780,1780,1750,1750,1780,1750,0.017,30,1765,"Ecc",0,0,FALSE,FALSE,FALSE,1.71,"old",63,178,74,"m"
20,"LEG PRESS",1,"Ecc05",1680,1660,1650,1650,1670,1650,0.012,20,1660,"Ecc",20,0,FALSE,FALSE,FALSE,1.21,"old",63,178,74,"m"
20,"LEG PRESS",1,"Ecc06",1600,1580,1550,1500,1590,1525,0.041,65,1557.5,"Ecc",20,50,FALSE,FALSE,FALSE,4.26,"old",63,178,74,"m"
20,"LEG PRESS",1,"Ecc07",1620,1600,1550,1500,1610,1525,0.053,85,1567.5,"Ecc",20,50,FALSE,FALSE,FALSE,5.57,"old",63,178,74,"m"
20,"LEG PRESS",1,"Ecc08",1660,1680,1500,1450,1670,1475,0.117,195,1572.5,"Ecc",-20,50,FALSE,FALSE,FALSE,13.22,"old",63,178,74,"m"
20,"LEG PRESS",1,"Ecc09",1840,1840,1600,1550,1840,1575,0.144,265,1707.5,"Ecc",0,50,FALSE,FALSE,FALSE,16.83,"old",63,178,74,"m"
20,"LEG PRESS",1,"Ecc10",2400,2420,1850,1850,2410,1850,0.232,560,2130,"Ecc",-20,0,TRUE,FALSE,FALSE,30.27,"old",63,178,74,"m"
20,"LEG PRESS",2,"Ecc01",2860,2840,2800,2850,2850,2825,0.009,25,2837.5,"Ecc",20,-50,FALSE,FALSE,FALSE,0.88,"old",63,178,74,"m"
20,"LEG PRESS",2,"Ecc02",1860,1880,1900,1900,1870,1900,0.016,-30,1885,"Ecc",-20,0,FALSE,FALSE,FALSE,1.58,"old",63,178,74,"m"
20,"LEG PRESS",2,"Ecc03",1720,1700,1650,1750,1710,1700,0.006,10,1705,"Ecc",20,-100,FALSE,FALSE,FALSE,0.59,"old",63,178,74,"m"
20,"LEG PRESS",2,"Ecc04",1620,1600,1600,1600,1610,1600,0.006,10,1605,"Ecc",20,0,FALSE,FALSE,FALSE,0.62,"old",63,178,74,"m"
20,"LEG PRESS",2,"Ecc05",1780,1760,1700,1650,1770,1675,0.054,95,1722.5,"Ecc",20,50,FALSE,FALSE,FALSE,5.67,"old",63,178,74,"m"
20,"LEG PRESS",2,"Ecc06",1500,1480,1400,1400,1490,1400,0.06,90,1445,"Ecc",20,0,FALSE,FALSE,FALSE,6.43,"old",63,178,74,"m"
20,"LEG PRESS",2,"Ecc07",1400,1400,1250,1250,1400,1250,0.107,150,1325,"Ecc",0,0,FALSE,FALSE,FALSE,12,"old",63,178,74,"m"
20,"LEG PRESS",2,"Ecc08",1700,1680,1550,1550,1690,1550,0.083,140,1620,"Ecc",20,0,FALSE,FALSE,FALSE,9.03,"old",63,178,74,"m"
20,"LEG PRESS",2,"Ecc09",1640,1640,1450,1450,1640,1450,0.116,190,1545,"Ecc",0,0,FALSE,FALSE,FALSE,13.1,"old",63,178,74,"m"
20,"LEG PRESS",2,"Ecc10",2460,2440,2400,2400,2450,2400,0.02,50,2425,"Ecc",20,0,FALSE,FALSE,FALSE,2.08,"old",63,178,74,"m"
20,"LEG PRESS",1,"Rep01",4960,4980,5100,4950,4970,5025,0.011,-55,4997.5,"Rep",-20,150,FALSE,FALSE,TRUE,1.09,"old",63,178,74,"m"
20,"LEG PRESS",1,"Rep02",3700,3740,3800,3850,3720,3825,0.028,-105,3772.5,"Rep",-40,-50,FALSE,FALSE,FALSE,2.75,"old",63,178,74,"m"
20,"LEG PRESS",1,"Rep03",3440,3440,3400,3400,3440,3400,0.012,40,3420,"Rep",0,0,FALSE,FALSE,FALSE,1.18,"old",63,178,74,"m"
20,"LEG PRESS",1,"Rep04",3180,3140,3150,3100,3160,3125,0.011,35,3142.5,"Rep",40,50,FALSE,FALSE,FALSE,1.12,"old",63,178,74,"m"
20,"LEG PRESS",1,"Rep05",2920,2920,2950,2950,2920,2950,0.01,-30,2935,"Rep",0,0,FALSE,FALSE,FALSE,1.02,"old",63,178,74,"m"
20,"LEG PRESS",1,"Rep06",2800,2800,2800,2750,2800,2775,0.009,25,2787.5,"Rep",0,50,FALSE,FALSE,FALSE,0.9,"old",63,178,74,"m"
20,"LEG PRESS",1,"Rep07",2780,2780,2750,2750,2780,2750,0.011,30,2765,"Rep",0,0,FALSE,FALSE,FALSE,1.09,"old",63,178,74,"m"
20,"LEG PRESS",1,"Rep08",2960,2960,2900,2900,2960,2900,0.02,60,2930,"Rep",0,0,FALSE,FALSE,FALSE,2.07,"old",63,178,74,"m"
20,"LEG PRESS",1,"Rep09",3000,2980,2950,2950,2990,2950,0.013,40,2970,"Rep",20,0,FALSE,FALSE,FALSE,1.36,"old",63,178,74,"m"
20,"LEG PRESS",1,"Rep10",3640,3660,3300,3400,3650,3350,0.082,300,3500,"Rep",-20,-100,TRUE,FALSE,TRUE,8.96,"old",63,178,74,"m"
20,"LEG PRESS",2,"Rep01",4480,4460,4650,4950,4470,4800,0.074,-330,4635,"Rep",20,-300,TRUE,FALSE,TRUE,6.88,"old",63,178,74,"m"
20,"LEG PRESS",2,"Rep02",3260,3260,3300,3250,3260,3275,0.005,-15,3267.5,"Rep",0,50,FALSE,FALSE,FALSE,0.46,"old",63,178,74,"m"
20,"LEG PRESS",2,"Rep03",2940,2920,2900,2950,2930,2925,0.002,5,2927.5,"Rep",20,-50,FALSE,FALSE,FALSE,0.17,"old",63,178,74,"m"
20,"LEG PRESS",2,"Rep04",2820,2820,2850,2800,2820,2825,0.002,-5,2822.5,"Rep",0,50,FALSE,FALSE,FALSE,0.18,"old",63,178,74,"m"
20,"LEG PRESS",2,"Rep05",2920,2920,2900,2850,2920,2875,0.015,45,2897.5,"Rep",0,50,FALSE,FALSE,FALSE,1.57,"old",63,178,74,"m"
20,"LEG PRESS",2,"Rep06",2620,2640,2600,2650,2630,2625,0.002,5,2627.5,"Rep",-20,-50,FALSE,FALSE,FALSE,0.19,"old",63,178,74,"m"
20,"LEG PRESS",2,"Rep07",2520,2520,2500,2500,2520,2500,0.008,20,2510,"Rep",0,0,FALSE,FALSE,FALSE,0.8,"old",63,178,74,"m"
20,"LEG PRESS",2,"Rep08",2820,2800,2800,2800,2810,2800,0.004,10,2805,"Rep",20,0,FALSE,FALSE,FALSE,0.36,"old",63,178,74,"m"
20,"LEG PRESS",2,"Rep09",2820,2820,2800,2800,2820,2800,0.007,20,2810,"Rep",0,0,FALSE,FALSE,FALSE,0.71,"old",63,178,74,"m"
20,"LEG PRESS",2,"Rep10",3600,3600,3750,3750,3600,3750,0.042,-150,3675,"Rep",0,0,TRUE,FALSE,FALSE,4,"old",63,178,74,"m"
20,"LEG PRESS",1,"TuT",33380,33400,33100,33000,33390,33050,0.01,340,33220,"TuT",-20,100,FALSE,FALSE,FALSE,1.03,"old",63,178,74,"m"
20,"LEG PRESS",2,"TuT",30800,30760,31050,31300,30780,31175,0.013,-395,30977.5,"TuT",40,-250,FALSE,FALSE,FALSE,1.27,"old",63,178,74,"m"
20,"LEG EXTENSION",1,"Con01",3620,3600,1950,3700,3610,2825,0.217,785,3217.5,"Con",20,-1750,TRUE,FALSE,TRUE,27.79,"old",63,178,74,"m"
20,"LEG EXTENSION",1,"Con02",2680,2660,2600,2750,2670,2675,0.002,-5,2672.5,"Con",20,-150,FALSE,FALSE,FALSE,0.19,"old",63,178,74,"m"
20,"LEG EXTENSION",1,"Con03",2440,2460,2150,2300,2450,2225,0.092,225,2337.5,"Con",-20,-150,TRUE,FALSE,FALSE,10.11,"old",63,178,74,"m"
20,"LEG EXTENSION",1,"Con04",2160,2160,2100,2050,2160,2075,0.039,85,2117.5,"Con",0,50,FALSE,FALSE,FALSE,4.1,"old",63,178,74,"m"
20,"LEG EXTENSION",1,"Con05",1880,1900,2050,1950,1890,2000,0.058,-110,1945,"Con",-20,100,FALSE,FALSE,FALSE,5.5,"old",63,178,74,"m"
20,"LEG EXTENSION",1,"Con06",1760,1740,1950,1850,1750,1900,0.086,-150,1825,"Con",20,100,FALSE,FALSE,FALSE,7.89,"old",63,178,74,"m"
20,"LEG EXTENSION",1,"Con07",1700,1740,1950,1900,1720,1925,0.119,-205,1822.5,"Con",-40,50,TRUE,TRUE,FALSE,10.65,"old",63,178,74,"m"
20,"LEG EXTENSION",1,"Con08",1540,1540,1650,1650,1540,1650,0.071,-110,1595,"Con",0,0,FALSE,FALSE,FALSE,6.67,"old",63,178,74,"m"
20,"LEG EXTENSION",1,"Con09",1300,1280,1650,1700,1290,1675,0.298,-385,1482.5,"Con",20,-50,TRUE,FALSE,FALSE,22.99,"old",63,178,74,"m"
20,"LEG EXTENSION",1,"Con10",1300,1340,1500,1550,1320,1525,0.155,-205,1422.5,"Con",-40,-50,TRUE,TRUE,FALSE,13.44,"old",63,178,74,"m"
20,"LEG EXTENSION",2,"Con01",2220,2240,2100,2250,2230,2175,0.025,55,2202.5,"Con",-20,-150,FALSE,FALSE,FALSE,2.53,"old",63,178,74,"m"
20,"LEG EXTENSION",2,"Con02",1520,1520,1650,1700,1520,1675,0.102,-155,1597.5,"Con",0,-50,FALSE,FALSE,FALSE,9.25,"old",63,178,74,"m"
20,"LEG EXTENSION",2,"Con03",1320,1280,1450,1350,1300,1400,0.077,-100,1350,"Con",40,100,FALSE,TRUE,FALSE,7.14,"old",63,178,74,"m"
20,"LEG EXTENSION",2,"Con04",1240,1240,1400,1250,1240,1325,0.069,-85,1282.5,"Con",0,150,FALSE,FALSE,FALSE,6.42,"old",63,178,74,"m"
20,"LEG EXTENSION",2,"Con05",1140,1120,1250,1150,1130,1200,0.062,-70,1165,"Con",20,100,FALSE,FALSE,FALSE,5.83,"old",63,178,74,"m"
20,"LEG EXTENSION",2,"Con06",1080,1080,1150,1200,1080,1175,0.088,-95,1127.5,"Con",0,-50,FALSE,FALSE,FALSE,8.09,"old",63,178,74,"m"
20,"LEG EXTENSION",2,"Con07",1140,1160,1200,1300,1150,1250,0.087,-100,1200,"Con",-20,-100,FALSE,FALSE,FALSE,8,"old",63,178,74,"m"
20,"LEG EXTENSION",2,"Con08",1220,1220,1300,1300,1220,1300,0.066,-80,1260,"Con",0,0,FALSE,FALSE,FALSE,6.15,"old",63,178,74,"m"
20,"LEG EXTENSION",2,"Con09",1160,1140,1200,1300,1150,1250,0.087,-100,1200,"Con",20,-100,FALSE,FALSE,FALSE,8,"old",63,178,74,"m"
20,"LEG EXTENSION",2,"Con10",1200,1180,1300,1400,1190,1350,0.134,-160,1270,"Con",20,-100,FALSE,FALSE,FALSE,11.85,"old",63,178,74,"m"
20,"LEG EXTENSION",1,"Ecc01",4720,4760,4700,4600,4740,4650,0.019,90,4695,"Ecc",-40,100,FALSE,TRUE,FALSE,1.94,"old",63,178,74,"m"
20,"LEG EXTENSION",1,"Ecc02",4100,4100,4450,4150,4100,4300,0.049,-200,4200,"Ecc",0,300,TRUE,FALSE,TRUE,4.65,"old",63,178,74,"m"
20,"LEG EXTENSION",1,"Ecc03",3660,3660,3700,3650,3660,3675,0.004,-15,3667.5,"Ecc",0,50,FALSE,FALSE,FALSE,0.41,"old",63,178,74,"m"
20,"LEG EXTENSION",1,"Ecc04",3440,3440,3400,3500,3440,3450,0.003,-10,3445,"Ecc",0,-100,FALSE,FALSE,FALSE,0.29,"old",63,178,74,"m"
20,"LEG EXTENSION",1,"Ecc05",3140,3120,2900,3050,3130,2975,0.05,155,3052.5,"Ecc",20,-150,FALSE,FALSE,FALSE,5.21,"old",63,178,74,"m"
20,"LEG EXTENSION",1,"Ecc06",2520,2520,2400,2450,2520,2425,0.038,95,2472.5,"Ecc",0,-50,FALSE,FALSE,FALSE,3.92,"old",63,178,74,"m"
20,"LEG EXTENSION",1,"Ecc07",2640,2620,2450,2450,2630,2450,0.068,180,2540,"Ecc",20,0,FALSE,FALSE,FALSE,7.35,"old",63,178,74,"m"
20,"LEG EXTENSION",1,"Ecc08",2480,2500,2200,2150,2490,2175,0.127,315,2332.5,"Ecc",-20,50,TRUE,FALSE,FALSE,14.48,"old",63,178,74,"m"
20,"LEG EXTENSION",1,"Ecc09",2460,2440,2200,2200,2450,2200,0.102,250,2325,"Ecc",20,0,TRUE,FALSE,FALSE,11.36,"old",63,178,74,"m"
20,"LEG EXTENSION",1,"Ecc10",2520,2520,2450,2450,2520,2450,0.028,70,2485,"Ecc",0,0,FALSE,FALSE,FALSE,2.86,"old",63,178,74,"m"
20,"LEG EXTENSION",2,"Ecc01",3200,3180,3150,3100,3190,3125,0.02,65,3157.5,"Ecc",20,50,FALSE,FALSE,FALSE,2.08,"old",63,178,74,"m"
20,"LEG EXTENSION",2,"Ecc02",2280,2320,2200,2200,2300,2200,0.043,100,2250,"Ecc",-40,0,FALSE,TRUE,FALSE,4.55,"old",63,178,74,"m"
20,"LEG EXTENSION",2,"Ecc03",2400,2400,2200,2400,2400,2300,0.042,100,2350,"Ecc",0,-200,FALSE,FALSE,TRUE,4.35,"old",63,178,74,"m"
20,"LEG EXTENSION",2,"Ecc04",1960,1960,1850,1950,1960,1900,0.031,60,1930,"Ecc",0,-100,FALSE,FALSE,FALSE,3.16,"old",63,178,74,"m"
20,"LEG EXTENSION",2,"Ecc05",1780,1800,1700,1700,1790,1700,0.05,90,1745,"Ecc",-20,0,FALSE,FALSE,FALSE,5.29,"old",63,178,74,"m"
20,"LEG EXTENSION",2,"Ecc06",1840,1820,1800,1700,1830,1750,0.044,80,1790,"Ecc",20,100,FALSE,FALSE,FALSE,4.57,"old",63,178,74,"m"
20,"LEG EXTENSION",2,"Ecc07",1880,1880,1800,1750,1880,1775,0.056,105,1827.5,"Ecc",0,50,FALSE,FALSE,FALSE,5.92,"old",63,178,74,"m"
20,"LEG EXTENSION",2,"Ecc08",1840,1860,1750,1700,1850,1725,0.068,125,1787.5,"Ecc",-20,50,FALSE,FALSE,FALSE,7.25,"old",63,178,74,"m"
20,"LEG EXTENSION",2,"Ecc09",1680,1700,1650,1550,1690,1600,0.053,90,1645,"Ecc",-20,100,FALSE,FALSE,FALSE,5.62,"old",63,178,74,"m"
20,"LEG EXTENSION",2,"Ecc10",3180,3160,3100,3150,3170,3125,0.014,45,3147.5,"Ecc",20,-50,FALSE,FALSE,FALSE,1.44,"old",63,178,74,"m"
20,"LEG EXTENSION",1,"Rep01",8340,8360,6650,8300,8350,7475,0.105,875,7912.5,"Rep",-20,-1650,TRUE,FALSE,TRUE,11.71,"old",63,178,74,"m"
20,"LEG EXTENSION",1,"Rep02",6780,6760,7050,6900,6770,6975,0.03,-205,6872.5,"Rep",20,150,TRUE,FALSE,FALSE,2.94,"old",63,178,74,"m"
20,"LEG EXTENSION",1,"Rep03",6100,6120,5850,5950,6110,5900,0.034,210,6005,"Rep",-20,-100,TRUE,FALSE,FALSE,3.56,"old",63,178,74,"m"
20,"LEG EXTENSION",1,"Rep04",5600,5600,5500,5550,5600,5525,0.013,75,5562.5,"Rep",0,-50,FALSE,FALSE,FALSE,1.36,"old",63,178,74,"m"
20,"LEG EXTENSION",1,"Rep05",5020,5020,4950,5000,5020,4975,0.009,45,4997.5,"Rep",0,-50,FALSE,FALSE,FALSE,0.9,"old",63,178,74,"m"
20,"LEG EXTENSION",1,"Rep06",4280,4260,4350,4300,4270,4325,0.013,-55,4297.5,"Rep",20,50,FALSE,FALSE,FALSE,1.27,"old",63,178,74,"m"
20,"LEG EXTENSION",1,"Rep07",4340,4360,4400,4350,4350,4375,0.006,-25,4362.5,"Rep",-20,50,FALSE,FALSE,FALSE,0.57,"old",63,178,74,"m"
20,"LEG EXTENSION",1,"Rep08",4020,4040,3850,3800,4030,3825,0.051,205,3927.5,"Rep",-20,50,TRUE,FALSE,FALSE,5.36,"old",63,178,74,"m"
20,"LEG EXTENSION",1,"Rep09",3760,3720,3850,3900,3740,3875,0.036,-135,3807.5,"Rep",40,-50,TRUE,FALSE,FALSE,3.48,"old",63,178,74,"m"
20,"LEG EXTENSION",1,"Rep10",3820,3860,3950,4000,3840,3975,0.035,-135,3907.5,"Rep",-40,-50,TRUE,FALSE,FALSE,3.4,"old",63,178,74,"m"
20,"LEG EXTENSION",2,"Rep01",5420,5420,5250,5350,5420,5300,0.022,120,5360,"Rep",0,-100,TRUE,FALSE,FALSE,2.26,"old",63,178,74,"m"
20,"LEG EXTENSION",2,"Rep02",3800,3840,3850,3900,3820,3875,0.014,-55,3847.5,"Rep",-40,-50,FALSE,FALSE,FALSE,1.42,"old",63,178,74,"m"
20,"LEG EXTENSION",2,"Rep03",3720,3680,3650,3750,3700,3700,0,0,3700,"Rep",40,-100,FALSE,FALSE,FALSE,0,"old",63,178,74,"m"
20,"LEG EXTENSION",2,"Rep04",3200,3200,3250,3200,3200,3225,0.008,-25,3212.5,"Rep",0,50,FALSE,FALSE,FALSE,0.78,"old",63,178,74,"m"
20,"LEG EXTENSION",2,"Rep05",2920,2920,2950,2850,2920,2900,0.007,20,2910,"Rep",0,100,FALSE,FALSE,FALSE,0.69,"old",63,178,74,"m"
20,"LEG EXTENSION",2,"Rep06",2920,2900,2950,2900,2910,2925,0.005,-15,2917.5,"Rep",20,50,FALSE,FALSE,FALSE,0.51,"old",63,178,74,"m"
20,"LEG EXTENSION",2,"Rep07",3020,3040,3000,3050,3030,3025,0.002,5,3027.5,"Rep",-20,-50,FALSE,FALSE,FALSE,0.17,"old",63,178,74,"m"
20,"LEG EXTENSION",2,"Rep08",3060,3080,3050,3000,3070,3025,0.015,45,3047.5,"Rep",-20,50,FALSE,FALSE,FALSE,1.49,"old",63,178,74,"m"
20,"LEG EXTENSION",2,"Rep09",2840,2840,2850,2850,2840,2850,0.004,-10,2845,"Rep",0,0,FALSE,FALSE,FALSE,0.35,"old",63,178,74,"m"
20,"LEG EXTENSION",2,"Rep10",4380,4340,4400,4550,4360,4475,0.026,-115,4417.5,"Rep",40,-150,TRUE,FALSE,FALSE,2.57,"old",63,178,74,"m"
20,"LEG EXTENSION",1,"TuT",52060,52100,50400,52050,52080,51225,0.016,855,51652.5,"TuT",-40,-1650,TRUE,FALSE,TRUE,1.67,"old",63,178,74,"m"
20,"LEG EXTENSION",2,"TuT",35280,35260,35200,35400,35270,35300,0.001,-30,35285,"TuT",20,-200,FALSE,FALSE,TRUE,0.08,"old",63,178,74,"m"
20,"LEG CURL",1,"Con01",3560,3500,3500,3500,3530,3500,0.008,30,3515,"Con",60,0,FALSE,FALSE,FALSE,0.86,"old",63,178,74,"m"
20,"LEG CURL",1,"Con02",2720,2720,2700,2600,2720,2650,0.026,70,2685,"Con",0,100,FALSE,FALSE,FALSE,2.64,"old",63,178,74,"m"
20,"LEG CURL",1,"Con03",2060,2080,2050,2050,2070,2050,0.01,20,2060,"Con",-20,0,FALSE,FALSE,FALSE,0.98,"old",63,178,74,"m"
20,"LEG CURL",1,"Con04",1880,1940,1950,1900,1910,1925,0.008,-15,1917.5,"Con",-60,50,FALSE,FALSE,FALSE,0.78,"old",63,178,74,"m"
20,"LEG CURL",1,"Con05",1800,1820,1800,1900,1810,1850,0.022,-40,1830,"Con",-20,-100,FALSE,FALSE,FALSE,2.16,"old",63,178,74,"m"
20,"LEG CURL",1,"Con06",2160,2160,2150,2150,2160,2150,0.005,10,2155,"Con",0,0,FALSE,FALSE,FALSE,0.47,"old",63,178,74,"m"
20,"LEG CURL",1,"Con07",2340,2360,2350,2350,2350,2350,0,0,2350,"Con",-20,0,FALSE,FALSE,FALSE,0,"old",63,178,74,"m"
20,"LEG CURL",1,"Con08",2200,2240,2300,2300,2220,2300,0.036,-80,2260,"Con",-40,0,FALSE,FALSE,FALSE,3.48,"old",63,178,74,"m"
20,"LEG CURL",1,"Con09",2100,2120,2200,2150,2110,2175,0.031,-65,2142.5,"Con",-20,50,FALSE,FALSE,FALSE,2.99,"old",63,178,74,"m"
20,"LEG CURL",1,"Con10",2280,2300,2450,2450,2290,2450,0.07,-160,2370,"Con",-20,0,FALSE,FALSE,FALSE,6.53,"old",63,178,74,"m"
20,"LEG CURL",2,"Con01",3860,3880,2100,3700,3870,2900,0.251,970,3385,"Con",-20,-1600,TRUE,FALSE,TRUE,33.45,"old",63,178,74,"m"
20,"LEG CURL",2,"Con02",2660,2680,2400,2600,2670,2500,0.064,170,2585,"Con",-20,-200,FALSE,FALSE,TRUE,6.8,"old",63,178,74,"m"
20,"LEG CURL",2,"Con03",1880,1920,1950,2000,1900,1975,0.039,-75,1937.5,"Con",-40,-50,FALSE,FALSE,FALSE,3.8,"old",63,178,74,"m"
20,"LEG CURL",2,"Con04",2100,2120,2200,2100,2110,2150,0.019,-40,2130,"Con",-20,100,FALSE,FALSE,FALSE,1.86,"old",63,178,74,"m"
20,"LEG CURL",2,"Con05",2020,2060,2050,2050,2040,2050,0.005,-10,2045,"Con",-40,0,FALSE,FALSE,FALSE,0.49,"old",63,178,74,"m"
20,"LEG CURL",2,"Con06",2420,2420,2500,2500,2420,2500,0.033,-80,2460,"Con",0,0,FALSE,FALSE,FALSE,3.2,"old",63,178,74,"m"
20,"LEG CURL",2,"Con07",2120,2140,2100,2100,2130,2100,0.014,30,2115,"Con",-20,0,FALSE,FALSE,FALSE,1.43,"old",63,178,74,"m"
20,"LEG CURL",2,"Con08",1820,1820,1900,1850,1820,1875,0.03,-55,1847.5,"Con",0,50,FALSE,FALSE,FALSE,2.93,"old",63,178,74,"m"
20,"LEG CURL",2,"Con09",1980,2000,2000,2000,1990,2000,0.005,-10,1995,"Con",-20,0,FALSE,FALSE,FALSE,0.5,"old",63,178,74,"m"
20,"LEG CURL",2,"Con10",1960,2000,2100,2100,1980,2100,0.061,-120,2040,"Con",-40,0,FALSE,FALSE,FALSE,5.71,"old",63,178,74,"m"
20,"LEG CURL",1,"Ecc01",3480,3500,3550,3650,3490,3600,0.032,-110,3545,"Ecc",-20,-100,FALSE,FALSE,FALSE,3.06,"old",63,178,74,"m"
20,"LEG CURL",1,"Ecc02",3180,3160,3150,3200,3170,3175,0.002,-5,3172.5,"Ecc",20,-50,FALSE,FALSE,FALSE,0.16,"old",63,178,74,"m"
20,"LEG CURL",1,"Ecc03",2960,2920,2950,3000,2940,2975,0.012,-35,2957.5,"Ecc",40,-50,FALSE,FALSE,FALSE,1.18,"old",63,178,74,"m"
20,"LEG CURL",1,"Ecc04",2560,2520,2500,2450,2540,2475,0.026,65,2507.5,"Ecc",40,50,FALSE,FALSE,FALSE,2.63,"old",63,178,74,"m"
20,"LEG CURL",1,"Ecc05",2640,2640,2650,2600,2640,2625,0.006,15,2632.5,"Ecc",0,50,FALSE,FALSE,FALSE,0.57,"old",63,178,74,"m"
20,"LEG CURL",1,"Ecc06",2220,2200,2250,2250,2210,2250,0.018,-40,2230,"Ecc",20,0,FALSE,FALSE,FALSE,1.78,"old",63,178,74,"m"
20,"LEG CURL",1,"Ecc07",2620,2600,2550,2550,2610,2550,0.023,60,2580,"Ecc",20,0,FALSE,FALSE,FALSE,2.35,"old",63,178,74,"m"
20,"LEG CURL",1,"Ecc08",2560,2520,2450,2500,2540,2475,0.026,65,2507.5,"Ecc",40,-50,FALSE,FALSE,FALSE,2.63,"old",63,178,74,"m"
20,"LEG CURL",1,"Ecc09",3000,2980,2850,2850,2990,2850,0.047,140,2920,"Ecc",20,0,FALSE,FALSE,FALSE,4.91,"old",63,178,74,"m"
20,"LEG CURL",1,"Ecc10",3720,3720,3750,3300,3720,3525,0.052,195,3622.5,"Ecc",0,450,FALSE,FALSE,TRUE,5.53,"old",63,178,74,"m"
20,"LEG CURL",2,"Ecc01",3880,3840,4000,3950,3860,3975,0.03,-115,3917.5,"Ecc",40,50,FALSE,FALSE,FALSE,2.89,"old",63,178,74,"m"
20,"LEG CURL",2,"Ecc02",3040,3020,3200,3050,3030,3125,0.031,-95,3077.5,"Ecc",20,150,FALSE,FALSE,FALSE,3.04,"old",63,178,74,"m"
20,"LEG CURL",2,"Ecc03",2860,2840,2750,2800,2850,2775,0.026,75,2812.5,"Ecc",20,-50,FALSE,FALSE,FALSE,2.7,"old",63,178,74,"m"
20,"LEG CURL",2,"Ecc04",2260,2220,2150,2200,2240,2175,0.029,65,2207.5,"Ecc",40,-50,FALSE,FALSE,FALSE,2.99,"old",63,178,74,"m"
20,"LEG CURL",2,"Ecc05",2560,2540,2550,2550,2550,2550,0,0,2550,"Ecc",20,0,FALSE,FALSE,FALSE,0,"old",63,178,74,"m"
20,"LEG CURL",2,"Ecc06",2420,2400,2350,2350,2410,2350,0.025,60,2380,"Ecc",20,0,FALSE,FALSE,FALSE,2.55,"old",63,178,74,"m"
20,"LEG CURL",2,"Ecc07",2400,2380,2400,2400,2390,2400,0.004,-10,2395,"Ecc",20,0,FALSE,FALSE,FALSE,0.42,"old",63,178,74,"m"
20,"LEG CURL",2,"Ecc08",2280,2280,2250,2250,2280,2250,0.013,30,2265,"Ecc",0,0,FALSE,FALSE,FALSE,1.33,"old",63,178,74,"m"
20,"LEG CURL",2,"Ecc09",2400,2380,2300,2350,2390,2325,0.027,65,2357.5,"Ecc",20,-50,FALSE,FALSE,FALSE,2.8,"old",63,178,74,"m"
20,"LEG CURL",2,"Ecc10",4420,4400,4350,4350,4410,4350,0.014,60,4380,"Ecc",20,0,FALSE,FALSE,FALSE,1.38,"old",63,178,74,"m"
20,"LEG CURL",1,"Rep01",7040,7000,7050,7150,7020,7100,0.011,-80,7060,"Rep",40,-100,FALSE,FALSE,FALSE,1.13,"old",63,178,74,"m"
20,"LEG CURL",1,"Rep02",5900,5880,5850,5800,5890,5825,0.011,65,5857.5,"Rep",20,50,FALSE,FALSE,FALSE,1.12,"old",63,178,74,"m"
20,"LEG CURL",1,"Rep03",5020,5000,5000,5050,5010,5025,0.003,-15,5017.5,"Rep",20,-50,FALSE,FALSE,FALSE,0.3,"old",63,178,74,"m"
20,"LEG CURL",1,"Rep04",4440,4460,4450,4350,4450,4400,0.011,50,4425,"Rep",-20,100,FALSE,FALSE,FALSE,1.14,"old",63,178,74,"m"
20,"LEG CURL",1,"Rep05",4440,4460,4450,4500,4450,4475,0.006,-25,4462.5,"Rep",-20,-50,FALSE,FALSE,FALSE,0.56,"old",63,178,74,"m"
20,"LEG CURL",1,"Rep06",4380,4360,4400,4400,4370,4400,0.007,-30,4385,"Rep",20,0,FALSE,FALSE,FALSE,0.68,"old",63,178,74,"m"
20,"LEG CURL",1,"Rep07",4960,4960,4900,4900,4960,4900,0.012,60,4930,"Rep",0,0,FALSE,FALSE,FALSE,1.22,"old",63,178,74,"m"
20,"LEG CURL",1,"Rep08",4760,4760,4750,4800,4760,4775,0.003,-15,4767.5,"Rep",0,-50,FALSE,FALSE,FALSE,0.31,"old",63,178,74,"m"
20,"LEG CURL",1,"Rep09",5100,5100,5050,5000,5100,5025,0.015,75,5062.5,"Rep",0,50,FALSE,FALSE,FALSE,1.49,"old",63,178,74,"m"
20,"LEG CURL",1,"Rep10",6000,6020,6200,5750,6010,5975,0.006,35,5992.5,"Rep",-20,450,FALSE,FALSE,TRUE,0.59,"old",63,178,74,"m"
20,"LEG CURL",2,"Rep01",7740,7720,6100,7650,7730,6875,0.111,855,7302.5,"Rep",20,-1550,TRUE,FALSE,TRUE,12.44,"old",63,178,74,"m"
20,"LEG CURL",2,"Rep02",5700,5700,5600,5650,5700,5625,0.013,75,5662.5,"Rep",0,-50,FALSE,FALSE,FALSE,1.33,"old",63,178,74,"m"
20,"LEG CURL",2,"Rep03",4740,4760,4700,4800,4750,4750,0,0,4750,"Rep",-20,-100,FALSE,FALSE,FALSE,0,"old",63,178,74,"m"
20,"LEG CURL",2,"Rep04",4360,4340,4350,4300,4350,4325,0.006,25,4337.5,"Rep",20,50,FALSE,FALSE,FALSE,0.58,"old",63,178,74,"m"
20,"LEG CURL",2,"Rep05",4580,4600,4600,4600,4590,4600,0.002,-10,4595,"Rep",-20,0,FALSE,FALSE,FALSE,0.22,"old",63,178,74,"m"
20,"LEG CURL",2,"Rep06",4840,4820,4850,4850,4830,4850,0.004,-20,4840,"Rep",20,0,FALSE,FALSE,FALSE,0.41,"old",63,178,74,"m"
20,"LEG CURL",2,"Rep07",4520,4520,4500,4500,4520,4500,0.004,20,4510,"Rep",0,0,FALSE,FALSE,FALSE,0.44,"old",63,178,74,"m"
20,"LEG CURL",2,"Rep08",4100,4100,4150,4100,4100,4125,0.006,-25,4112.5,"Rep",0,50,FALSE,FALSE,FALSE,0.61,"old",63,178,74,"m"
20,"LEG CURL",2,"Rep09",4380,4380,4300,4350,4380,4325,0.013,55,4352.5,"Rep",0,-50,FALSE,FALSE,FALSE,1.27,"old",63,178,74,"m"
20,"LEG CURL",2,"Rep10",6380,6400,6450,6450,6390,6450,0.009,-60,6420,"Rep",-20,0,FALSE,FALSE,FALSE,0.93,"old",63,178,74,"m"
20,"LEG CURL",1,"TuT",52040,52000,52100,51700,52020,51900,0.002,120,51960,"TuT",40,400,FALSE,TRUE,TRUE,0.23,"old",63,178,74,"m"
20,"LEG CURL",2,"TuT",51340,51340,49600,51250,51340,50425,0.018,915,50882.5,"TuT",0,-1650,TRUE,FALSE,TRUE,1.81,"old",63,178,74,"m"
20,"ABDUCTOR",1,"Con01",1980,1980,1500,1150,1980,1325,0.331,655,1652.5,"Con",0,350,TRUE,FALSE,TRUE,49.43,"old",63,178,74,"m"
20,"ABDUCTOR",1,"Con02",1420,1420,1450,1000,1420,1225,0.137,195,1322.5,"Con",0,450,FALSE,FALSE,TRUE,15.92,"old",63,178,74,"m"
20,"ABDUCTOR",1,"Con03",1220,1220,1200,950,1220,1075,0.119,145,1147.5,"Con",0,250,FALSE,FALSE,TRUE,13.49,"old",63,178,74,"m"
20,"ABDUCTOR",1,"Con04",1020,1040,1100,1000,1030,1050,0.019,-20,1040,"Con",-20,100,FALSE,FALSE,FALSE,1.9,"old",63,178,74,"m"
20,"ABDUCTOR",1,"Con05",1020,1060,1000,1100,1040,1050,0.01,-10,1045,"Con",-40,-100,FALSE,TRUE,FALSE,0.95,"old",63,178,74,"m"
20,"ABDUCTOR",1,"Con06",860,860,1150,1650,860,1400,0.628,-540,1130,"Con",0,-500,TRUE,FALSE,TRUE,38.57,"old",63,178,74,"m"
20,"ABDUCTOR",1,"Con07",940,940,950,1450,940,1200,0.277,-260,1070,"Con",0,-500,FALSE,FALSE,TRUE,21.67,"old",63,178,74,"m"
20,"ABDUCTOR",1,"Con08",860,880,1050,1450,870,1250,0.437,-380,1060,"Con",-20,-400,TRUE,FALSE,TRUE,30.4,"old",63,178,74,"m"
20,"ABDUCTOR",1,"Con09",1020,1020,950,1150,1020,1050,0.029,-30,1035,"Con",0,-200,FALSE,FALSE,FALSE,2.86,"old",63,178,74,"m"
20,"ABDUCTOR",1,"Con10",900,920,0,0,910,0,1,910,455,"Con",-20,0,TRUE,FALSE,FALSE,NA,"old",63,178,74,"m"
20,"ABDUCTOR",2,"Con01",1440,1420,1550,1550,1430,1550,0.084,-120,1490,"Con",20,0,FALSE,FALSE,FALSE,7.74,"old",63,178,74,"m"
20,"ABDUCTOR",2,"Con02",1240,1240,1300,1250,1240,1275,0.028,-35,1257.5,"Con",0,50,FALSE,FALSE,FALSE,2.75,"old",63,178,74,"m"
20,"ABDUCTOR",2,"Con03",1380,1360,1200,1150,1370,1175,0.142,195,1272.5,"Con",20,50,FALSE,FALSE,FALSE,16.6,"old",63,178,74,"m"
20,"ABDUCTOR",2,"Con04",1220,1200,1250,1200,1210,1225,0.012,-15,1217.5,"Con",20,50,FALSE,FALSE,FALSE,1.22,"old",63,178,74,"m"
20,"ABDUCTOR",2,"Con05",1080,1100,1400,1300,1090,1350,0.239,-260,1220,"Con",-20,100,FALSE,FALSE,FALSE,19.26,"old",63,178,74,"m"
20,"ABDUCTOR",2,"Con06",1060,1020,1100,1250,1040,1175,0.13,-135,1107.5,"Con",40,-150,FALSE,TRUE,FALSE,11.49,"old",63,178,74,"m"
20,"ABDUCTOR",2,"Con07",1040,1060,1200,1250,1050,1225,0.167,-175,1137.5,"Con",-20,-50,FALSE,FALSE,FALSE,14.29,"old",63,178,74,"m"
20,"ABDUCTOR",2,"Con08",940,940,1100,1050,940,1075,0.144,-135,1007.5,"Con",0,50,FALSE,FALSE,FALSE,12.56,"old",63,178,74,"m"
20,"ABDUCTOR",2,"Con09",1000,1000,1000,950,1000,975,0.025,25,987.5,"Con",0,50,FALSE,FALSE,FALSE,2.56,"old",63,178,74,"m"
20,"ABDUCTOR",2,"Con10",880,880,950,950,880,950,0.08,-70,915,"Con",0,0,FALSE,FALSE,FALSE,7.37,"old",63,178,74,"m"
20,"ABDUCTOR",1,"Ecc01",2420,2460,1500,2100,2440,1800,0.262,640,2120,"Ecc",-40,-600,TRUE,TRUE,TRUE,35.56,"old",63,178,74,"m"
20,"ABDUCTOR",1,"Ecc02",1900,1880,1350,1650,1890,1500,0.206,390,1695,"Ecc",20,-300,TRUE,FALSE,FALSE,26,"old",63,178,74,"m"
20,"ABDUCTOR",1,"Ecc03",1480,1460,1500,1650,1470,1575,0.071,-105,1522.5,"Ecc",20,-150,FALSE,FALSE,FALSE,6.67,"old",63,178,74,"m"
20,"ABDUCTOR",1,"Ecc04",1620,1600,1550,1600,1610,1575,0.022,35,1592.5,"Ecc",20,-50,FALSE,FALSE,FALSE,2.22,"old",63,178,74,"m"
20,"ABDUCTOR",1,"Ecc05",1720,1700,1200,700,1710,950,0.444,760,1330,"Ecc",20,500,TRUE,FALSE,TRUE,80,"old",63,178,74,"m"
20,"ABDUCTOR",1,"Ecc06",1400,1400,1300,800,1400,1050,0.25,350,1225,"Ecc",0,500,TRUE,FALSE,TRUE,33.33,"old",63,178,74,"m"
20,"ABDUCTOR",1,"Ecc07",1420,1420,1350,950,1420,1150,0.19,270,1285,"Ecc",0,400,FALSE,FALSE,TRUE,23.48,"old",63,178,74,"m"
20,"ABDUCTOR",1,"Ecc08",1400,1360,1450,1200,1380,1325,0.04,55,1352.5,"Ecc",40,250,FALSE,TRUE,FALSE,4.15,"old",63,178,74,"m"
20,"ABDUCTOR",1,"Ecc09",1500,1500,1900,1900,1500,1900,0.267,-400,1700,"Ecc",0,0,TRUE,FALSE,FALSE,21.05,"old",63,178,74,"m"
20,"ABDUCTOR",1,"Ecc10",1920,1920,0,0,1920,0,1,1920,960,"Ecc",0,0,TRUE,FALSE,FALSE,NA,"old",63,178,74,"m"
20,"ABDUCTOR",2,"Ecc01",2180,2180,2100,2100,2180,2100,0.037,80,2140,"Ecc",0,0,FALSE,FALSE,FALSE,3.81,"old",63,178,74,"m"
20,"ABDUCTOR",2,"Ecc02",1600,1600,1750,1800,1600,1775,0.109,-175,1687.5,"Ecc",0,-50,FALSE,FALSE,FALSE,9.86,"old",63,178,74,"m"
20,"ABDUCTOR",2,"Ecc03",1720,1740,1700,1750,1730,1725,0.003,5,1727.5,"Ecc",-20,-50,FALSE,FALSE,FALSE,0.29,"old",63,178,74,"m"
20,"ABDUCTOR",2,"Ecc04",1920,1920,1650,1750,1920,1700,0.115,220,1810,"Ecc",0,-100,FALSE,FALSE,FALSE,12.94,"old",63,178,74,"m"
20,"ABDUCTOR",2,"Ecc05",1500,1520,1400,1400,1510,1400,0.073,110,1455,"Ecc",-20,0,FALSE,FALSE,FALSE,7.86,"old",63,178,74,"m"
20,"ABDUCTOR",2,"Ecc06",1520,1520,1400,1200,1520,1300,0.145,220,1410,"Ecc",0,200,FALSE,FALSE,FALSE,16.92,"old",63,178,74,"m"
20,"ABDUCTOR",2,"Ecc07",1580,1580,1400,1450,1580,1425,0.098,155,1502.5,"Ecc",0,-50,FALSE,FALSE,FALSE,10.88,"old",63,178,74,"m"
20,"ABDUCTOR",2,"Ecc08",1340,1340,1350,1400,1340,1375,0.026,-35,1357.5,"Ecc",0,-50,FALSE,FALSE,FALSE,2.55,"old",63,178,74,"m"
20,"ABDUCTOR",2,"Ecc09",1380,1360,1300,1350,1370,1325,0.033,45,1347.5,"Ecc",20,-50,FALSE,FALSE,FALSE,3.4,"old",63,178,74,"m"
20,"ABDUCTOR",2,"Ecc10",2520,2520,2650,2800,2520,2725,0.081,-205,2622.5,"Ecc",0,-150,FALSE,FALSE,FALSE,7.52,"old",63,178,74,"m"
20,"ABDUCTOR",1,"Rep01",4400,4440,3000,3250,4420,3125,0.293,1295,3772.5,"Rep",-40,-250,TRUE,FALSE,FALSE,41.44,"old",63,178,74,"m"
20,"ABDUCTOR",1,"Rep02",3320,3300,2800,2650,3310,2725,0.177,585,3017.5,"Rep",20,150,TRUE,FALSE,FALSE,21.47,"old",63,178,74,"m"
20,"ABDUCTOR",1,"Rep03",2700,2680,2700,2600,2690,2650,0.015,40,2670,"Rep",20,100,FALSE,FALSE,FALSE,1.51,"old",63,178,74,"m"
20,"ABDUCTOR",1,"Rep04",2640,2640,2650,2600,2640,2625,0.006,15,2632.5,"Rep",0,50,FALSE,FALSE,FALSE,0.57,"old",63,178,74,"m"
20,"ABDUCTOR",1,"Rep05",2740,2760,2200,1800,2750,2000,0.273,750,2375,"Rep",-20,400,TRUE,FALSE,TRUE,37.5,"old",63,178,74,"m"
20,"ABDUCTOR",1,"Rep06",2260,2260,2450,2450,2260,2450,0.084,-190,2355,"Rep",0,0,FALSE,FALSE,FALSE,7.76,"old",63,178,74,"m"
20,"ABDUCTOR",1,"Rep07",2360,2360,2300,2400,2360,2350,0.004,10,2355,"Rep",0,-100,FALSE,FALSE,FALSE,0.43,"old",63,178,74,"m"
20,"ABDUCTOR",1,"Rep08",2260,2240,2500,2650,2250,2575,0.144,-325,2412.5,"Rep",20,-150,TRUE,FALSE,FALSE,12.62,"old",63,178,74,"m"
20,"ABDUCTOR",1,"Rep09",2520,2520,2850,3050,2520,2950,0.171,-430,2735,"Rep",0,-200,TRUE,FALSE,FALSE,14.58,"old",63,178,74,"m"
20,"ABDUCTOR",1,"Rep10",2820,2840,0,0,2830,0,1,2830,1415,"Rep",-20,0,TRUE,FALSE,FALSE,NA,"old",63,178,74,"m"
20,"ABDUCTOR",2,"Rep01",3620,3600,3650,3650,3610,3650,0.011,-40,3630,"Rep",20,0,FALSE,FALSE,FALSE,1.1,"old",63,178,74,"m"
20,"ABDUCTOR",2,"Rep02",2840,2840,3050,3050,2840,3050,0.074,-210,2945,"Rep",0,0,FALSE,FALSE,FALSE,6.89,"old",63,178,74,"m"
20,"ABDUCTOR",2,"Rep03",3100,3100,2900,2900,3100,2900,0.065,200,3000,"Rep",0,0,FALSE,FALSE,FALSE,6.9,"old",63,178,74,"m"
20,"ABDUCTOR",2,"Rep04",3140,3120,2900,2950,3130,2925,0.065,205,3027.5,"Rep",20,-50,FALSE,FALSE,FALSE,7.01,"old",63,178,74,"m"
20,"ABDUCTOR",2,"Rep05",2580,2620,2800,2700,2600,2750,0.058,-150,2675,"Rep",-40,100,FALSE,FALSE,FALSE,5.45,"old",63,178,74,"m"
20,"ABDUCTOR",2,"Rep06",2580,2540,2500,2450,2560,2475,0.033,85,2517.5,"Rep",40,50,FALSE,FALSE,FALSE,3.43,"old",63,178,74,"m"
20,"ABDUCTOR",2,"Rep07",2620,2640,2600,2700,2630,2650,0.008,-20,2640,"Rep",-20,-100,FALSE,FALSE,FALSE,0.75,"old",63,178,74,"m"
20,"ABDUCTOR",2,"Rep08",2280,2280,2450,2450,2280,2450,0.075,-170,2365,"Rep",0,0,FALSE,FALSE,FALSE,6.94,"old",63,178,74,"m"
20,"ABDUCTOR",2,"Rep09",2380,2360,2300,2300,2370,2300,0.03,70,2335,"Rep",20,0,FALSE,FALSE,FALSE,3.04,"old",63,178,74,"m"
20,"ABDUCTOR",2,"Rep10",3400,3400,3600,3750,3400,3675,0.081,-275,3537.5,"Rep",0,-150,FALSE,FALSE,FALSE,7.48,"old",63,178,74,"m"
20,"ABDUCTOR",1,"TuT",28020,28040,23450,23450,28030,23450,0.163,4580,25740,"TuT",-20,0,TRUE,FALSE,FALSE,19.53,"old",63,178,74,"m"
20,"ABDUCTOR",2,"TuT",28540,28500,28750,28900,28520,28825,0.011,-305,28672.5,"TuT",40,-150,FALSE,TRUE,FALSE,1.06,"old",63,178,74,"m"
20,"ADDUCTOR",1,"Con01",1460,1480,1650,1900,1470,1775,0.207,-305,1622.5,"Con",-20,-250,FALSE,FALSE,FALSE,17.18,"old",63,178,74,"m"
20,"ADDUCTOR",1,"Con02",1320,1340,1650,2000,1330,1825,0.372,-495,1577.5,"Con",-20,-350,FALSE,FALSE,TRUE,27.12,"old",63,178,74,"m"
20,"ADDUCTOR",1,"Con03",1360,1380,1550,1250,1370,1400,0.022,-30,1385,"Con",-20,300,FALSE,FALSE,FALSE,2.14,"old",63,178,74,"m"
20,"ADDUCTOR",1,"Con04",1340,1360,1250,1200,1350,1225,0.093,125,1287.5,"Con",-20,50,FALSE,FALSE,FALSE,10.2,"old",63,178,74,"m"
20,"ADDUCTOR",1,"Con05",1180,1200,1300,1250,1190,1275,0.071,-85,1232.5,"Con",-20,50,FALSE,FALSE,FALSE,6.67,"old",63,178,74,"m"
20,"ADDUCTOR",1,"Con06",940,940,1050,950,940,1000,0.064,-60,970,"Con",0,100,FALSE,FALSE,FALSE,6,"old",63,178,74,"m"
20,"ADDUCTOR",1,"Con07",1020,1040,1400,1300,1030,1350,0.311,-320,1190,"Con",-20,100,FALSE,FALSE,FALSE,23.7,"old",63,178,74,"m"
20,"ADDUCTOR",1,"Con08",1380,1360,1750,1800,1370,1775,0.296,-405,1572.5,"Con",20,-50,FALSE,FALSE,FALSE,22.82,"old",63,178,74,"m"
20,"ADDUCTOR",1,"Con09",1340,1340,1750,1900,1340,1825,0.362,-485,1582.5,"Con",0,-150,FALSE,FALSE,FALSE,26.58,"old",63,178,74,"m"
20,"ADDUCTOR",1,"Con10",1220,1240,1850,1950,1230,1900,0.545,-670,1565,"Con",-20,-100,TRUE,FALSE,FALSE,35.26,"old",63,178,74,"m"
20,"ADDUCTOR",2,"Con01",1260,1260,1250,1250,1260,1250,0.008,10,1255,"Con",0,0,FALSE,FALSE,FALSE,0.8,"old",63,178,74,"m"
20,"ADDUCTOR",2,"Con02",1320,1300,1900,1500,1310,1700,0.298,-390,1505,"Con",20,400,FALSE,FALSE,TRUE,22.94,"old",63,178,74,"m"
20,"ADDUCTOR",2,"Con03",1080,1120,1400,1250,1100,1325,0.205,-225,1212.5,"Con",-40,150,FALSE,TRUE,FALSE,16.98,"old",63,178,74,"m"
20,"ADDUCTOR",2,"Con04",1360,1380,1250,1300,1370,1275,0.069,95,1322.5,"Con",-20,-50,FALSE,FALSE,FALSE,7.45,"old",63,178,74,"m"
20,"ADDUCTOR",2,"Con05",1300,1300,1150,1200,1300,1175,0.096,125,1237.5,"Con",0,-50,FALSE,FALSE,FALSE,10.64,"old",63,178,74,"m"
20,"ADDUCTOR",2,"Con06",1080,1100,1400,1400,1090,1400,0.284,-310,1245,"Con",-20,0,FALSE,FALSE,FALSE,22.14,"old",63,178,74,"m"
20,"ADDUCTOR",2,"Con07",1160,1180,1350,1300,1170,1325,0.132,-155,1247.5,"Con",-20,50,FALSE,FALSE,FALSE,11.7,"old",63,178,74,"m"
20,"ADDUCTOR",2,"Con08",1140,1160,1300,1350,1150,1325,0.152,-175,1237.5,"Con",-20,-50,FALSE,FALSE,FALSE,13.21,"old",63,178,74,"m"
20,"ADDUCTOR",2,"Con09",1160,1180,1400,1450,1170,1425,0.218,-255,1297.5,"Con",-20,-50,FALSE,FALSE,FALSE,17.89,"old",63,178,74,"m"
20,"ADDUCTOR",2,"Con10",1280,1240,1550,1600,1260,1575,0.25,-315,1417.5,"Con",40,-50,FALSE,TRUE,FALSE,20,"old",63,178,74,"m"
20,"ADDUCTOR",1,"Ecc01",2580,2520,1900,1300,2550,1600,0.373,950,2075,"Ecc",60,600,TRUE,TRUE,TRUE,59.38,"old",63,178,74,"m"
20,"ADDUCTOR",1,"Ecc02",1920,1920,1750,1750,1920,1750,0.089,170,1835,"Ecc",0,0,FALSE,FALSE,FALSE,9.71,"old",63,178,74,"m"
20,"ADDUCTOR",1,"Ecc03",2020,2000,2000,2250,2010,2125,0.057,-115,2067.5,"Ecc",20,-250,FALSE,FALSE,FALSE,5.41,"old",63,178,74,"m"
20,"ADDUCTOR",1,"Ecc04",2180,2160,2100,2150,2170,2125,0.021,45,2147.5,"Ecc",20,-50,FALSE,FALSE,FALSE,2.12,"old",63,178,74,"m"
20,"ADDUCTOR",1,"Ecc05",2020,2000,1900,2000,2010,1950,0.03,60,1980,"Ecc",20,-100,FALSE,FALSE,FALSE,3.08,"old",63,178,74,"m"
20,"ADDUCTOR",1,"Ecc06",1980,1980,1900,1950,1980,1925,0.028,55,1952.5,"Ecc",0,-50,FALSE,FALSE,FALSE,2.86,"old",63,178,74,"m"
20,"ADDUCTOR",1,"Ecc07",1900,1900,1350,1450,1900,1400,0.263,500,1650,"Ecc",0,-100,FALSE,FALSE,FALSE,35.71,"old",63,178,74,"m"
20,"ADDUCTOR",1,"Ecc08",1780,1800,1400,1250,1790,1325,0.26,465,1557.5,"Ecc",-20,150,FALSE,FALSE,FALSE,35.09,"old",63,178,74,"m"
20,"ADDUCTOR",1,"Ecc09",1900,1880,1600,1500,1890,1550,0.18,340,1720,"Ecc",20,100,FALSE,FALSE,FALSE,21.94,"old",63,178,74,"m"
20,"ADDUCTOR",1,"Ecc10",3060,3040,2600,1700,3050,2150,0.295,900,2600,"Ecc",20,900,TRUE,FALSE,TRUE,41.86,"old",63,178,74,"m"
20,"ADDUCTOR",2,"Ecc01",2440,2420,1650,1950,2430,1800,0.259,630,2115,"Ecc",20,-300,TRUE,FALSE,FALSE,35,"old",63,178,74,"m"
20,"ADDUCTOR",2,"Ecc02",1700,1720,1550,1700,1710,1625,0.05,85,1667.5,"Ecc",-20,-150,FALSE,FALSE,FALSE,5.23,"old",63,178,74,"m"
20,"ADDUCTOR",2,"Ecc03",1640,1600,1500,1500,1620,1500,0.074,120,1560,"Ecc",40,0,FALSE,TRUE,FALSE,8,"old",63,178,74,"m"
20,"ADDUCTOR",2,"Ecc04",1180,1180,1500,1450,1180,1475,0.25,-295,1327.5,"Ecc",0,50,FALSE,FALSE,FALSE,20,"old",63,178,74,"m"
20,"ADDUCTOR",2,"Ecc05",1560,1540,1250,1250,1550,1250,0.194,300,1400,"Ecc",20,0,FALSE,FALSE,FALSE,24,"old",63,178,74,"m"
20,"ADDUCTOR",2,"Ecc06",1480,1460,1300,1300,1470,1300,0.116,170,1385,"Ecc",20,0,FALSE,FALSE,FALSE,13.08,"old",63,178,74,"m"
20,"ADDUCTOR",2,"Ecc07",1520,1500,1350,1400,1510,1375,0.089,135,1442.5,"Ecc",20,-50,FALSE,FALSE,FALSE,9.82,"old",63,178,74,"m"
20,"ADDUCTOR",2,"Ecc08",1580,1580,1350,1250,1580,1300,0.177,280,1440,"Ecc",0,100,FALSE,FALSE,FALSE,21.54,"old",63,178,74,"m"
20,"ADDUCTOR",2,"Ecc09",1620,1600,1400,1400,1610,1400,0.13,210,1505,"Ecc",20,0,FALSE,FALSE,FALSE,15,"old",63,178,74,"m"
20,"ADDUCTOR",2,"Ecc10",2420,2480,2250,2200,2450,2225,0.092,225,2337.5,"Ecc",-60,50,FALSE,TRUE,FALSE,10.11,"old",63,178,74,"m"
20,"ADDUCTOR",1,"Rep01",4040,4000,3550,3200,4020,3375,0.16,645,3697.5,"Rep",40,350,TRUE,FALSE,TRUE,19.11,"old",63,178,74,"m"
20,"ADDUCTOR",1,"Rep02",3240,3260,3400,3750,3250,3575,0.1,-325,3412.5,"Rep",-20,-350,FALSE,FALSE,TRUE,9.09,"old",63,178,74,"m"
20,"ADDUCTOR",1,"Rep03",3380,3380,3550,3500,3380,3525,0.043,-145,3452.5,"Rep",0,50,FALSE,FALSE,FALSE,4.11,"old",63,178,74,"m"
20,"ADDUCTOR",1,"Rep04",3520,3520,3350,3350,3520,3350,0.048,170,3435,"Rep",0,0,FALSE,FALSE,FALSE,5.07,"old",63,178,74,"m"
20,"ADDUCTOR",1,"Rep05",3200,3200,3200,3250,3200,3225,0.008,-25,3212.5,"Rep",0,-50,FALSE,FALSE,FALSE,0.78,"old",63,178,74,"m"
20,"ADDUCTOR",1,"Rep06",2920,2920,2950,2900,2920,2925,0.002,-5,2922.5,"Rep",0,50,FALSE,FALSE,FALSE,0.17,"old",63,178,74,"m"
20,"ADDUCTOR",1,"Rep07",2920,2940,2750,2750,2930,2750,0.061,180,2840,"Rep",-20,0,FALSE,FALSE,FALSE,6.55,"old",63,178,74,"m"
20,"ADDUCTOR",1,"Rep08",3160,3160,3150,3050,3160,3100,0.019,60,3130,"Rep",0,100,FALSE,FALSE,FALSE,1.94,"old",63,178,74,"m"
20,"ADDUCTOR",1,"Rep09",3240,3220,3350,3400,3230,3375,0.045,-145,3302.5,"Rep",20,-50,FALSE,FALSE,FALSE,4.3,"old",63,178,74,"m"
20,"ADDUCTOR",1,"Rep10",4280,4280,4450,3650,4280,4050,0.054,230,4165,"Rep",0,800,FALSE,FALSE,TRUE,5.68,"old",63,178,74,"m"
20,"ADDUCTOR",2,"Rep01",3700,3680,2900,3200,3690,3050,0.173,640,3370,"Rep",20,-300,TRUE,FALSE,TRUE,20.98,"old",63,178,74,"m"
20,"ADDUCTOR",2,"Rep02",3020,3020,3450,3200,3020,3325,0.101,-305,3172.5,"Rep",0,250,FALSE,FALSE,TRUE,9.17,"old",63,178,74,"m"
20,"ADDUCTOR",2,"Rep03",2720,2720,2900,2750,2720,2825,0.039,-105,2772.5,"Rep",0,150,FALSE,FALSE,FALSE,3.72,"old",63,178,74,"m"
20,"ADDUCTOR",2,"Rep04",2540,2560,2750,2750,2550,2750,0.078,-200,2650,"Rep",-20,0,FALSE,FALSE,FALSE,7.27,"old",63,178,74,"m"
20,"ADDUCTOR",2,"Rep05",2860,2840,2400,2450,2850,2425,0.149,425,2637.5,"Rep",20,-50,TRUE,FALSE,FALSE,17.53,"old",63,178,74,"m"
20,"ADDUCTOR",2,"Rep06",2560,2560,2700,2700,2560,2700,0.055,-140,2630,"Rep",0,0,FALSE,FALSE,FALSE,5.19,"old",63,178,74,"m"
20,"ADDUCTOR",2,"Rep07",2680,2680,2700,2700,2680,2700,0.007,-20,2690,"Rep",0,0,FALSE,FALSE,FALSE,0.74,"old",63,178,74,"m"
20,"ADDUCTOR",2,"Rep08",2720,2740,2650,2600,2730,2625,0.038,105,2677.5,"Rep",-20,50,FALSE,FALSE,FALSE,4,"old",63,178,74,"m"
20,"ADDUCTOR",2,"Rep09",2780,2780,2800,2850,2780,2825,0.016,-45,2802.5,"Rep",0,-50,FALSE,FALSE,FALSE,1.59,"old",63,178,74,"m"
20,"ADDUCTOR",2,"Rep10",3700,3720,3800,3800,3710,3800,0.024,-90,3755,"Rep",-20,0,FALSE,FALSE,FALSE,2.37,"old",63,178,74,"m"
20,"ADDUCTOR",1,"TuT",33900,33880,33700,32800,33890,33250,0.019,640,33570,"TuT",20,900,FALSE,FALSE,TRUE,1.92,"old",63,178,74,"m"
20,"ADDUCTOR",2,"TuT",29280,29300,29050,29000,29290,29025,0.009,265,29157.5,"TuT",-20,50,FALSE,FALSE,FALSE,0.91,"old",63,178,74,"m"
20,"LOWER BACK",1,"Con01",3620,3600,3600,3600,3610,3600,0.003,10,3605,"Con",20,0,FALSE,FALSE,FALSE,0.28,"old",63,178,74,"m"
20,"LOWER BACK",1,"Con02",2680,2660,2650,2650,2670,2650,0.007,20,2660,"Con",20,0,FALSE,FALSE,FALSE,0.75,"old",63,178,74,"m"
20,"LOWER BACK",1,"Con03",2580,2540,2400,2450,2560,2425,0.053,135,2492.5,"Con",40,-50,FALSE,TRUE,FALSE,5.57,"old",63,178,74,"m"
20,"LOWER BACK",1,"Con04",2200,2200,2200,2200,2200,2200,0,0,2200,"Con",0,0,FALSE,FALSE,FALSE,0,"old",63,178,74,"m"
20,"LOWER BACK",1,"Con05",2280,2260,2350,2350,2270,2350,0.035,-80,2310,"Con",20,0,FALSE,FALSE,FALSE,3.4,"old",63,178,74,"m"
20,"LOWER BACK",1,"Con06",2320,2320,2400,2350,2320,2375,0.024,-55,2347.5,"Con",0,50,FALSE,FALSE,FALSE,2.32,"old",63,178,74,"m"
20,"LOWER BACK",1,"Con07",2040,2060,2050,2000,2050,2025,0.012,25,2037.5,"Con",-20,50,FALSE,FALSE,FALSE,1.23,"old",63,178,74,"m"
20,"LOWER BACK",1,"Con08",2060,2040,2150,2150,2050,2150,0.049,-100,2100,"Con",20,0,FALSE,FALSE,FALSE,4.65,"old",63,178,74,"m"
20,"LOWER BACK",1,"Con09",2000,2000,2150,2250,2000,2200,0.1,-200,2100,"Con",0,-100,TRUE,FALSE,FALSE,9.09,"old",63,178,74,"m"
20,"LOWER BACK",1,"Con10",2360,2360,2500,2700,2360,2600,0.102,-240,2480,"Con",0,-200,TRUE,FALSE,TRUE,9.23,"old",63,178,74,"m"
20,"LOWER BACK",2,"Con01",2400,2420,2400,2400,2410,2400,0.004,10,2405,"Con",-20,0,FALSE,FALSE,FALSE,0.42,"old",63,178,74,"m"
20,"LOWER BACK",2,"Con02",2180,2240,2050,2000,2210,2025,0.084,185,2117.5,"Con",-60,50,FALSE,TRUE,FALSE,9.14,"old",63,178,74,"m"
20,"LOWER BACK",2,"Con03",2060,2040,2000,1950,2050,1975,0.037,75,2012.5,"Con",20,50,FALSE,FALSE,FALSE,3.8,"old",63,178,74,"m"
20,"LOWER BACK",2,"Con04",1920,1920,1900,1850,1920,1875,0.023,45,1897.5,"Con",0,50,FALSE,FALSE,FALSE,2.4,"old",63,178,74,"m"
20,"LOWER BACK",2,"Con05",1980,1960,1950,1900,1970,1925,0.023,45,1947.5,"Con",20,50,FALSE,FALSE,FALSE,2.34,"old",63,178,74,"m"
20,"LOWER BACK",2,"Con06",1860,1840,1900,1900,1850,1900,0.027,-50,1875,"Con",20,0,FALSE,FALSE,FALSE,2.63,"old",63,178,74,"m"
20,"LOWER BACK",2,"Con07",1820,1760,1950,1900,1790,1925,0.075,-135,1857.5,"Con",60,50,FALSE,TRUE,FALSE,7.01,"old",63,178,74,"m"
20,"LOWER BACK",2,"Con08",2000,2000,2050,2100,2000,2075,0.038,-75,2037.5,"Con",0,-50,FALSE,FALSE,FALSE,3.61,"old",63,178,74,"m"
20,"LOWER BACK",2,"Con09",1940,1960,2000,2100,1950,2050,0.051,-100,2000,"Con",-20,-100,FALSE,FALSE,FALSE,4.88,"old",63,178,74,"m"
20,"LOWER BACK",2,"Con10",1800,1800,1950,2000,1800,1975,0.097,-175,1887.5,"Con",0,-50,FALSE,FALSE,FALSE,8.86,"old",63,178,74,"m"
20,"LOWER BACK",1,"Ecc01",3980,4020,4150,4050,4000,4100,0.025,-100,4050,"Ecc",-40,100,FALSE,FALSE,FALSE,2.44,"old",63,178,74,"m"
20,"LOWER BACK",1,"Ecc02",2700,2760,2800,2800,2730,2800,0.026,-70,2765,"Ecc",-60,0,FALSE,FALSE,FALSE,2.5,"old",63,178,74,"m"
20,"LOWER BACK",1,"Ecc03",2580,2560,2650,2650,2570,2650,0.031,-80,2610,"Ecc",20,0,FALSE,FALSE,FALSE,3.02,"old",63,178,74,"m"
20,"LOWER BACK",1,"Ecc04",2600,2600,2600,2550,2600,2575,0.01,25,2587.5,"Ecc",0,50,FALSE,FALSE,FALSE,0.97,"old",63,178,74,"m"
20,"LOWER BACK",1,"Ecc05",2460,2480,2350,2400,2470,2375,0.038,95,2422.5,"Ecc",-20,-50,FALSE,FALSE,FALSE,4,"old",63,178,74,"m"
20,"LOWER BACK",1,"Ecc06",1980,1960,1950,2000,1970,1975,0.003,-5,1972.5,"Ecc",20,-50,FALSE,FALSE,FALSE,0.25,"old",63,178,74,"m"
20,"LOWER BACK",1,"Ecc07",2260,2280,2200,2250,2270,2225,0.02,45,2247.5,"Ecc",-20,-50,FALSE,FALSE,FALSE,2.02,"old",63,178,74,"m"
20,"LOWER BACK",1,"Ecc08",2100,2100,2000,1950,2100,1975,0.06,125,2037.5,"Ecc",0,50,FALSE,FALSE,FALSE,6.33,"old",63,178,74,"m"
20,"LOWER BACK",1,"Ecc09",2140,2160,2000,1800,2150,1900,0.116,250,2025,"Ecc",-20,200,TRUE,FALSE,TRUE,13.16,"old",63,178,74,"m"
20,"LOWER BACK",1,"Ecc10",3060,3080,3000,2900,3070,2950,0.039,120,3010,"Ecc",-20,100,FALSE,FALSE,FALSE,4.07,"old",63,178,74,"m"
20,"LOWER BACK",2,"Ecc01",2460,2440,2600,2550,2450,2575,0.051,-125,2512.5,"Ecc",20,50,FALSE,FALSE,FALSE,4.85,"old",63,178,74,"m"
20,"LOWER BACK",2,"Ecc02",2460,2420,2550,2600,2440,2575,0.055,-135,2507.5,"Ecc",40,-50,FALSE,FALSE,FALSE,5.24,"old",63,178,74,"m"
20,"LOWER BACK",2,"Ecc03",2060,2080,2100,2200,2070,2150,0.039,-80,2110,"Ecc",-20,-100,FALSE,FALSE,FALSE,3.72,"old",63,178,74,"m"
20,"LOWER BACK",2,"Ecc04",2000,2020,2050,2100,2010,2075,0.032,-65,2042.5,"Ecc",-20,-50,FALSE,FALSE,FALSE,3.13,"old",63,178,74,"m"
20,"LOWER BACK",2,"Ecc05",1940,1960,1950,1950,1950,1950,0,0,1950,"Ecc",-20,0,FALSE,FALSE,FALSE,0,"old",63,178,74,"m"
20,"LOWER BACK",2,"Ecc06",2000,2040,1900,1950,2020,1925,0.047,95,1972.5,"Ecc",-40,-50,FALSE,FALSE,FALSE,4.94,"old",63,178,74,"m"
20,"LOWER BACK",2,"Ecc07",1980,2000,1900,1900,1990,1900,0.045,90,1945,"Ecc",-20,0,FALSE,FALSE,FALSE,4.74,"old",63,178,74,"m"
20,"LOWER BACK",2,"Ecc08",1740,1720,1650,1600,1730,1625,0.061,105,1677.5,"Ecc",20,50,FALSE,FALSE,FALSE,6.46,"old",63,178,74,"m"
20,"LOWER BACK",2,"Ecc09",1820,1820,1750,1650,1820,1700,0.066,120,1760,"Ecc",0,100,FALSE,FALSE,FALSE,7.06,"old",63,178,74,"m"
20,"LOWER BACK",2,"Ecc10",3280,3300,3250,3250,3290,3250,0.012,40,3270,"Ecc",-20,0,FALSE,FALSE,FALSE,1.23,"old",63,178,74,"m"
20,"LOWER BACK",1,"Rep01",7600,7620,7750,7650,7610,7700,0.012,-90,7655,"Rep",-20,100,FALSE,FALSE,FALSE,1.17,"old",63,178,74,"m"
20,"LOWER BACK",1,"Rep02",5380,5420,5450,5450,5400,5450,0.009,-50,5425,"Rep",-40,0,FALSE,FALSE,FALSE,0.92,"old",63,178,74,"m"
20,"LOWER BACK",1,"Rep03",5160,5100,5050,5100,5130,5075,0.011,55,5102.5,"Rep",60,-50,FALSE,FALSE,FALSE,1.08,"old",63,178,74,"m"
20,"LOWER BACK",1,"Rep04",4800,4800,4800,4750,4800,4775,0.005,25,4787.5,"Rep",0,50,FALSE,FALSE,FALSE,0.52,"old",63,178,74,"m"
20,"LOWER BACK",1,"Rep05",4740,4740,4700,4750,4740,4725,0.003,15,4732.5,"Rep",0,-50,FALSE,FALSE,FALSE,0.32,"old",63,178,74,"m"
20,"LOWER BACK",1,"Rep06",4300,4280,4350,4350,4290,4350,0.014,-60,4320,"Rep",20,0,FALSE,FALSE,FALSE,1.38,"old",63,178,74,"m"
20,"LOWER BACK",1,"Rep07",4300,4340,4250,4250,4320,4250,0.016,70,4285,"Rep",-40,0,FALSE,FALSE,FALSE,1.65,"old",63,178,74,"m"
20,"LOWER BACK",1,"Rep08",4160,4140,4150,4100,4150,4125,0.006,25,4137.5,"Rep",20,50,FALSE,FALSE,FALSE,0.61,"old",63,178,74,"m"
20,"LOWER BACK",1,"Rep09",4140,4160,4150,4050,4150,4100,0.012,50,4125,"Rep",-20,100,FALSE,FALSE,FALSE,1.22,"old",63,178,74,"m"
20,"LOWER BACK",1,"Rep10",5420,5440,5500,5600,5430,5550,0.022,-120,5490,"Rep",-20,-100,TRUE,FALSE,FALSE,2.16,"old",63,178,74,"m"
20,"LOWER BACK",2,"Rep01",4860,4860,5000,4950,4860,4975,0.024,-115,4917.5,"Rep",0,50,TRUE,FALSE,FALSE,2.31,"old",63,178,74,"m"
20,"LOWER BACK",2,"Rep02",4640,4660,4600,4600,4650,4600,0.011,50,4625,"Rep",-20,0,FALSE,FALSE,FALSE,1.09,"old",63,178,74,"m"
20,"LOWER BACK",2,"Rep03",4120,4120,4100,4150,4120,4125,0.001,-5,4122.5,"Rep",0,-50,FALSE,FALSE,FALSE,0.12,"old",63,178,74,"m"
20,"LOWER BACK",2,"Rep04",3920,3940,3950,3950,3930,3950,0.005,-20,3940,"Rep",-20,0,FALSE,FALSE,FALSE,0.51,"old",63,178,74,"m"
20,"LOWER BACK",2,"Rep05",3920,3920,3900,3850,3920,3875,0.011,45,3897.5,"Rep",0,50,FALSE,FALSE,FALSE,1.16,"old",63,178,74,"m"
20,"LOWER BACK",2,"Rep06",3860,3880,3800,3850,3870,3825,0.012,45,3847.5,"Rep",-20,-50,FALSE,FALSE,FALSE,1.18,"old",63,178,74,"m"
20,"LOWER BACK",2,"Rep07",3800,3760,3850,3800,3780,3825,0.012,-45,3802.5,"Rep",40,50,FALSE,FALSE,FALSE,1.18,"old",63,178,74,"m"
20,"LOWER BACK",2,"Rep08",3740,3720,3700,3700,3730,3700,0.008,30,3715,"Rep",20,0,FALSE,FALSE,FALSE,0.81,"old",63,178,74,"m"
20,"LOWER BACK",2,"Rep09",3760,3780,3750,3750,3770,3750,0.005,20,3760,"Rep",-20,0,FALSE,FALSE,FALSE,0.53,"old",63,178,74,"m"
20,"LOWER BACK",2,"Rep10",5080,5100,5200,5250,5090,5225,0.027,-135,5157.5,"Rep",-20,-50,TRUE,FALSE,FALSE,2.58,"old",63,178,74,"m"
20,"LOWER BACK",1,"TuT",50000,50040,50150,50050,50020,50100,0.002,-80,50060,"TuT",-40,100,FALSE,FALSE,FALSE,0.16,"old",63,178,74,"m"
20,"LOWER BACK",2,"TuT",41700,41740,41850,41850,41720,41850,0.003,-130,41785,"TuT",-40,0,FALSE,FALSE,FALSE,0.31,"old",63,178,74,"m"
20,"TOTAL ABDOMINAL",1,"Con01",2640,2620,2700,2650,2630,2675,0.017,-45,2652.5,"Con",20,50,FALSE,FALSE,FALSE,1.68,"old",63,178,74,"m"
20,"TOTAL ABDOMINAL",1,"Con02",1740,1720,1850,1950,1730,1900,0.098,-170,1815,"Con",20,-100,TRUE,FALSE,FALSE,8.95,"old",63,178,74,"m"
20,"TOTAL ABDOMINAL",1,"Con03",1360,1340,1450,1450,1350,1450,0.074,-100,1400,"Con",20,0,FALSE,FALSE,FALSE,6.9,"old",63,178,74,"m"
20,"TOTAL ABDOMINAL",1,"Con04",1560,1540,1600,1650,1550,1625,0.048,-75,1587.5,"Con",20,-50,FALSE,FALSE,FALSE,4.62,"old",63,178,74,"m"
20,"TOTAL ABDOMINAL",1,"Con05",1460,1440,1550,1600,1450,1575,0.086,-125,1512.5,"Con",20,-50,FALSE,FALSE,FALSE,7.94,"old",63,178,74,"m"
20,"TOTAL ABDOMINAL",1,"Con06",1420,1420,1500,1500,1420,1500,0.056,-80,1460,"Con",0,0,FALSE,FALSE,FALSE,5.33,"old",63,178,74,"m"
20,"TOTAL ABDOMINAL",1,"Con07",1300,1320,1400,1400,1310,1400,0.069,-90,1355,"Con",-20,0,FALSE,FALSE,FALSE,6.43,"old",63,178,74,"m"
20,"TOTAL ABDOMINAL",1,"Con08",1320,1320,1450,1400,1320,1425,0.08,-105,1372.5,"Con",0,50,FALSE,FALSE,FALSE,7.37,"old",63,178,74,"m"
20,"TOTAL ABDOMINAL",1,"Con09",1440,1440,1550,1550,1440,1550,0.076,-110,1495,"Con",0,0,FALSE,FALSE,FALSE,7.1,"old",63,178,74,"m"
20,"TOTAL ABDOMINAL",1,"Con10",1440,1440,1550,1550,1440,1550,0.076,-110,1495,"Con",0,0,FALSE,FALSE,FALSE,7.1,"old",63,178,74,"m"
20,"TOTAL ABDOMINAL",2,"Con01",1760,1720,1850,1800,1740,1825,0.049,-85,1782.5,"Con",40,50,FALSE,TRUE,FALSE,4.66,"old",63,178,74,"m"
20,"TOTAL ABDOMINAL",2,"Con02",1940,1900,1950,1900,1920,1925,0.003,-5,1922.5,"Con",40,50,FALSE,TRUE,FALSE,0.26,"old",63,178,74,"m"
20,"TOTAL ABDOMINAL",2,"Con03",1660,1660,1700,1700,1660,1700,0.024,-40,1680,"Con",0,0,FALSE,FALSE,FALSE,2.35,"old",63,178,74,"m"
20,"TOTAL ABDOMINAL",2,"Con04",1400,1420,1500,1400,1410,1450,0.028,-40,1430,"Con",-20,100,FALSE,FALSE,FALSE,2.76,"old",63,178,74,"m"
20,"TOTAL ABDOMINAL",2,"Con05",1360,1340,1400,1350,1350,1375,0.019,-25,1362.5,"Con",20,50,FALSE,FALSE,FALSE,1.82,"old",63,178,74,"m"
20,"TOTAL ABDOMINAL",2,"Con06",1260,1260,1350,1350,1260,1350,0.071,-90,1305,"Con",0,0,FALSE,FALSE,FALSE,6.67,"old",63,178,74,"m"
20,"TOTAL ABDOMINAL",2,"Con07",1400,1400,1450,1500,1400,1475,0.054,-75,1437.5,"Con",0,-50,FALSE,FALSE,FALSE,5.08,"old",63,178,74,"m"
20,"TOTAL ABDOMINAL",2,"Con08",1380,1400,1450,1450,1390,1450,0.043,-60,1420,"Con",-20,0,FALSE,FALSE,FALSE,4.14,"old",63,178,74,"m"
20,"TOTAL ABDOMINAL",2,"Con09",1360,1360,1550,1600,1360,1575,0.158,-215,1467.5,"Con",0,-50,TRUE,FALSE,FALSE,13.65,"old",63,178,74,"m"
20,"TOTAL ABDOMINAL",2,"Con10",1680,1640,1800,1950,1660,1875,0.13,-215,1767.5,"Con",40,-150,TRUE,TRUE,FALSE,11.47,"old",63,178,74,"m"
20,"TOTAL ABDOMINAL",1,"Ecc01",3080,3100,3000,2900,3090,2950,0.045,140,3020,"Ecc",-20,100,FALSE,FALSE,FALSE,4.75,"old",63,178,74,"m"
20,"TOTAL ABDOMINAL",1,"Ecc02",2920,2940,2900,2800,2930,2850,0.027,80,2890,"Ecc",-20,100,FALSE,FALSE,FALSE,2.81,"old",63,178,74,"m"
20,"TOTAL ABDOMINAL",1,"Ecc03",2940,2960,2850,2850,2950,2850,0.034,100,2900,"Ecc",-20,0,FALSE,FALSE,FALSE,3.51,"old",63,178,74,"m"
20,"TOTAL ABDOMINAL",1,"Ecc04",2600,2620,2550,2500,2610,2525,0.033,85,2567.5,"Ecc",-20,50,FALSE,FALSE,FALSE,3.37,"old",63,178,74,"m"
20,"TOTAL ABDOMINAL",1,"Ecc05",2320,2320,2200,2200,2320,2200,0.052,120,2260,"Ecc",0,0,FALSE,FALSE,FALSE,5.45,"old",63,178,74,"m"
20,"TOTAL ABDOMINAL",1,"Ecc06",2040,2040,1950,1950,2040,1950,0.044,90,1995,"Ecc",0,0,FALSE,FALSE,FALSE,4.62,"old",63,178,74,"m"
20,"TOTAL ABDOMINAL",1,"Ecc07",2020,2020,1950,1950,2020,1950,0.035,70,1985,"Ecc",0,0,FALSE,FALSE,FALSE,3.59,"old",63,178,74,"m"
20,"TOTAL ABDOMINAL",1,"Ecc08",2260,2260,2100,2150,2260,2125,0.06,135,2192.5,"Ecc",0,-50,FALSE,FALSE,FALSE,6.35,"old",63,178,74,"m"
20,"TOTAL ABDOMINAL",1,"Ecc09",1880,1900,1850,1850,1890,1850,0.021,40,1870,"Ecc",-20,0,FALSE,FALSE,FALSE,2.16,"old",63,178,74,"m"
20,"TOTAL ABDOMINAL",1,"Ecc10",3340,3340,4200,4200,3340,4200,0.257,-860,3770,"Ecc",0,0,TRUE,FALSE,FALSE,20.48,"old",63,178,74,"m"
20,"TOTAL ABDOMINAL",2,"Ecc01",2380,2400,2350,2400,2390,2375,0.006,15,2382.5,"Ecc",-20,-50,FALSE,FALSE,FALSE,0.63,"old",63,178,74,"m"
20,"TOTAL ABDOMINAL",2,"Ecc02",2300,2320,2300,2300,2310,2300,0.004,10,2305,"Ecc",-20,0,FALSE,FALSE,FALSE,0.43,"old",63,178,74,"m"
20,"TOTAL ABDOMINAL",2,"Ecc03",2060,2060,2000,2050,2060,2025,0.017,35,2042.5,"Ecc",0,-50,FALSE,FALSE,FALSE,1.73,"old",63,178,74,"m"
20,"TOTAL ABDOMINAL",2,"Ecc04",2120,2120,2050,2150,2120,2100,0.009,20,2110,"Ecc",0,-100,FALSE,FALSE,FALSE,0.95,"old",63,178,74,"m"
20,"TOTAL ABDOMINAL",2,"Ecc05",1880,1880,1800,1800,1880,1800,0.043,80,1840,"Ecc",0,0,FALSE,FALSE,FALSE,4.44,"old",63,178,74,"m"
20,"TOTAL ABDOMINAL",2,"Ecc06",2120,2120,2050,2050,2120,2050,0.033,70,2085,"Ecc",0,0,FALSE,FALSE,FALSE,3.41,"old",63,178,74,"m"
20,"TOTAL ABDOMINAL",2,"Ecc07",2280,2260,2250,2200,2270,2225,0.02,45,2247.5,"Ecc",20,50,FALSE,FALSE,FALSE,2.02,"old",63,178,74,"m"
20,"TOTAL ABDOMINAL",2,"Ecc08",2260,2260,2050,2050,2260,2050,0.093,210,2155,"Ecc",0,0,TRUE,FALSE,FALSE,10.24,"old",63,178,74,"m"
20,"TOTAL ABDOMINAL",2,"Ecc09",2440,2460,2300,2200,2450,2250,0.082,200,2350,"Ecc",-20,100,TRUE,FALSE,FALSE,8.89,"old",63,178,74,"m"
20,"TOTAL ABDOMINAL",2,"Ecc10",3340,3380,3400,3200,3360,3300,0.018,60,3330,"Ecc",-40,200,FALSE,TRUE,TRUE,1.82,"old",63,178,74,"m"
20,"TOTAL ABDOMINAL",1,"Rep01",5720,5720,5700,5550,5720,5625,0.017,95,5672.5,"Rep",0,150,FALSE,FALSE,FALSE,1.69,"old",63,178,74,"m"
20,"TOTAL ABDOMINAL",1,"Rep02",4660,4660,4750,4750,4660,4750,0.019,-90,4705,"Rep",0,0,FALSE,FALSE,FALSE,1.89,"old",63,178,74,"m"
20,"TOTAL ABDOMINAL",1,"Rep03",4300,4300,4300,4300,4300,4300,0,0,4300,"Rep",0,0,FALSE,FALSE,FALSE,0,"old",63,178,74,"m"
20,"TOTAL ABDOMINAL",1,"Rep04",4160,4160,4150,4150,4160,4150,0.002,10,4155,"Rep",0,0,FALSE,FALSE,FALSE,0.24,"old",63,178,74,"m"
20,"TOTAL ABDOMINAL",1,"Rep05",3780,3760,3750,3800,3770,3775,0.001,-5,3772.5,"Rep",20,-50,FALSE,FALSE,FALSE,0.13,"old",63,178,74,"m"
20,"TOTAL ABDOMINAL",1,"Rep06",3460,3460,3450,3450,3460,3450,0.003,10,3455,"Rep",0,0,FALSE,FALSE,FALSE,0.29,"old",63,178,74,"m"
20,"TOTAL ABDOMINAL",1,"Rep07",3320,3340,3350,3350,3330,3350,0.006,-20,3340,"Rep",-20,0,FALSE,FALSE,FALSE,0.6,"old",63,178,74,"m"
20,"TOTAL ABDOMINAL",1,"Rep08",3580,3580,3550,3550,3580,3550,0.008,30,3565,"Rep",0,0,FALSE,FALSE,FALSE,0.85,"old",63,178,74,"m"
20,"TOTAL ABDOMINAL",1,"Rep09",3320,3340,3400,3400,3330,3400,0.021,-70,3365,"Rep",-20,0,FALSE,FALSE,FALSE,2.06,"old",63,178,74,"m"
20,"TOTAL ABDOMINAL",1,"Rep10",4780,4780,5750,5750,4780,5750,0.203,-970,5265,"Rep",0,0,TRUE,FALSE,FALSE,16.87,"old",63,178,74,"m"
20,"TOTAL ABDOMINAL",2,"Rep01",4140,4120,4200,4200,4130,4200,0.017,-70,4165,"Rep",20,0,FALSE,FALSE,FALSE,1.67,"old",63,178,74,"m"
20,"TOTAL ABDOMINAL",2,"Rep02",4240,4220,4250,4200,4230,4225,0.001,5,4227.5,"Rep",20,50,FALSE,FALSE,FALSE,0.12,"old",63,178,74,"m"
20,"TOTAL ABDOMINAL",2,"Rep03",3720,3720,3700,3750,3720,3725,0.001,-5,3722.5,"Rep",0,-50,FALSE,FALSE,FALSE,0.13,"old",63,178,74,"m"
20,"TOTAL ABDOMINAL",2,"Rep04",3520,3540,3550,3550,3530,3550,0.006,-20,3540,"Rep",-20,0,FALSE,FALSE,FALSE,0.56,"old",63,178,74,"m"
20,"TOTAL ABDOMINAL",2,"Rep05",3240,3220,3200,3150,3230,3175,0.017,55,3202.5,"Rep",20,50,FALSE,FALSE,FALSE,1.73,"old",63,178,74,"m"
20,"TOTAL ABDOMINAL",2,"Rep06",3380,3380,3400,3400,3380,3400,0.006,-20,3390,"Rep",0,0,FALSE,FALSE,FALSE,0.59,"old",63,178,74,"m"
20,"TOTAL ABDOMINAL",2,"Rep07",3680,3660,3700,3700,3670,3700,0.008,-30,3685,"Rep",20,0,FALSE,FALSE,FALSE,0.81,"old",63,178,74,"m"
20,"TOTAL ABDOMINAL",2,"Rep08",3640,3660,3500,3500,3650,3500,0.041,150,3575,"Rep",-20,0,TRUE,FALSE,FALSE,4.29,"old",63,178,74,"m"
20,"TOTAL ABDOMINAL",2,"Rep09",3800,3820,3850,3800,3810,3825,0.004,-15,3817.5,"Rep",-20,50,FALSE,FALSE,FALSE,0.39,"old",63,178,74,"m"
20,"TOTAL ABDOMINAL",2,"Rep10",5020,5020,5200,5150,5020,5175,0.031,-155,5097.5,"Rep",0,50,TRUE,FALSE,FALSE,3,"old",63,178,74,"m"
20,"TOTAL ABDOMINAL",1,"TuT",41080,41100,42150,42050,41090,42100,0.025,-1010,41595,"TuT",-20,100,TRUE,FALSE,FALSE,2.4,"old",63,178,74,"m"
20,"TOTAL ABDOMINAL",2,"TuT",38380,38360,38550,38400,38370,38475,0.003,-105,38422.5,"TuT",20,150,FALSE,FALSE,FALSE,0.27,"old",63,178,74,"m"
20,"VERTICAL TRACTION",1,"Con01",3280,3320,3150,1800,3300,2475,0.25,825,2887.5,"Con",-40,1350,TRUE,FALSE,TRUE,33.33,"old",63,178,74,"m"
20,"VERTICAL TRACTION",1,"Con02",1840,1860,1850,1650,1850,1750,0.054,100,1800,"Con",-20,200,FALSE,FALSE,TRUE,5.71,"old",63,178,74,"m"
20,"VERTICAL TRACTION",1,"Con03",1640,1640,1750,1750,1640,1750,0.067,-110,1695,"Con",0,0,FALSE,FALSE,FALSE,6.29,"old",63,178,74,"m"
20,"VERTICAL TRACTION",1,"Con04",1600,1600,1800,1700,1600,1750,0.094,-150,1675,"Con",0,100,FALSE,FALSE,FALSE,8.57,"old",63,178,74,"m"
20,"VERTICAL TRACTION",1,"Con05",1640,1620,1750,1550,1630,1650,0.012,-20,1640,"Con",20,200,FALSE,FALSE,TRUE,1.21,"old",63,178,74,"m"
20,"VERTICAL TRACTION",1,"Con06",1480,1480,1550,1700,1480,1625,0.098,-145,1552.5,"Con",0,-150,FALSE,FALSE,FALSE,8.92,"old",63,178,74,"m"
20,"VERTICAL TRACTION",1,"Con07",1560,1540,1600,1550,1550,1575,0.016,-25,1562.5,"Con",20,50,FALSE,FALSE,FALSE,1.59,"old",63,178,74,"m"
20,"VERTICAL TRACTION",1,"Con08",1440,1420,1550,1650,1430,1600,0.119,-170,1515,"Con",20,-100,FALSE,FALSE,FALSE,10.62,"old",63,178,74,"m"
20,"VERTICAL TRACTION",1,"Con09",1460,1480,1650,1750,1470,1700,0.156,-230,1585,"Con",-20,-100,FALSE,FALSE,FALSE,13.53,"old",63,178,74,"m"
20,"VERTICAL TRACTION",1,"Con10",1520,1540,1700,0,1530,850,0.444,680,1190,"Con",-20,1700,TRUE,FALSE,TRUE,80,"old",63,178,74,"m"
20,"VERTICAL TRACTION",2,"Con01",3180,3200,3250,3300,3190,3275,0.027,-85,3232.5,"Con",-20,-50,FALSE,FALSE,FALSE,2.6,"old",63,178,74,"m"
20,"VERTICAL TRACTION",2,"Con02",2300,2300,2300,2250,2300,2275,0.011,25,2287.5,"Con",0,50,FALSE,FALSE,FALSE,1.1,"old",63,178,74,"m"
20,"VERTICAL TRACTION",2,"Con03",1860,1860,1850,1850,1860,1850,0.005,10,1855,"Con",0,0,FALSE,FALSE,FALSE,0.54,"old",63,178,74,"m"
20,"VERTICAL TRACTION",2,"Con04",1620,1580,1700,1650,1600,1675,0.047,-75,1637.5,"Con",40,50,FALSE,FALSE,FALSE,4.48,"old",63,178,74,"m"
20,"VERTICAL TRACTION",2,"Con05",1560,1560,1650,1600,1560,1625,0.042,-65,1592.5,"Con",0,50,FALSE,FALSE,FALSE,4,"old",63,178,74,"m"
20,"VERTICAL TRACTION",2,"Con06",1660,1680,1800,1800,1670,1800,0.078,-130,1735,"Con",-20,0,FALSE,FALSE,FALSE,7.22,"old",63,178,74,"m"
20,"VERTICAL TRACTION",2,"Con07",1680,1680,1800,1800,1680,1800,0.071,-120,1740,"Con",0,0,FALSE,FALSE,FALSE,6.67,"old",63,178,74,"m"
20,"VERTICAL TRACTION",2,"Con08",1680,1700,1750,1800,1690,1775,0.05,-85,1732.5,"Con",-20,-50,FALSE,FALSE,FALSE,4.79,"old",63,178,74,"m"
20,"VERTICAL TRACTION",2,"Con09",1520,1500,1600,1700,1510,1650,0.093,-140,1580,"Con",20,-100,FALSE,FALSE,FALSE,8.48,"old",63,178,74,"m"
20,"VERTICAL TRACTION",2,"Con10",1620,1640,1750,1900,1630,1825,0.12,-195,1727.5,"Con",-20,-150,FALSE,FALSE,FALSE,10.68,"old",63,178,74,"m"
20,"VERTICAL TRACTION",1,"Ecc01",3060,3020,3050,2550,3040,2800,0.079,240,2920,"Ecc",40,500,FALSE,FALSE,TRUE,8.57,"old",63,178,74,"m"
20,"VERTICAL TRACTION",1,"Ecc02",2480,2480,2450,2500,2480,2475,0.002,5,2477.5,"Ecc",0,-50,FALSE,FALSE,FALSE,0.2,"old",63,178,74,"m"
20,"VERTICAL TRACTION",1,"Ecc03",2580,2580,2400,2050,2580,2225,0.138,355,2402.5,"Ecc",0,350,TRUE,FALSE,TRUE,15.96,"old",63,178,74,"m"
20,"VERTICAL TRACTION",1,"Ecc04",2100,2100,2000,1850,2100,1925,0.083,175,2012.5,"Ecc",0,150,FALSE,FALSE,FALSE,9.09,"old",63,178,74,"m"
20,"VERTICAL TRACTION",1,"Ecc05",1960,1980,1850,1800,1970,1825,0.074,145,1897.5,"Ecc",-20,50,FALSE,FALSE,FALSE,7.95,"old",63,178,74,"m"
20,"VERTICAL TRACTION",1,"Ecc06",1940,1960,1850,1650,1950,1750,0.103,200,1850,"Ecc",-20,200,FALSE,FALSE,TRUE,11.43,"old",63,178,74,"m"
20,"VERTICAL TRACTION",1,"Ecc07",1760,1780,1700,1750,1770,1725,0.025,45,1747.5,"Ecc",-20,-50,FALSE,FALSE,FALSE,2.61,"old",63,178,74,"m"
20,"VERTICAL TRACTION",1,"Ecc08",1900,1880,1750,1950,1890,1850,0.021,40,1870,"Ecc",20,-200,FALSE,FALSE,TRUE,2.16,"old",63,178,74,"m"
20,"VERTICAL TRACTION",1,"Ecc09",2140,2120,1950,2800,2130,2375,0.115,-245,2252.5,"Ecc",20,-850,FALSE,FALSE,TRUE,10.32,"old",63,178,74,"m"
20,"VERTICAL TRACTION",1,"Ecc10",2860,2880,2400,0,2870,1200,0.582,1670,2035,"Ecc",-20,2400,TRUE,FALSE,TRUE,139.17,"old",63,178,74,"m"
20,"VERTICAL TRACTION",2,"Ecc01",3500,3500,3450,3500,3500,3475,0.007,25,3487.5,"Ecc",0,-50,FALSE,FALSE,FALSE,0.72,"old",63,178,74,"m"
20,"VERTICAL TRACTION",2,"Ecc02",2680,2680,2700,2700,2680,2700,0.007,-20,2690,"Ecc",0,0,FALSE,FALSE,FALSE,0.74,"old",63,178,74,"m"
20,"VERTICAL TRACTION",2,"Ecc03",2360,2380,2300,2300,2370,2300,0.03,70,2335,"Ecc",-20,0,FALSE,FALSE,FALSE,3.04,"old",63,178,74,"m"
20,"VERTICAL TRACTION",2,"Ecc04",1960,1960,1850,1950,1960,1900,0.031,60,1930,"Ecc",0,-100,FALSE,FALSE,FALSE,3.16,"old",63,178,74,"m"
20,"VERTICAL TRACTION",2,"Ecc05",2100,2100,1950,2000,2100,1975,0.06,125,2037.5,"Ecc",0,-50,FALSE,FALSE,FALSE,6.33,"old",63,178,74,"m"
20,"VERTICAL TRACTION",2,"Ecc06",2060,2080,2000,1950,2070,1975,0.046,95,2022.5,"Ecc",-20,50,FALSE,FALSE,FALSE,4.81,"old",63,178,74,"m"
20,"VERTICAL TRACTION",2,"Ecc07",1980,1940,1850,1850,1960,1850,0.056,110,1905,"Ecc",40,0,FALSE,FALSE,FALSE,5.95,"old",63,178,74,"m"
20,"VERTICAL TRACTION",2,"Ecc08",1980,2000,1950,1850,1990,1900,0.045,90,1945,"Ecc",-20,100,FALSE,FALSE,FALSE,4.74,"old",63,178,74,"m"
20,"VERTICAL TRACTION",2,"Ecc09",2040,2040,1900,1750,2040,1825,0.105,215,1932.5,"Ecc",0,150,FALSE,FALSE,FALSE,11.78,"old",63,178,74,"m"
20,"VERTICAL TRACTION",2,"Ecc10",3540,3500,5250,2500,3520,3875,0.101,-355,3697.5,"Ecc",40,2750,TRUE,FALSE,TRUE,9.16,"old",63,178,74,"m"
20,"VERTICAL TRACTION",1,"Rep01",6340,6340,6200,4350,6340,5275,0.168,1065,5807.5,"Rep",0,1850,TRUE,FALSE,TRUE,20.19,"old",63,178,74,"m"
20,"VERTICAL TRACTION",1,"Rep02",4320,4340,4300,4150,4330,4225,0.024,105,4277.5,"Rep",-20,150,FALSE,FALSE,FALSE,2.49,"old",63,178,74,"m"
20,"VERTICAL TRACTION",1,"Rep03",4220,4220,4150,3800,4220,3975,0.058,245,4097.5,"Rep",0,350,TRUE,FALSE,TRUE,6.16,"old",63,178,74,"m"
20,"VERTICAL TRACTION",1,"Rep04",3700,3700,3800,3550,3700,3675,0.007,25,3687.5,"Rep",0,250,FALSE,FALSE,TRUE,0.68,"old",63,178,74,"m"
20,"VERTICAL TRACTION",1,"Rep05",3600,3600,3600,3350,3600,3475,0.035,125,3537.5,"Rep",0,250,FALSE,FALSE,TRUE,3.6,"old",63,178,74,"m"
20,"VERTICAL TRACTION",1,"Rep06",3420,3440,3400,3350,3430,3375,0.016,55,3402.5,"Rep",-20,50,FALSE,FALSE,FALSE,1.63,"old",63,178,74,"m"
20,"VERTICAL TRACTION",1,"Rep07",3320,3320,3300,3300,3320,3300,0.006,20,3310,"Rep",0,0,FALSE,FALSE,FALSE,0.61,"old",63,178,74,"m"
20,"VERTICAL TRACTION",1,"Rep08",3340,3300,3300,3600,3320,3450,0.039,-130,3385,"Rep",40,-300,FALSE,FALSE,TRUE,3.77,"old",63,178,74,"m"
20,"VERTICAL TRACTION",1,"Rep09",3600,3600,3600,4550,3600,4075,0.132,-475,3837.5,"Rep",0,-950,TRUE,FALSE,TRUE,11.66,"old",63,178,74,"m"
20,"VERTICAL TRACTION",1,"Rep10",4380,4420,4100,0,4400,2050,0.534,2350,3225,"Rep",-40,4100,TRUE,FALSE,TRUE,114.63,"old",63,178,74,"m"
20,"VERTICAL TRACTION",2,"Rep01",6680,6700,6700,6800,6690,6750,0.009,-60,6720,"Rep",-20,-100,FALSE,FALSE,FALSE,0.89,"old",63,178,74,"m"
20,"VERTICAL TRACTION",2,"Rep02",4980,4980,5000,4950,4980,4975,0.001,5,4977.5,"Rep",0,50,FALSE,FALSE,FALSE,0.1,"old",63,178,74,"m"
20,"VERTICAL TRACTION",2,"Rep03",4220,4240,4150,4150,4230,4150,0.019,80,4190,"Rep",-20,0,FALSE,FALSE,FALSE,1.93,"old",63,178,74,"m"
20,"VERTICAL TRACTION",2,"Rep04",3580,3540,3550,3600,3560,3575,0.004,-15,3567.5,"Rep",40,-50,FALSE,FALSE,FALSE,0.42,"old",63,178,74,"m"
20,"VERTICAL TRACTION",2,"Rep05",3660,3660,3600,3600,3660,3600,0.016,60,3630,"Rep",0,0,FALSE,FALSE,FALSE,1.67,"old",63,178,74,"m"
20,"VERTICAL TRACTION",2,"Rep06",3720,3760,3800,3750,3740,3775,0.009,-35,3757.5,"Rep",-40,50,FALSE,FALSE,FALSE,0.93,"old",63,178,74,"m"
20,"VERTICAL TRACTION",2,"Rep07",3660,3620,3650,3650,3640,3650,0.003,-10,3645,"Rep",40,0,FALSE,FALSE,FALSE,0.27,"old",63,178,74,"m"
20,"VERTICAL TRACTION",2,"Rep08",3660,3700,3700,3650,3680,3675,0.001,5,3677.5,"Rep",-40,50,FALSE,FALSE,FALSE,0.14,"old",63,178,74,"m"
20,"VERTICAL TRACTION",2,"Rep09",3560,3540,3500,3450,3550,3475,0.021,75,3512.5,"Rep",20,50,FALSE,FALSE,FALSE,2.16,"old",63,178,74,"m"
20,"VERTICAL TRACTION",2,"Rep10",5160,5140,7000,4400,5150,5700,0.107,-550,5425,"Rep",20,2600,TRUE,FALSE,TRUE,9.65,"old",63,178,74,"m"
20,"VERTICAL TRACTION",1,"TuT",40240,40280,39750,34000,40260,36875,0.084,3385,38567.5,"TuT",-40,5750,TRUE,FALSE,TRUE,9.18,"old",63,178,74,"m"
20,"VERTICAL TRACTION",2,"TuT",42880,42880,44650,42000,42880,43325,0.01,-445,43102.5,"TuT",0,2650,FALSE,FALSE,TRUE,1.03,"old",63,178,74,"m"
20,"CHEST PRESS",1,"Con01",4540,4520,3550,2600,4530,3075,0.321,1455,3802.5,"Con",20,950,TRUE,FALSE,TRUE,47.32,"old",63,178,74,"m"
20,"CHEST PRESS",1,"Con02",3460,3400,2300,1700,3430,2000,0.417,1430,2715,"Con",60,600,TRUE,TRUE,TRUE,71.5,"old",63,178,74,"m"
20,"CHEST PRESS",1,"Con03",2380,2380,2150,1950,2380,2050,0.139,330,2215,"Con",0,200,FALSE,FALSE,FALSE,16.1,"old",63,178,74,"m"
20,"CHEST PRESS",1,"Con04",2520,2520,2600,2100,2520,2350,0.067,170,2435,"Con",0,500,FALSE,FALSE,TRUE,7.23,"old",63,178,74,"m"
20,"CHEST PRESS",1,"Con05",2420,2440,3050,2350,2430,2700,0.111,-270,2565,"Con",-20,700,FALSE,FALSE,TRUE,10,"old",63,178,74,"m"
20,"CHEST PRESS",1,"Con06",2240,2240,2700,2500,2240,2600,0.161,-360,2420,"Con",0,200,TRUE,FALSE,FALSE,13.85,"old",63,178,74,"m"
20,"CHEST PRESS",1,"Con07",2220,2240,2650,3000,2230,2825,0.267,-595,2527.5,"Con",-20,-350,TRUE,FALSE,TRUE,21.06,"old",63,178,74,"m"
20,"CHEST PRESS",1,"Con08",2340,2360,2700,3950,2350,3325,0.415,-975,2837.5,"Con",-20,-1250,TRUE,FALSE,TRUE,29.32,"old",63,178,74,"m"
20,"CHEST PRESS",1,"Con09",2340,2320,2750,3100,2330,2925,0.255,-595,2627.5,"Con",20,-350,TRUE,FALSE,TRUE,20.34,"old",63,178,74,"m"
20,"CHEST PRESS",1,"Con10",2400,2420,2600,2850,2410,2725,0.131,-315,2567.5,"Con",-20,-250,FALSE,FALSE,FALSE,11.56,"old",63,178,74,"m"
20,"CHEST PRESS",2,"Con01",4320,4320,4550,3100,4320,3825,0.115,495,4072.5,"Con",0,1450,TRUE,FALSE,TRUE,12.94,"old",63,178,74,"m"
20,"CHEST PRESS",2,"Con02",3420,3440,3100,2700,3430,2900,0.155,530,3165,"Con",-20,400,TRUE,FALSE,TRUE,18.28,"old",63,178,74,"m"
20,"CHEST PRESS",2,"Con03",3220,3200,2900,2750,3210,2825,0.12,385,3017.5,"Con",20,150,TRUE,FALSE,FALSE,13.63,"old",63,178,74,"m"
20,"CHEST PRESS",2,"Con04",3500,3540,2550,2700,3520,2625,0.254,895,3072.5,"Con",-40,-150,TRUE,TRUE,FALSE,34.1,"old",63,178,74,"m"
20,"CHEST PRESS",2,"Con05",3120,3160,3150,2900,3140,3025,0.037,115,3082.5,"Con",-40,250,FALSE,TRUE,FALSE,3.8,"old",63,178,74,"m"
20,"CHEST PRESS",2,"Con06",3280,3260,3500,3450,3270,3475,0.063,-205,3372.5,"Con",20,50,FALSE,FALSE,FALSE,5.9,"old",63,178,74,"m"
20,"CHEST PRESS",2,"Con07",2760,2720,3300,3400,2740,3350,0.223,-610,3045,"Con",40,-100,TRUE,TRUE,FALSE,18.21,"old",63,178,74,"m"
20,"CHEST PRESS",2,"Con08",2940,2960,3450,3900,2950,3675,0.246,-725,3312.5,"Con",-20,-450,TRUE,FALSE,TRUE,19.73,"old",63,178,74,"m"
20,"CHEST PRESS",2,"Con09",3060,3040,3650,3850,3050,3750,0.23,-700,3400,"Con",20,-200,TRUE,FALSE,FALSE,18.67,"old",63,178,74,"m"
20,"CHEST PRESS",2,"Con10",3600,3620,3450,3800,3610,3625,0.004,-15,3617.5,"Con",-20,-350,FALSE,FALSE,TRUE,0.41,"old",63,178,74,"m"
20,"CHEST PRESS",1,"Ecc01",5200,5220,6050,6700,5210,6375,0.224,-1165,5792.5,"Ecc",-20,-650,TRUE,FALSE,TRUE,18.27,"old",63,178,74,"m"
20,"CHEST PRESS",1,"Ecc02",4340,4340,5100,5000,4340,5050,0.164,-710,4695,"Ecc",0,100,TRUE,FALSE,FALSE,14.06,"old",63,178,74,"m"
20,"CHEST PRESS",1,"Ecc03",4460,4460,4600,4800,4460,4700,0.054,-240,4580,"Ecc",0,-200,FALSE,FALSE,FALSE,5.11,"old",63,178,74,"m"
20,"CHEST PRESS",1,"Ecc04",3720,3720,3600,4100,3720,3850,0.035,-130,3785,"Ecc",0,-500,FALSE,FALSE,TRUE,3.38,"old",63,178,74,"m"
20,"CHEST PRESS",1,"Ecc05",3540,3520,2850,3450,3530,3150,0.108,380,3340,"Ecc",20,-600,TRUE,FALSE,TRUE,12.06,"old",63,178,74,"m"
20,"CHEST PRESS",1,"Ecc06",3160,3140,2700,2800,3150,2750,0.127,400,2950,"Ecc",20,-100,TRUE,FALSE,FALSE,14.55,"old",63,178,74,"m"
20,"CHEST PRESS",1,"Ecc07",3060,3040,2600,2200,3050,2400,0.213,650,2725,"Ecc",20,400,TRUE,FALSE,TRUE,27.08,"old",63,178,74,"m"
20,"CHEST PRESS",1,"Ecc08",3780,3760,3500,2200,3770,2850,0.244,920,3310,"Ecc",20,1300,TRUE,FALSE,TRUE,32.28,"old",63,178,74,"m"
20,"CHEST PRESS",1,"Ecc09",3600,3640,3100,2800,3620,2950,0.185,670,3285,"Ecc",-40,300,TRUE,TRUE,TRUE,22.71,"old",63,178,74,"m"
20,"CHEST PRESS",1,"Ecc10",4200,4200,750,4350,4200,2550,0.393,1650,3375,"Ecc",0,-3600,TRUE,FALSE,TRUE,64.71,"old",63,178,74,"m"
20,"CHEST PRESS",2,"Ecc01",4000,4000,3850,4250,4000,4050,0.012,-50,4025,"Ecc",0,-400,FALSE,FALSE,TRUE,1.23,"old",63,178,74,"m"
20,"CHEST PRESS",2,"Ecc02",3620,3620,3850,4250,3620,4050,0.119,-430,3835,"Ecc",0,-400,TRUE,FALSE,TRUE,10.62,"old",63,178,74,"m"
20,"CHEST PRESS",2,"Ecc03",3200,3200,3600,3600,3200,3600,0.125,-400,3400,"Ecc",0,0,TRUE,FALSE,FALSE,11.11,"old",63,178,74,"m"
20,"CHEST PRESS",2,"Ecc04",2800,2760,3750,3700,2780,3725,0.34,-945,3252.5,"Ecc",40,50,TRUE,TRUE,FALSE,25.37,"old",63,178,74,"m"
20,"CHEST PRESS",2,"Ecc05",3000,2980,2850,3100,2990,2975,0.005,15,2982.5,"Ecc",20,-250,FALSE,FALSE,TRUE,0.5,"old",63,178,74,"m"
20,"CHEST PRESS",2,"Ecc06",3180,3200,2800,2900,3190,2850,0.107,340,3020,"Ecc",-20,-100,TRUE,FALSE,FALSE,11.93,"old",63,178,74,"m"
20,"CHEST PRESS",2,"Ecc07",3440,3460,2850,2550,3450,2700,0.217,750,3075,"Ecc",-20,300,TRUE,FALSE,TRUE,27.78,"old",63,178,74,"m"
20,"CHEST PRESS",2,"Ecc08",3380,3400,2800,2300,3390,2550,0.248,840,2970,"Ecc",-20,500,TRUE,FALSE,TRUE,32.94,"old",63,178,74,"m"
20,"CHEST PRESS",2,"Ecc09",3300,3280,3000,2900,3290,2950,0.103,340,3120,"Ecc",20,100,TRUE,FALSE,FALSE,11.53,"old",63,178,74,"m"
20,"CHEST PRESS",2,"Ecc10",3580,3580,3950,6850,3580,5400,0.508,-1820,4490,"Ecc",0,-2900,TRUE,FALSE,TRUE,33.7,"old",63,178,74,"m"
20,"CHEST PRESS",1,"Rep01",9740,9740,9600,9300,9740,9450,0.03,290,9595,"Rep",0,300,TRUE,FALSE,TRUE,3.07,"old",63,178,74,"m"
20,"CHEST PRESS",1,"Rep02",7800,7740,7400,6700,7770,7050,0.093,720,7410,"Rep",60,700,TRUE,FALSE,TRUE,10.21,"old",63,178,74,"m"
20,"CHEST PRESS",1,"Rep03",6840,6840,6750,6750,6840,6750,0.013,90,6795,"Rep",0,0,FALSE,FALSE,FALSE,1.33,"old",63,178,74,"m"
20,"CHEST PRESS",1,"Rep04",6240,6240,6200,6200,6240,6200,0.006,40,6220,"Rep",0,0,FALSE,FALSE,FALSE,0.65,"old",63,178,74,"m"
20,"CHEST PRESS",1,"Rep05",5960,5960,5900,5800,5960,5850,0.018,110,5905,"Rep",0,100,FALSE,FALSE,FALSE,1.88,"old",63,178,74,"m"
20,"CHEST PRESS",1,"Rep06",5400,5380,5400,5300,5390,5350,0.007,40,5370,"Rep",20,100,FALSE,FALSE,FALSE,0.75,"old",63,178,74,"m"
20,"CHEST PRESS",1,"Rep07",5280,5280,5250,5200,5280,5225,0.01,55,5252.5,"Rep",0,50,FALSE,FALSE,FALSE,1.05,"old",63,178,74,"m"
20,"CHEST PRESS",1,"Rep08",6120,6120,6200,6150,6120,6175,0.009,-55,6147.5,"Rep",0,50,FALSE,FALSE,FALSE,0.89,"old",63,178,74,"m"
20,"CHEST PRESS",1,"Rep09",5940,5960,5850,5900,5950,5875,0.013,75,5912.5,"Rep",-20,-50,FALSE,FALSE,FALSE,1.28,"old",63,178,74,"m"
20,"CHEST PRESS",1,"Rep10",6600,6620,3350,7200,6610,5275,0.202,1335,5942.5,"Rep",-20,-3850,TRUE,FALSE,TRUE,25.31,"old",63,178,74,"m"
20,"CHEST PRESS",2,"Rep01",8320,8320,8400,7350,8320,7875,0.053,445,8097.5,"Rep",0,1050,TRUE,FALSE,TRUE,5.65,"old",63,178,74,"m"
20,"CHEST PRESS",2,"Rep02",7040,7060,6950,6950,7050,6950,0.014,100,7000,"Rep",-20,0,FALSE,FALSE,FALSE,1.44,"old",63,178,74,"m"
20,"CHEST PRESS",2,"Rep03",6420,6400,6500,6350,6410,6425,0.002,-15,6417.5,"Rep",20,150,FALSE,FALSE,FALSE,0.23,"old",63,178,74,"m"
20,"CHEST PRESS",2,"Rep04",6300,6300,6300,6400,6300,6350,0.008,-50,6325,"Rep",0,-100,FALSE,FALSE,FALSE,0.79,"old",63,178,74,"m"
20,"CHEST PRESS",2,"Rep05",6120,6140,6000,6000,6130,6000,0.021,130,6065,"Rep",-20,0,FALSE,FALSE,FALSE,2.17,"old",63,178,74,"m"
20,"CHEST PRESS",2,"Rep06",6460,6460,6300,6350,6460,6325,0.021,135,6392.5,"Rep",0,-50,FALSE,FALSE,FALSE,2.13,"old",63,178,74,"m"
20,"CHEST PRESS",2,"Rep07",6200,6180,6150,5950,6190,6050,0.023,140,6120,"Rep",20,200,FALSE,FALSE,TRUE,2.31,"old",63,178,74,"m"
20,"CHEST PRESS",2,"Rep08",6320,6360,6250,6200,6340,6225,0.018,115,6282.5,"Rep",-40,50,FALSE,FALSE,FALSE,1.85,"old",63,178,74,"m"
20,"CHEST PRESS",2,"Rep09",6360,6320,6650,6750,6340,6700,0.057,-360,6520,"Rep",40,-100,TRUE,FALSE,FALSE,5.37,"old",63,178,74,"m"
20,"CHEST PRESS",2,"Rep10",7180,7200,7400,10650,7190,9025,0.255,-1835,8107.5,"Rep",-20,-3250,TRUE,FALSE,TRUE,20.33,"old",63,178,74,"m"
20,"CHEST PRESS",1,"TuT",65920,65880,61900,64500,65900,63200,0.041,2700,64550,"TuT",40,-2600,TRUE,FALSE,TRUE,4.27,"old",63,178,74,"m"
20,"CHEST PRESS",2,"TuT",66720,66740,66900,68950,66730,67925,0.018,-1195,67327.5,"TuT",-20,-2050,FALSE,FALSE,TRUE,1.76,"old",63,178,74,"m"
21,"LEG PRESS",1,"Con01",1440,1460,1550,1450,1450,1500,0.034,-50,1475,"Con",-20,100,FALSE,FALSE,FALSE,3.33,"young",35,180,88,"m"
21,"LEG PRESS",1,"Con02",1200,1200,1250,1250,1200,1250,0.042,-50,1225,"Con",0,0,FALSE,FALSE,FALSE,4,"young",35,180,88,"m"
21,"LEG PRESS",1,"Con03",1300,1300,1350,1300,1300,1325,0.019,-25,1312.5,"Con",0,50,FALSE,FALSE,FALSE,1.89,"young",35,180,88,"m"
21,"LEG PRESS",1,"Con04",1240,1220,1350,1350,1230,1350,0.098,-120,1290,"Con",20,0,FALSE,FALSE,FALSE,8.89,"young",35,180,88,"m"
21,"LEG PRESS",1,"Con05",1540,1540,1650,1700,1540,1675,0.088,-135,1607.5,"Con",0,-50,FALSE,FALSE,FALSE,8.06,"young",35,180,88,"m"
21,"LEG PRESS",1,"Con06",1360,1340,1600,1550,1350,1575,0.167,-225,1462.5,"Con",20,50,FALSE,FALSE,FALSE,14.29,"young",35,180,88,"m"
21,"LEG PRESS",1,"Con07",1340,1360,1700,1600,1350,1650,0.222,-300,1500,"Con",-20,100,FALSE,FALSE,FALSE,18.18,"young",35,180,88,"m"
21,"LEG PRESS",1,"Con08",1580,1580,1750,1750,1580,1750,0.108,-170,1665,"Con",0,0,FALSE,FALSE,FALSE,9.71,"young",35,180,88,"m"
21,"LEG PRESS",1,"Con09",1500,1500,1750,1800,1500,1775,0.183,-275,1637.5,"Con",0,-50,FALSE,FALSE,FALSE,15.49,"young",35,180,88,"m"
21,"LEG PRESS",1,"Con10",1600,1600,2300,2450,1600,2375,0.484,-775,1987.5,"Con",0,-150,TRUE,FALSE,FALSE,32.63,"young",35,180,88,"m"
21,"LEG PRESS",2,"Con01",1460,1460,1600,1650,1460,1625,0.113,-165,1542.5,"Con",0,-50,FALSE,FALSE,FALSE,10.15,"young",35,180,88,"m"
21,"LEG PRESS",2,"Con02",1380,1420,1500,1400,1400,1450,0.036,-50,1425,"Con",-40,100,FALSE,FALSE,FALSE,3.45,"young",35,180,88,"m"
21,"LEG PRESS",2,"Con03",1420,1400,1600,1500,1410,1550,0.099,-140,1480,"Con",20,100,FALSE,FALSE,FALSE,9.03,"young",35,180,88,"m"
21,"LEG PRESS",2,"Con04",1440,1440,1650,1700,1440,1675,0.163,-235,1557.5,"Con",0,-50,FALSE,FALSE,FALSE,14.03,"young",35,180,88,"m"
21,"LEG PRESS",2,"Con05",1460,1460,1800,1800,1460,1800,0.233,-340,1630,"Con",0,0,FALSE,FALSE,FALSE,18.89,"young",35,180,88,"m"
21,"LEG PRESS",2,"Con06",1600,1600,1550,1550,1600,1550,0.031,50,1575,"Con",0,0,FALSE,FALSE,FALSE,3.23,"young",35,180,88,"m"
21,"LEG PRESS",2,"Con07",1660,1680,1700,1700,1670,1700,0.018,-30,1685,"Con",-20,0,FALSE,FALSE,FALSE,1.76,"young",35,180,88,"m"
21,"LEG PRESS",2,"Con08",1560,1540,1700,1750,1550,1725,0.113,-175,1637.5,"Con",20,-50,FALSE,FALSE,FALSE,10.14,"young",35,180,88,"m"
21,"LEG PRESS",2,"Con09",1520,1520,2050,2100,1520,2075,0.365,-555,1797.5,"Con",0,-50,TRUE,FALSE,FALSE,26.75,"young",35,180,88,"m"
21,"LEG PRESS",2,"Con10",1760,1760,2800,2750,1760,2775,0.577,-1015,2267.5,"Con",0,50,TRUE,FALSE,FALSE,36.58,"young",35,180,88,"m"
21,"LEG PRESS",1,"Ecc01",1800,1780,1750,1800,1790,1775,0.008,15,1782.5,"Ecc",20,-50,FALSE,FALSE,FALSE,0.85,"young",35,180,88,"m"
21,"LEG PRESS",1,"Ecc02",2020,2040,2000,2000,2030,2000,0.015,30,2015,"Ecc",-20,0,FALSE,FALSE,FALSE,1.5,"young",35,180,88,"m"
21,"LEG PRESS",1,"Ecc03",2160,2160,2050,2100,2160,2075,0.039,85,2117.5,"Ecc",0,-50,FALSE,FALSE,FALSE,4.1,"young",35,180,88,"m"
21,"LEG PRESS",1,"Ecc04",2300,2300,2200,2150,2300,2175,0.054,125,2237.5,"Ecc",0,50,FALSE,FALSE,FALSE,5.75,"young",35,180,88,"m"
21,"LEG PRESS",1,"Ecc05",1780,1820,1650,1650,1800,1650,0.083,150,1725,"Ecc",-40,0,FALSE,FALSE,FALSE,9.09,"young",35,180,88,"m"
21,"LEG PRESS",1,"Ecc06",1980,1960,1700,1750,1970,1725,0.124,245,1847.5,"Ecc",20,-50,FALSE,FALSE,FALSE,14.2,"young",35,180,88,"m"
21,"LEG PRESS",1,"Ecc07",2000,2020,1650,1750,2010,1700,0.154,310,1855,"Ecc",-20,-100,FALSE,FALSE,FALSE,18.24,"young",35,180,88,"m"
21,"LEG PRESS",1,"Ecc08",1980,1940,1800,1750,1960,1775,0.094,185,1867.5,"Ecc",40,50,FALSE,FALSE,FALSE,10.42,"young",35,180,88,"m"
21,"LEG PRESS",1,"Ecc09",2280,2300,1850,1750,2290,1800,0.214,490,2045,"Ecc",-20,100,TRUE,FALSE,FALSE,27.22,"young",35,180,88,"m"
21,"LEG PRESS",1,"Ecc10",2240,2240,1850,1800,2240,1825,0.185,415,2032.5,"Ecc",0,50,TRUE,FALSE,FALSE,22.74,"young",35,180,88,"m"
21,"LEG PRESS",2,"Ecc01",1860,1840,1750,1800,1850,1775,0.041,75,1812.5,"Ecc",20,-50,FALSE,FALSE,FALSE,4.23,"young",35,180,88,"m"
21,"LEG PRESS",2,"Ecc02",1800,1780,1700,1800,1790,1750,0.022,40,1770,"Ecc",20,-100,FALSE,FALSE,FALSE,2.29,"young",35,180,88,"m"
21,"LEG PRESS",2,"Ecc03",2180,2200,1950,2000,2190,1975,0.098,215,2082.5,"Ecc",-20,-50,FALSE,FALSE,FALSE,10.89,"young",35,180,88,"m"
21,"LEG PRESS",2,"Ecc04",2200,2200,1900,1850,2200,1875,0.148,325,2037.5,"Ecc",0,50,TRUE,FALSE,FALSE,17.33,"young",35,180,88,"m"
21,"LEG PRESS",2,"Ecc05",2020,2000,1900,1900,2010,1900,0.055,110,1955,"Ecc",20,0,FALSE,FALSE,FALSE,5.79,"young",35,180,88,"m"
21,"LEG PRESS",2,"Ecc06",2140,2160,2150,2150,2150,2150,0,0,2150,"Ecc",-20,0,FALSE,FALSE,FALSE,0,"young",35,180,88,"m"
21,"LEG PRESS",2,"Ecc07",2000,1980,1900,1900,1990,1900,0.045,90,1945,"Ecc",20,0,FALSE,FALSE,FALSE,4.74,"young",35,180,88,"m"
21,"LEG PRESS",2,"Ecc08",2240,2240,2000,1950,2240,1975,0.118,265,2107.5,"Ecc",0,50,FALSE,FALSE,FALSE,13.42,"young",35,180,88,"m"
21,"LEG PRESS",2,"Ecc09",2400,2420,1550,1500,2410,1525,0.367,885,1967.5,"Ecc",-20,50,TRUE,FALSE,FALSE,58.03,"young",35,180,88,"m"
21,"LEG PRESS",2,"Ecc10",2140,2140,1600,1850,2140,1725,0.194,415,1932.5,"Ecc",0,-250,TRUE,FALSE,TRUE,24.06,"young",35,180,88,"m"
21,"LEG PRESS",1,"Rep01",3240,3240,3300,3250,3240,3275,0.011,-35,3257.5,"Rep",0,50,FALSE,FALSE,FALSE,1.07,"young",35,180,88,"m"
21,"LEG PRESS",1,"Rep02",3220,3240,3250,3250,3230,3250,0.006,-20,3240,"Rep",-20,0,FALSE,FALSE,FALSE,0.62,"young",35,180,88,"m"
21,"LEG PRESS",1,"Rep03",3460,3460,3400,3400,3460,3400,0.017,60,3430,"Rep",0,0,FALSE,FALSE,FALSE,1.76,"young",35,180,88,"m"
21,"LEG PRESS",1,"Rep04",3540,3520,3550,3500,3530,3525,0.001,5,3527.5,"Rep",20,50,FALSE,FALSE,FALSE,0.14,"young",35,180,88,"m"
21,"LEG PRESS",1,"Rep05",3320,3360,3300,3350,3340,3325,0.004,15,3332.5,"Rep",-40,-50,FALSE,FALSE,FALSE,0.45,"young",35,180,88,"m"
21,"LEG PRESS",1,"Rep06",3340,3300,3300,3300,3320,3300,0.006,20,3310,"Rep",40,0,FALSE,FALSE,FALSE,0.61,"young",35,180,88,"m"
21,"LEG PRESS",1,"Rep07",3340,3380,3350,3350,3360,3350,0.003,10,3355,"Rep",-40,0,FALSE,FALSE,FALSE,0.3,"young",35,180,88,"m"
21,"LEG PRESS",1,"Rep08",3560,3520,3550,3500,3540,3525,0.004,15,3532.5,"Rep",40,50,FALSE,FALSE,FALSE,0.43,"young",35,180,88,"m"
21,"LEG PRESS",1,"Rep09",3780,3800,3600,3550,3790,3575,0.057,215,3682.5,"Rep",-20,50,TRUE,FALSE,FALSE,6.01,"young",35,180,88,"m"
21,"LEG PRESS",1,"Rep10",3840,3840,4150,4250,3840,4200,0.094,-360,4020,"Rep",0,-100,TRUE,FALSE,TRUE,8.57,"young",35,180,88,"m"
21,"LEG PRESS",2,"Rep01",3320,3300,3350,3450,3310,3400,0.027,-90,3355,"Rep",20,-100,FALSE,FALSE,TRUE,2.65,"young",35,180,88,"m"
21,"LEG PRESS",2,"Rep02",3180,3200,3200,3200,3190,3200,0.003,-10,3195,"Rep",-20,0,FALSE,FALSE,FALSE,0.31,"young",35,180,88,"m"
21,"LEG PRESS",2,"Rep03",3600,3600,3550,3500,3600,3525,0.021,75,3562.5,"Rep",0,50,FALSE,FALSE,FALSE,2.13,"young",35,180,88,"m"
21,"LEG PRESS",2,"Rep04",3640,3640,3550,3550,3640,3550,0.025,90,3595,"Rep",0,0,FALSE,FALSE,FALSE,2.54,"young",35,180,88,"m"
21,"LEG PRESS",2,"Rep05",3480,3460,3700,3700,3470,3700,0.066,-230,3585,"Rep",20,0,TRUE,FALSE,FALSE,6.22,"young",35,180,88,"m"
21,"LEG PRESS",2,"Rep06",3740,3760,3700,3700,3750,3700,0.013,50,3725,"Rep",-20,0,FALSE,FALSE,FALSE,1.35,"young",35,180,88,"m"
21,"LEG PRESS",2,"Rep07",3660,3660,3600,3600,3660,3600,0.016,60,3630,"Rep",0,0,FALSE,FALSE,FALSE,1.67,"young",35,180,88,"m"
21,"LEG PRESS",2,"Rep08",3800,3780,3700,3700,3790,3700,0.024,90,3745,"Rep",20,0,FALSE,FALSE,FALSE,2.43,"young",35,180,88,"m"
21,"LEG PRESS",2,"Rep09",3920,3940,3600,3600,3930,3600,0.084,330,3765,"Rep",-20,0,TRUE,FALSE,FALSE,9.17,"young",35,180,88,"m"
21,"LEG PRESS",2,"Rep10",3900,3900,4400,4600,3900,4500,0.154,-600,4200,"Rep",0,-200,TRUE,FALSE,TRUE,13.33,"young",35,180,88,"m"
21,"LEG PRESS",1,"TuT",34640,34660,34750,34700,34650,34725,0.002,-75,34687.5,"TuT",-20,50,FALSE,FALSE,FALSE,0.22,"young",35,180,88,"m"
21,"LEG PRESS",2,"TuT",36240,36240,36350,36600,36240,36475,0.006,-235,36357.5,"TuT",0,-250,FALSE,FALSE,FALSE,0.64,"young",35,180,88,"m"
21,"LEG EXTENSION",1,"Con01",1180,1200,1350,1150,1190,1250,0.05,-60,1220,"Con",-20,200,FALSE,FALSE,TRUE,4.8,"young",35,180,88,"m"
21,"LEG EXTENSION",1,"Con02",980,980,1050,1000,980,1025,0.046,-45,1002.5,"Con",0,50,FALSE,FALSE,FALSE,4.39,"young",35,180,88,"m"
21,"LEG EXTENSION",1,"Con03",1040,1060,1050,1100,1050,1075,0.024,-25,1062.5,"Con",-20,-50,FALSE,FALSE,FALSE,2.33,"young",35,180,88,"m"
21,"LEG EXTENSION",1,"Con04",1020,1040,1050,1050,1030,1050,0.019,-20,1040,"Con",-20,0,FALSE,FALSE,FALSE,1.9,"young",35,180,88,"m"
21,"LEG EXTENSION",1,"Con05",1000,1000,1100,1100,1000,1100,0.1,-100,1050,"Con",0,0,FALSE,FALSE,FALSE,9.09,"young",35,180,88,"m"
21,"LEG EXTENSION",1,"Con06",1000,1000,1100,1150,1000,1125,0.125,-125,1062.5,"Con",0,-50,FALSE,FALSE,FALSE,11.11,"young",35,180,88,"m"
21,"LEG EXTENSION",1,"Con07",1020,1020,1150,1150,1020,1150,0.127,-130,1085,"Con",0,0,FALSE,FALSE,FALSE,11.3,"young",35,180,88,"m"
21,"LEG EXTENSION",1,"Con08",1080,1080,1200,1150,1080,1175,0.088,-95,1127.5,"Con",0,50,FALSE,FALSE,FALSE,8.09,"young",35,180,88,"m"
21,"LEG EXTENSION",1,"Con09",1040,1040,1250,1350,1040,1300,0.25,-260,1170,"Con",0,-100,TRUE,FALSE,FALSE,20,"young",35,180,88,"m"
21,"LEG EXTENSION",1,"Con10",1120,1140,1600,1650,1130,1625,0.438,-495,1377.5,"Con",-20,-50,TRUE,FALSE,FALSE,30.46,"young",35,180,88,"m"
21,"LEG EXTENSION",2,"Con01",1120,1140,1250,1250,1130,1250,0.106,-120,1190,"Con",-20,0,FALSE,FALSE,FALSE,9.6,"young",35,180,88,"m"
21,"LEG EXTENSION",2,"Con02",1080,1080,1100,1100,1080,1100,0.019,-20,1090,"Con",0,0,FALSE,FALSE,FALSE,1.82,"young",35,180,88,"m"
21,"LEG EXTENSION",2,"Con03",1020,1020,1050,1050,1020,1050,0.029,-30,1035,"Con",0,0,FALSE,FALSE,FALSE,2.86,"young",35,180,88,"m"
21,"LEG EXTENSION",2,"Con04",1060,1060,1150,1100,1060,1125,0.061,-65,1092.5,"Con",0,50,FALSE,FALSE,FALSE,5.78,"young",35,180,88,"m"
21,"LEG EXTENSION",2,"Con05",1000,1000,1150,1050,1000,1100,0.1,-100,1050,"Con",0,100,FALSE,FALSE,FALSE,9.09,"young",35,180,88,"m"
21,"LEG EXTENSION",2,"Con06",1080,1060,1200,1100,1070,1150,0.075,-80,1110,"Con",20,100,FALSE,FALSE,FALSE,6.96,"young",35,180,88,"m"
21,"LEG EXTENSION",2,"Con07",1060,1060,1200,1150,1060,1175,0.108,-115,1117.5,"Con",0,50,FALSE,FALSE,FALSE,9.79,"young",35,180,88,"m"
21,"LEG EXTENSION",2,"Con08",1040,1040,1150,1200,1040,1175,0.13,-135,1107.5,"Con",0,-50,FALSE,FALSE,FALSE,11.49,"young",35,180,88,"m"
21,"LEG EXTENSION",2,"Con09",1040,1040,1200,1350,1040,1275,0.226,-235,1157.5,"Con",0,-150,TRUE,FALSE,FALSE,18.43,"young",35,180,88,"m"
21,"LEG EXTENSION",2,"Con10",1100,1140,1400,1650,1120,1525,0.362,-405,1322.5,"Con",-40,-250,TRUE,TRUE,TRUE,26.56,"young",35,180,88,"m"
21,"LEG EXTENSION",1,"Ecc01",1960,1940,1900,1950,1950,1925,0.013,25,1937.5,"Ecc",20,-50,FALSE,FALSE,FALSE,1.3,"young",35,180,88,"m"
21,"LEG EXTENSION",1,"Ecc02",2120,2100,2100,2100,2110,2100,0.005,10,2105,"Ecc",20,0,FALSE,FALSE,FALSE,0.48,"young",35,180,88,"m"
21,"LEG EXTENSION",1,"Ecc03",1940,1920,1900,1900,1930,1900,0.016,30,1915,"Ecc",20,0,FALSE,FALSE,FALSE,1.58,"young",35,180,88,"m"
21,"LEG EXTENSION",1,"Ecc04",1900,1900,1850,1800,1900,1825,0.039,75,1862.5,"Ecc",0,50,FALSE,FALSE,FALSE,4.11,"young",35,180,88,"m"
21,"LEG EXTENSION",1,"Ecc05",2080,2080,1950,1950,2080,1950,0.062,130,2015,"Ecc",0,0,FALSE,FALSE,FALSE,6.67,"young",35,180,88,"m"
21,"LEG EXTENSION",1,"Ecc06",1940,1940,1850,1800,1940,1825,0.059,115,1882.5,"Ecc",0,50,FALSE,FALSE,FALSE,6.3,"young",35,180,88,"m"
21,"LEG EXTENSION",1,"Ecc07",1980,1980,1850,1900,1980,1875,0.053,105,1927.5,"Ecc",0,-50,FALSE,FALSE,FALSE,5.6,"young",35,180,88,"m"
21,"LEG EXTENSION",1,"Ecc08",1840,1840,1650,1600,1840,1625,0.117,215,1732.5,"Ecc",0,50,TRUE,FALSE,FALSE,13.23,"young",35,180,88,"m"
21,"LEG EXTENSION",1,"Ecc09",2000,1980,1550,1450,1990,1500,0.246,490,1745,"Ecc",20,100,TRUE,FALSE,FALSE,32.67,"young",35,180,88,"m"
21,"LEG EXTENSION",1,"Ecc10",1860,1860,1800,1850,1860,1825,0.019,35,1842.5,"Ecc",0,-50,FALSE,FALSE,FALSE,1.92,"young",35,180,88,"m"
21,"LEG EXTENSION",2,"Ecc01",1760,1760,1750,1750,1760,1750,0.006,10,1755,"Ecc",0,0,FALSE,FALSE,FALSE,0.57,"young",35,180,88,"m"
21,"LEG EXTENSION",2,"Ecc02",2180,2180,2150,2150,2180,2150,0.014,30,2165,"Ecc",0,0,FALSE,FALSE,FALSE,1.4,"young",35,180,88,"m"
21,"LEG EXTENSION",2,"Ecc03",2040,2040,1950,2000,2040,1975,0.032,65,2007.5,"Ecc",0,-50,FALSE,FALSE,FALSE,3.29,"young",35,180,88,"m"
21,"LEG EXTENSION",2,"Ecc04",1900,1900,1800,1850,1900,1825,0.039,75,1862.5,"Ecc",0,-50,FALSE,FALSE,FALSE,4.11,"young",35,180,88,"m"
21,"LEG EXTENSION",2,"Ecc05",1700,1720,1550,1650,1710,1600,0.064,110,1655,"Ecc",-20,-100,FALSE,FALSE,FALSE,6.88,"young",35,180,88,"m"
21,"LEG EXTENSION",2,"Ecc06",1720,1720,1600,1700,1720,1650,0.041,70,1685,"Ecc",0,-100,FALSE,FALSE,FALSE,4.24,"young",35,180,88,"m"
21,"LEG EXTENSION",2,"Ecc07",1780,1780,1650,1600,1780,1625,0.087,155,1702.5,"Ecc",0,50,FALSE,FALSE,FALSE,9.54,"young",35,180,88,"m"
21,"LEG EXTENSION",2,"Ecc08",1960,1960,1800,1700,1960,1750,0.107,210,1855,"Ecc",0,100,TRUE,FALSE,FALSE,12,"young",35,180,88,"m"
21,"LEG EXTENSION",2,"Ecc09",1800,1760,1550,1300,1780,1425,0.199,355,1602.5,"Ecc",40,250,TRUE,TRUE,TRUE,24.91,"young",35,180,88,"m"
21,"LEG EXTENSION",2,"Ecc10",1660,1640,1600,1550,1650,1575,0.045,75,1612.5,"Ecc",20,50,FALSE,FALSE,FALSE,4.76,"young",35,180,88,"m"
21,"LEG EXTENSION",1,"Rep01",3140,3140,3250,3100,3140,3175,0.011,-35,3157.5,"Rep",0,150,FALSE,FALSE,FALSE,1.1,"young",35,180,88,"m"
21,"LEG EXTENSION",1,"Rep02",3100,3080,3150,3100,3090,3125,0.011,-35,3107.5,"Rep",20,50,FALSE,FALSE,FALSE,1.12,"young",35,180,88,"m"
21,"LEG EXTENSION",1,"Rep03",2980,2980,2950,3000,2980,2975,0.002,5,2977.5,"Rep",0,-50,FALSE,FALSE,FALSE,0.17,"young",35,180,88,"m"
21,"LEG EXTENSION",1,"Rep04",2920,2940,2900,2850,2930,2875,0.019,55,2902.5,"Rep",-20,50,FALSE,FALSE,FALSE,1.91,"young",35,180,88,"m"
21,"LEG EXTENSION",1,"Rep05",3080,3080,3050,3050,3080,3050,0.01,30,3065,"Rep",0,0,FALSE,FALSE,FALSE,0.98,"young",35,180,88,"m"
21,"LEG EXTENSION",1,"Rep06",2940,2940,2950,2950,2940,2950,0.003,-10,2945,"Rep",0,0,FALSE,FALSE,FALSE,0.34,"young",35,180,88,"m"
21,"LEG EXTENSION",1,"Rep07",3000,3000,3000,3050,3000,3025,0.008,-25,3012.5,"Rep",0,-50,FALSE,FALSE,FALSE,0.83,"young",35,180,88,"m"
21,"LEG EXTENSION",1,"Rep08",2920,2920,2850,2750,2920,2800,0.041,120,2860,"Rep",0,100,TRUE,FALSE,FALSE,4.29,"young",35,180,88,"m"
21,"LEG EXTENSION",1,"Rep09",3040,3020,2800,2800,3030,2800,0.076,230,2915,"Rep",20,0,TRUE,FALSE,FALSE,8.21,"young",35,180,88,"m"
21,"LEG EXTENSION",1,"Rep10",2980,3000,3400,3500,2990,3450,0.154,-460,3220,"Rep",-20,-100,TRUE,FALSE,FALSE,13.33,"young",35,180,88,"m"
21,"LEG EXTENSION",2,"Rep01",2880,2900,3000,3000,2890,3000,0.038,-110,2945,"Rep",-20,0,TRUE,FALSE,FALSE,3.67,"young",35,180,88,"m"
21,"LEG EXTENSION",2,"Rep02",3260,3260,3250,3250,3260,3250,0.003,10,3255,"Rep",0,0,FALSE,FALSE,FALSE,0.31,"young",35,180,88,"m"
21,"LEG EXTENSION",2,"Rep03",3060,3060,3000,3050,3060,3025,0.011,35,3042.5,"Rep",0,-50,FALSE,FALSE,FALSE,1.16,"young",35,180,88,"m"
21,"LEG EXTENSION",2,"Rep04",2960,2960,2950,2950,2960,2950,0.003,10,2955,"Rep",0,0,FALSE,FALSE,FALSE,0.34,"young",35,180,88,"m"
21,"LEG EXTENSION",2,"Rep05",2700,2720,2700,2700,2710,2700,0.004,10,2705,"Rep",-20,0,FALSE,FALSE,FALSE,0.37,"young",35,180,88,"m"
21,"LEG EXTENSION",2,"Rep06",2800,2780,2800,2800,2790,2800,0.004,-10,2795,"Rep",20,0,FALSE,FALSE,FALSE,0.36,"young",35,180,88,"m"
21,"LEG EXTENSION",2,"Rep07",2840,2840,2850,2750,2840,2800,0.014,40,2820,"Rep",0,100,FALSE,FALSE,FALSE,1.43,"young",35,180,88,"m"
21,"LEG EXTENSION",2,"Rep08",3000,3000,2950,2900,3000,2925,0.025,75,2962.5,"Rep",0,50,FALSE,FALSE,FALSE,2.56,"young",35,180,88,"m"
21,"LEG EXTENSION",2,"Rep09",2840,2800,2750,2650,2820,2700,0.043,120,2760,"Rep",40,100,TRUE,FALSE,FALSE,4.44,"young",35,180,88,"m"
21,"LEG EXTENSION",2,"Rep10",2760,2780,3000,3200,2770,3100,0.119,-330,2935,"Rep",-20,-200,TRUE,FALSE,TRUE,10.65,"young",35,180,88,"m"
21,"LEG EXTENSION",1,"TuT",30100,30100,30300,30150,30100,30225,0.004,-125,30162.5,"TuT",0,150,FALSE,FALSE,FALSE,0.41,"young",35,180,88,"m"
21,"LEG EXTENSION",2,"TuT",29100,29100,29250,29250,29100,29250,0.005,-150,29175,"TuT",0,0,FALSE,FALSE,FALSE,0.51,"young",35,180,88,"m"
21,"LEG CURL",1,"Con01",1460,1460,3450,1350,1460,2400,0.644,-940,1930,"Con",0,2100,TRUE,FALSE,TRUE,39.17,"young",35,180,88,"m"
21,"LEG CURL",1,"Con02",1020,1040,1300,1550,1030,1425,0.383,-395,1227.5,"Con",-20,-250,TRUE,FALSE,TRUE,27.72,"young",35,180,88,"m"
21,"LEG CURL",1,"Con03",1580,1600,1100,950,1590,1025,0.355,565,1307.5,"Con",-20,150,TRUE,FALSE,FALSE,55.12,"young",35,180,88,"m"
21,"LEG CURL",1,"Con04",1120,1120,1050,1000,1120,1025,0.085,95,1072.5,"Con",0,50,FALSE,FALSE,FALSE,9.27,"young",35,180,88,"m"
21,"LEG CURL",1,"Con05",1120,1120,1100,1100,1120,1100,0.018,20,1110,"Con",0,0,FALSE,FALSE,FALSE,1.82,"young",35,180,88,"m"
21,"LEG CURL",1,"Con06",1080,1080,1200,1200,1080,1200,0.111,-120,1140,"Con",0,0,FALSE,FALSE,FALSE,10,"young",35,180,88,"m"
21,"LEG CURL",1,"Con07",1060,1060,1250,1250,1060,1250,0.179,-190,1155,"Con",0,0,FALSE,FALSE,FALSE,15.2,"young",35,180,88,"m"
21,"LEG CURL",1,"Con08",1100,1100,1650,1750,1100,1700,0.545,-600,1400,"Con",0,-100,TRUE,FALSE,FALSE,35.29,"young",35,180,88,"m"
21,"LEG CURL",1,"Con09",1000,1020,1550,1650,1010,1600,0.584,-590,1305,"Con",-20,-100,TRUE,FALSE,FALSE,36.88,"young",35,180,88,"m"
21,"LEG CURL",1,"Con10",1280,1280,1900,2000,1280,1950,0.523,-670,1615,"Con",0,-100,TRUE,FALSE,FALSE,34.36,"young",35,180,88,"m"
21,"LEG CURL",2,"Con01",1300,1300,1350,1400,1300,1375,0.058,-75,1337.5,"Con",0,-50,FALSE,FALSE,FALSE,5.45,"young",35,180,88,"m"
21,"LEG CURL",2,"Con02",1020,1020,1150,1150,1020,1150,0.127,-130,1085,"Con",0,0,FALSE,FALSE,FALSE,11.3,"young",35,180,88,"m"
21,"LEG CURL",2,"Con03",1060,1060,1150,1150,1060,1150,0.085,-90,1105,"Con",0,0,FALSE,FALSE,FALSE,7.83,"young",35,180,88,"m"
21,"LEG CURL",2,"Con04",1080,1080,1150,1150,1080,1150,0.065,-70,1115,"Con",0,0,FALSE,FALSE,FALSE,6.09,"young",35,180,88,"m"
21,"LEG CURL",2,"Con05",1040,1060,1150,1050,1050,1100,0.048,-50,1075,"Con",-20,100,FALSE,FALSE,FALSE,4.55,"young",35,180,88,"m"
21,"LEG CURL",2,"Con06",1160,1120,1250,1250,1140,1250,0.096,-110,1195,"Con",40,0,FALSE,FALSE,FALSE,8.8,"young",35,180,88,"m"
21,"LEG CURL",2,"Con07",1080,1060,1150,1150,1070,1150,0.075,-80,1110,"Con",20,0,FALSE,FALSE,FALSE,6.96,"young",35,180,88,"m"
21,"LEG CURL",2,"Con08",980,980,1150,1100,980,1125,0.148,-145,1052.5,"Con",0,50,FALSE,FALSE,FALSE,12.89,"young",35,180,88,"m"
21,"LEG CURL",2,"Con09",1180,1180,1350,1400,1180,1375,0.165,-195,1277.5,"Con",0,-50,FALSE,FALSE,FALSE,14.18,"young",35,180,88,"m"
21,"LEG CURL",2,"Con10",1080,1120,1350,1650,1100,1500,0.364,-400,1300,"Con",-40,-300,TRUE,FALSE,TRUE,26.67,"young",35,180,88,"m"
21,"LEG CURL",1,"Ecc01",1700,1680,1450,1100,1690,1275,0.246,415,1482.5,"Ecc",20,350,TRUE,FALSE,TRUE,32.55,"young",35,180,88,"m"
21,"LEG CURL",1,"Ecc02",2060,2040,2200,2300,2050,2250,0.098,-200,2150,"Ecc",20,-100,FALSE,FALSE,FALSE,8.89,"young",35,180,88,"m"
21,"LEG CURL",1,"Ecc03",2120,2120,2450,2550,2120,2500,0.179,-380,2310,"Ecc",0,-100,TRUE,FALSE,FALSE,15.2,"young",35,180,88,"m"
21,"LEG CURL",1,"Ecc04",2280,2260,2300,2350,2270,2325,0.024,-55,2297.5,"Ecc",20,-50,FALSE,FALSE,FALSE,2.37,"young",35,180,88,"m"
21,"LEG CURL",1,"Ecc05",2240,2240,2200,2200,2240,2200,0.018,40,2220,"Ecc",0,0,FALSE,FALSE,FALSE,1.82,"young",35,180,88,"m"
21,"LEG CURL",1,"Ecc06",2220,2240,2050,2050,2230,2050,0.081,180,2140,"Ecc",-20,0,FALSE,FALSE,FALSE,8.78,"young",35,180,88,"m"
21,"LEG CURL",1,"Ecc07",2240,2240,1700,1600,2240,1650,0.263,590,1945,"Ecc",0,100,TRUE,FALSE,FALSE,35.76,"young",35,180,88,"m"
21,"LEG CURL",1,"Ecc08",1980,1960,1450,1350,1970,1400,0.289,570,1685,"Ecc",20,100,TRUE,FALSE,FALSE,40.71,"young",35,180,88,"m"
21,"LEG CURL",1,"Ecc09",2100,2080,1500,1400,2090,1450,0.306,640,1770,"Ecc",20,100,TRUE,FALSE,FALSE,44.14,"young",35,180,88,"m"
21,"LEG CURL",1,"Ecc10",2060,2080,1950,1950,2070,1950,0.058,120,2010,"Ecc",-20,0,FALSE,FALSE,FALSE,6.15,"young",35,180,88,"m"
21,"LEG CURL",2,"Ecc01",2080,2080,1950,1900,2080,1925,0.075,155,2002.5,"Ecc",0,50,FALSE,FALSE,FALSE,8.05,"young",35,180,88,"m"
21,"LEG CURL",2,"Ecc02",2040,2040,1900,1950,2040,1925,0.056,115,1982.5,"Ecc",0,-50,FALSE,FALSE,FALSE,5.97,"young",35,180,88,"m"
21,"LEG CURL",2,"Ecc03",2060,2060,2000,2000,2060,2000,0.029,60,2030,"Ecc",0,0,FALSE,FALSE,FALSE,3,"young",35,180,88,"m"
21,"LEG CURL",2,"Ecc04",2060,2040,2000,2050,2050,2025,0.012,25,2037.5,"Ecc",20,-50,FALSE,FALSE,FALSE,1.23,"young",35,180,88,"m"
21,"LEG CURL",2,"Ecc05",1920,1960,1800,1850,1940,1825,0.059,115,1882.5,"Ecc",-40,-50,FALSE,FALSE,FALSE,6.3,"young",35,180,88,"m"
21,"LEG CURL",2,"Ecc06",2280,2300,2200,2200,2290,2200,0.039,90,2245,"Ecc",-20,0,FALSE,FALSE,FALSE,4.09,"young",35,180,88,"m"
21,"LEG CURL",2,"Ecc07",2240,2240,2050,2100,2240,2075,0.074,165,2157.5,"Ecc",0,-50,FALSE,FALSE,FALSE,7.95,"young",35,180,88,"m"
21,"LEG CURL",2,"Ecc08",2020,2020,1900,1850,2020,1875,0.072,145,1947.5,"Ecc",0,50,FALSE,FALSE,FALSE,7.73,"young",35,180,88,"m"
21,"LEG CURL",2,"Ecc09",2140,2120,1900,1650,2130,1775,0.167,355,1952.5,"Ecc",20,250,TRUE,FALSE,TRUE,20,"young",35,180,88,"m"
21,"LEG CURL",2,"Ecc10",2560,2520,2500,2450,2540,2475,0.026,65,2507.5,"Ecc",40,50,FALSE,FALSE,FALSE,2.63,"young",35,180,88,"m"
21,"LEG CURL",1,"Rep01",3160,3140,4900,2450,3150,3675,0.167,-525,3412.5,"Rep",20,2450,TRUE,FALSE,TRUE,14.29,"young",35,180,88,"m"
21,"LEG CURL",1,"Rep02",3080,3080,3500,3850,3080,3675,0.193,-595,3377.5,"Rep",0,-350,TRUE,FALSE,TRUE,16.19,"young",35,180,88,"m"
21,"LEG CURL",1,"Rep03",3700,3720,3550,3500,3710,3525,0.05,185,3617.5,"Rep",-20,50,TRUE,FALSE,FALSE,5.25,"young",35,180,88,"m"
21,"LEG CURL",1,"Rep04",3400,3380,3350,3350,3390,3350,0.012,40,3370,"Rep",20,0,FALSE,FALSE,FALSE,1.19,"young",35,180,88,"m"
21,"LEG CURL",1,"Rep05",3360,3360,3300,3300,3360,3300,0.018,60,3330,"Rep",0,0,FALSE,FALSE,FALSE,1.82,"young",35,180,88,"m"
21,"LEG CURL",1,"Rep06",3300,3320,3250,3250,3310,3250,0.018,60,3280,"Rep",-20,0,FALSE,FALSE,FALSE,1.85,"young",35,180,88,"m"
21,"LEG CURL",1,"Rep07",3300,3300,2950,2850,3300,2900,0.121,400,3100,"Rep",0,100,TRUE,FALSE,FALSE,13.79,"young",35,180,88,"m"
21,"LEG CURL",1,"Rep08",3080,3060,3100,3100,3070,3100,0.01,-30,3085,"Rep",20,0,FALSE,FALSE,FALSE,0.97,"young",35,180,88,"m"
21,"LEG CURL",1,"Rep09",3100,3100,3050,3050,3100,3050,0.016,50,3075,"Rep",0,0,FALSE,FALSE,FALSE,1.64,"young",35,180,88,"m"
21,"LEG CURL",1,"Rep10",3340,3360,3850,3950,3350,3900,0.164,-550,3625,"Rep",-20,-100,TRUE,FALSE,FALSE,14.1,"young",35,180,88,"m"
21,"LEG CURL",2,"Rep01",3380,3380,3300,3300,3380,3300,0.024,80,3340,"Rep",0,0,FALSE,FALSE,FALSE,2.42,"young",35,180,88,"m"
21,"LEG CURL",2,"Rep02",3060,3060,3050,3100,3060,3075,0.005,-15,3067.5,"Rep",0,-50,FALSE,FALSE,FALSE,0.49,"young",35,180,88,"m"
21,"LEG CURL",2,"Rep03",3120,3120,3150,3150,3120,3150,0.01,-30,3135,"Rep",0,0,FALSE,FALSE,FALSE,0.95,"young",35,180,88,"m"
21,"LEG CURL",2,"Rep04",3140,3120,3150,3200,3130,3175,0.014,-45,3152.5,"Rep",20,-50,FALSE,FALSE,FALSE,1.42,"young",35,180,88,"m"
21,"LEG CURL",2,"Rep05",2960,3020,2950,2900,2990,2925,0.022,65,2957.5,"Rep",-60,50,FALSE,FALSE,FALSE,2.22,"young",35,180,88,"m"
21,"LEG CURL",2,"Rep06",3440,3420,3450,3450,3430,3450,0.006,-20,3440,"Rep",20,0,FALSE,FALSE,FALSE,0.58,"young",35,180,88,"m"
21,"LEG CURL",2,"Rep07",3320,3300,3200,3250,3310,3225,0.026,85,3267.5,"Rep",20,-50,FALSE,FALSE,FALSE,2.64,"young",35,180,88,"m"
21,"LEG CURL",2,"Rep08",3000,3000,3050,2950,3000,3000,0,0,3000,"Rep",0,100,FALSE,FALSE,FALSE,0,"young",35,180,88,"m"
21,"LEG CURL",2,"Rep09",3320,3300,3250,3050,3310,3150,0.048,160,3230,"Rep",20,200,TRUE,FALSE,TRUE,5.08,"young",35,180,88,"m"
21,"LEG CURL",2,"Rep10",3640,3640,3850,4100,3640,3975,0.092,-335,3807.5,"Rep",0,-250,TRUE,FALSE,TRUE,8.43,"young",35,180,88,"m"
21,"LEG CURL",1,"TuT",32820,32820,34800,32650,32820,33725,0.028,-905,33272.5,"TuT",0,2150,TRUE,FALSE,TRUE,2.68,"young",35,180,88,"m"
21,"LEG CURL",2,"TuT",32380,32360,32400,32450,32370,32425,0.002,-55,32397.5,"TuT",20,-50,FALSE,FALSE,FALSE,0.17,"young",35,180,88,"m"
21,"ABDUCTOR",1,"Con01",760,780,850,1750,770,1300,0.688,-530,1035,"Con",-20,-900,TRUE,FALSE,TRUE,40.77,"young",35,180,88,"m"
21,"ABDUCTOR",1,"Con02",760,740,950,900,750,925,0.233,-175,837.5,"Con",20,50,FALSE,FALSE,FALSE,18.92,"young",35,180,88,"m"
21,"ABDUCTOR",1,"Con03",780,760,1000,800,770,900,0.169,-130,835,"Con",20,200,FALSE,FALSE,FALSE,14.44,"young",35,180,88,"m"
21,"ABDUCTOR",1,"Con04",680,680,900,750,680,825,0.213,-145,752.5,"Con",0,150,FALSE,FALSE,FALSE,17.58,"young",35,180,88,"m"
21,"ABDUCTOR",1,"Con05",660,640,850,750,650,800,0.231,-150,725,"Con",20,100,FALSE,FALSE,FALSE,18.75,"young",35,180,88,"m"
21,"ABDUCTOR",1,"Con06",700,720,900,850,710,875,0.232,-165,792.5,"Con",-20,50,FALSE,FALSE,FALSE,18.86,"young",35,180,88,"m"
21,"ABDUCTOR",1,"Con07",680,700,800,850,690,825,0.196,-135,757.5,"Con",-20,-50,FALSE,FALSE,FALSE,16.36,"young",35,180,88,"m"
21,"ABDUCTOR",1,"Con08",680,680,750,900,680,825,0.213,-145,752.5,"Con",0,-150,FALSE,FALSE,FALSE,17.58,"young",35,180,88,"m"
21,"ABDUCTOR",1,"Con09",740,720,800,1050,730,925,0.267,-195,827.5,"Con",20,-250,FALSE,FALSE,TRUE,21.08,"young",35,180,88,"m"
21,"ABDUCTOR",1,"Con10",720,740,850,1150,730,1000,0.37,-270,865,"Con",-20,-300,FALSE,FALSE,TRUE,27,"young",35,180,88,"m"
21,"ABDUCTOR",2,"Con01",740,720,800,900,730,850,0.164,-120,790,"Con",20,-100,FALSE,FALSE,FALSE,14.12,"young",35,180,88,"m"
21,"ABDUCTOR",2,"Con02",700,680,600,750,690,675,0.022,15,682.5,"Con",20,-150,FALSE,FALSE,FALSE,2.22,"young",35,180,88,"m"
21,"ABDUCTOR",2,"Con03",660,680,800,700,670,750,0.119,-80,710,"Con",-20,100,FALSE,FALSE,FALSE,10.67,"young",35,180,88,"m"
21,"ABDUCTOR",2,"Con04",640,660,900,850,650,875,0.346,-225,762.5,"Con",-20,50,FALSE,FALSE,FALSE,25.71,"young",35,180,88,"m"
21,"ABDUCTOR",2,"Con05",680,680,900,900,680,900,0.324,-220,790,"Con",0,0,FALSE,FALSE,FALSE,24.44,"young",35,180,88,"m"
21,"ABDUCTOR",2,"Con06",660,700,800,800,680,800,0.176,-120,740,"Con",-40,0,FALSE,TRUE,FALSE,15,"young",35,180,88,"m"
21,"ABDUCTOR",2,"Con07",660,680,750,850,670,800,0.194,-130,735,"Con",-20,-100,FALSE,FALSE,FALSE,16.25,"young",35,180,88,"m"
21,"ABDUCTOR",2,"Con08",640,640,750,950,640,850,0.328,-210,745,"Con",0,-200,FALSE,FALSE,FALSE,24.71,"young",35,180,88,"m"
21,"ABDUCTOR",2,"Con09",660,660,800,900,660,850,0.288,-190,755,"Con",0,-100,FALSE,FALSE,FALSE,22.35,"young",35,180,88,"m"
21,"ABDUCTOR",2,"Con10",680,660,950,900,670,925,0.381,-255,797.5,"Con",20,50,FALSE,FALSE,FALSE,27.57,"young",35,180,88,"m"
21,"ABDUCTOR",1,"Ecc01",1780,1800,1750,1600,1790,1675,0.064,115,1732.5,"Ecc",-20,150,FALSE,FALSE,FALSE,6.87,"young",35,180,88,"m"
21,"ABDUCTOR",1,"Ecc02",1940,1980,1650,1850,1960,1750,0.107,210,1855,"Ecc",-40,-200,FALSE,TRUE,FALSE,12,"young",35,180,88,"m"
21,"ABDUCTOR",1,"Ecc03",1900,1880,1650,1850,1890,1750,0.074,140,1820,"Ecc",20,-200,FALSE,FALSE,FALSE,8,"young",35,180,88,"m"
21,"ABDUCTOR",1,"Ecc04",1760,1760,1550,1650,1760,1600,0.091,160,1680,"Ecc",0,-100,FALSE,FALSE,FALSE,10,"young",35,180,88,"m"
21,"ABDUCTOR",1,"Ecc05",1760,1760,1550,1650,1760,1600,0.091,160,1680,"Ecc",0,-100,FALSE,FALSE,FALSE,10,"young",35,180,88,"m"
21,"ABDUCTOR",1,"Ecc06",1700,1660,1550,1550,1680,1550,0.077,130,1615,"Ecc",40,0,FALSE,TRUE,FALSE,8.39,"young",35,180,88,"m"
21,"ABDUCTOR",1,"Ecc07",1720,1740,1650,1500,1730,1575,0.09,155,1652.5,"Ecc",-20,150,FALSE,FALSE,FALSE,9.84,"young",35,180,88,"m"
21,"ABDUCTOR",1,"Ecc08",1680,1700,1650,1400,1690,1525,0.098,165,1607.5,"Ecc",-20,250,FALSE,FALSE,FALSE,10.82,"young",35,180,88,"m"
21,"ABDUCTOR",1,"Ecc09",1720,1700,1600,1300,1710,1450,0.152,260,1580,"Ecc",20,300,FALSE,FALSE,FALSE,17.93,"young",35,180,88,"m"
21,"ABDUCTOR",1,"Ecc10",1500,1500,1550,1450,1500,1500,0,0,1500,"Ecc",0,100,FALSE,FALSE,FALSE,0,"young",35,180,88,"m"
21,"ABDUCTOR",2,"Ecc01",1820,1820,1850,1700,1820,1775,0.025,45,1797.5,"Ecc",0,150,FALSE,FALSE,FALSE,2.54,"young",35,180,88,"m"
21,"ABDUCTOR",2,"Ecc02",1740,1720,1700,1750,1730,1725,0.003,5,1727.5,"Ecc",20,-50,FALSE,FALSE,FALSE,0.29,"young",35,180,88,"m"
21,"ABDUCTOR",2,"Ecc03",1580,1560,1350,1400,1570,1375,0.124,195,1472.5,"Ecc",20,-50,FALSE,FALSE,FALSE,14.18,"young",35,180,88,"m"
21,"ABDUCTOR",2,"Ecc04",1540,1540,1300,1300,1540,1300,0.156,240,1420,"Ecc",0,0,FALSE,FALSE,FALSE,18.46,"young",35,180,88,"m"
21,"ABDUCTOR",2,"Ecc05",1420,1380,1200,1250,1400,1225,0.125,175,1312.5,"Ecc",40,-50,FALSE,TRUE,FALSE,14.29,"young",35,180,88,"m"
21,"ABDUCTOR",2,"Ecc06",1460,1440,1400,1300,1450,1350,0.069,100,1400,"Ecc",20,100,FALSE,FALSE,FALSE,7.41,"young",35,180,88,"m"
21,"ABDUCTOR",2,"Ecc07",1380,1360,1250,1050,1370,1150,0.161,220,1260,"Ecc",20,200,FALSE,FALSE,FALSE,19.13,"young",35,180,88,"m"
21,"ABDUCTOR",2,"Ecc08",1460,1480,1350,1250,1470,1300,0.116,170,1385,"Ecc",-20,100,FALSE,FALSE,FALSE,13.08,"young",35,180,88,"m"
21,"ABDUCTOR",2,"Ecc09",1420,1440,1300,1200,1430,1250,0.126,180,1340,"Ecc",-20,100,FALSE,FALSE,FALSE,14.4,"young",35,180,88,"m"
21,"ABDUCTOR",2,"Ecc10",1800,1800,1650,1750,1800,1700,0.056,100,1750,"Ecc",0,-100,FALSE,FALSE,FALSE,5.88,"young",35,180,88,"m"
21,"ABDUCTOR",1,"Rep01",2540,2580,2600,3350,2560,2975,0.162,-415,2767.5,"Rep",-40,-750,TRUE,FALSE,TRUE,13.95,"young",35,180,88,"m"
21,"ABDUCTOR",1,"Rep02",2700,2720,2600,2750,2710,2675,0.013,35,2692.5,"Rep",-20,-150,FALSE,FALSE,FALSE,1.31,"young",35,180,88,"m"
21,"ABDUCTOR",1,"Rep03",2680,2640,2650,2650,2660,2650,0.004,10,2655,"Rep",40,0,FALSE,FALSE,FALSE,0.38,"young",35,180,88,"m"
21,"ABDUCTOR",1,"Rep04",2440,2440,2450,2400,2440,2425,0.006,15,2432.5,"Rep",0,50,FALSE,FALSE,FALSE,0.62,"young",35,180,88,"m"
21,"ABDUCTOR",1,"Rep05",2420,2400,2400,2400,2410,2400,0.004,10,2405,"Rep",20,0,FALSE,FALSE,FALSE,0.42,"young",35,180,88,"m"
21,"ABDUCTOR",1,"Rep06",2400,2380,2450,2400,2390,2425,0.015,-35,2407.5,"Rep",20,50,FALSE,FALSE,FALSE,1.44,"young",35,180,88,"m"
21,"ABDUCTOR",1,"Rep07",2400,2440,2450,2350,2420,2400,0.008,20,2410,"Rep",-40,100,FALSE,FALSE,FALSE,0.83,"young",35,180,88,"m"
21,"ABDUCTOR",1,"Rep08",2360,2380,2400,2300,2370,2350,0.008,20,2360,"Rep",-20,100,FALSE,FALSE,FALSE,0.85,"young",35,180,88,"m"
21,"ABDUCTOR",1,"Rep09",2460,2420,2400,2350,2440,2375,0.027,65,2407.5,"Rep",40,50,FALSE,FALSE,FALSE,2.74,"young",35,180,88,"m"
21,"ABDUCTOR",1,"Rep10",2220,2240,2400,2600,2230,2500,0.121,-270,2365,"Rep",-20,-200,FALSE,FALSE,FALSE,10.8,"young",35,180,88,"m"
21,"ABDUCTOR",2,"Rep01",2560,2540,2650,2600,2550,2625,0.029,-75,2587.5,"Rep",20,50,FALSE,FALSE,FALSE,2.86,"young",35,180,88,"m"
21,"ABDUCTOR",2,"Rep02",2440,2400,2300,2500,2420,2400,0.008,20,2410,"Rep",40,-200,FALSE,FALSE,FALSE,0.83,"young",35,180,88,"m"
21,"ABDUCTOR",2,"Rep03",2240,2240,2150,2100,2240,2125,0.051,115,2182.5,"Rep",0,50,FALSE,FALSE,FALSE,5.41,"young",35,180,88,"m"
21,"ABDUCTOR",2,"Rep04",2180,2200,2200,2150,2190,2175,0.007,15,2182.5,"Rep",-20,50,FALSE,FALSE,FALSE,0.69,"young",35,180,88,"m"
21,"ABDUCTOR",2,"Rep05",2100,2060,2100,2150,2080,2125,0.022,-45,2102.5,"Rep",40,-50,FALSE,FALSE,FALSE,2.12,"young",35,180,88,"m"
21,"ABDUCTOR",2,"Rep06",2120,2140,2200,2100,2130,2150,0.009,-20,2140,"Rep",-20,100,FALSE,FALSE,FALSE,0.93,"young",35,180,88,"m"
21,"ABDUCTOR",2,"Rep07",2040,2040,2000,1900,2040,1950,0.044,90,1995,"Rep",0,100,FALSE,FALSE,FALSE,4.62,"young",35,180,88,"m"
21,"ABDUCTOR",2,"Rep08",2100,2120,2100,2200,2110,2150,0.019,-40,2130,"Rep",-20,-100,FALSE,FALSE,FALSE,1.86,"young",35,180,88,"m"
21,"ABDUCTOR",2,"Rep09",2080,2100,2100,2100,2090,2100,0.005,-10,2095,"Rep",-20,0,FALSE,FALSE,FALSE,0.48,"young",35,180,88,"m"
21,"ABDUCTOR",2,"Rep10",2480,2460,2600,2650,2470,2625,0.063,-155,2547.5,"Rep",20,-50,FALSE,FALSE,FALSE,5.9,"young",35,180,88,"m"
21,"ABDUCTOR",1,"TuT",24620,24640,24800,25550,24630,25175,0.022,-545,24902.5,"TuT",-20,-750,TRUE,FALSE,TRUE,2.16,"young",35,180,88,"m"
21,"ABDUCTOR",2,"TuT",22340,22300,22400,22450,22320,22425,0.005,-105,22372.5,"TuT",40,-50,FALSE,TRUE,FALSE,0.47,"young",35,180,88,"m"
21,"ADDUCTOR",1,"Con01",780,800,1000,900,790,950,0.203,-160,870,"Con",-20,100,FALSE,FALSE,FALSE,16.84,"young",35,180,88,"m"
21,"ADDUCTOR",1,"Con02",740,760,950,1150,750,1050,0.4,-300,900,"Con",-20,-200,FALSE,FALSE,FALSE,28.57,"young",35,180,88,"m"
21,"ADDUCTOR",1,"Con03",840,840,1000,1050,840,1025,0.22,-185,932.5,"Con",0,-50,FALSE,FALSE,FALSE,18.05,"young",35,180,88,"m"
21,"ADDUCTOR",1,"Con04",820,840,1000,1050,830,1025,0.235,-195,927.5,"Con",-20,-50,FALSE,FALSE,FALSE,19.02,"young",35,180,88,"m"
21,"ADDUCTOR",1,"Con05",840,840,1250,1150,840,1200,0.429,-360,1020,"Con",0,100,FALSE,FALSE,FALSE,30,"young",35,180,88,"m"
21,"ADDUCTOR",1,"Con06",1040,1020,1650,1700,1030,1675,0.626,-645,1352.5,"Con",20,-50,TRUE,FALSE,FALSE,38.51,"young",35,180,88,"m"
21,"ADDUCTOR",1,"Con07",860,920,1300,1250,890,1275,0.433,-385,1082.5,"Con",-60,50,FALSE,TRUE,FALSE,30.2,"young",35,180,88,"m"
21,"ADDUCTOR",1,"Con08",960,940,1200,1050,950,1125,0.184,-175,1037.5,"Con",20,150,FALSE,FALSE,FALSE,15.56,"young",35,180,88,"m"
21,"ADDUCTOR",1,"Con09",860,860,1050,950,860,1000,0.163,-140,930,"Con",0,100,FALSE,FALSE,FALSE,14,"young",35,180,88,"m"
21,"ADDUCTOR",1,"Con10",1020,1040,1200,1150,1030,1175,0.141,-145,1102.5,"Con",-20,50,FALSE,FALSE,FALSE,12.34,"young",35,180,88,"m"
21,"ADDUCTOR",2,"Con01",940,940,900,1000,940,950,0.011,-10,945,"Con",0,-100,FALSE,FALSE,FALSE,1.05,"young",35,180,88,"m"
21,"ADDUCTOR",2,"Con02",920,940,1500,1400,930,1450,0.559,-520,1190,"Con",-20,100,FALSE,FALSE,FALSE,35.86,"young",35,180,88,"m"
21,"ADDUCTOR",2,"Con03",840,880,1350,1500,860,1425,0.657,-565,1142.5,"Con",-40,-150,FALSE,TRUE,FALSE,39.65,"young",35,180,88,"m"
21,"ADDUCTOR",2,"Con04",840,860,1000,1150,850,1075,0.265,-225,962.5,"Con",-20,-150,FALSE,FALSE,FALSE,20.93,"young",35,180,88,"m"
21,"ADDUCTOR",2,"Con05",800,840,1000,950,820,975,0.189,-155,897.5,"Con",-40,50,FALSE,TRUE,FALSE,15.9,"young",35,180,88,"m"
21,"ADDUCTOR",2,"Con06",760,800,850,850,780,850,0.09,-70,815,"Con",-40,0,FALSE,TRUE,FALSE,8.24,"young",35,180,88,"m"
21,"ADDUCTOR",2,"Con07",900,920,950,950,910,950,0.044,-40,930,"Con",-20,0,FALSE,FALSE,FALSE,4.21,"young",35,180,88,"m"
21,"ADDUCTOR",2,"Con08",920,880,1100,1100,900,1100,0.222,-200,1000,"Con",40,0,FALSE,TRUE,FALSE,18.18,"young",35,180,88,"m"
21,"ADDUCTOR",2,"Con09",880,920,1250,1150,900,1200,0.333,-300,1050,"Con",-40,100,FALSE,TRUE,FALSE,25,"young",35,180,88,"m"
21,"ADDUCTOR",2,"Con10",940,940,1200,1650,940,1425,0.516,-485,1182.5,"Con",0,-450,FALSE,FALSE,TRUE,34.04,"young",35,180,88,"m"
21,"ADDUCTOR",1,"Ecc01",1940,1920,1650,1800,1930,1725,0.106,205,1827.5,"Ecc",20,-150,FALSE,FALSE,FALSE,11.88,"young",35,180,88,"m"
21,"ADDUCTOR",1,"Ecc02",1680,1680,1450,1150,1680,1300,0.226,380,1490,"Ecc",0,300,FALSE,FALSE,FALSE,29.23,"young",35,180,88,"m"
21,"ADDUCTOR",1,"Ecc03",1780,1780,1700,1650,1780,1675,0.059,105,1727.5,"Ecc",0,50,FALSE,FALSE,FALSE,6.27,"young",35,180,88,"m"
21,"ADDUCTOR",1,"Ecc04",2000,1980,1700,1750,1990,1725,0.133,265,1857.5,"Ecc",20,-50,FALSE,FALSE,FALSE,15.36,"young",35,180,88,"m"
21,"ADDUCTOR",1,"Ecc05",2240,2240,1350,1500,2240,1425,0.364,815,1832.5,"Ecc",0,-150,TRUE,FALSE,FALSE,57.19,"young",35,180,88,"m"
21,"ADDUCTOR",1,"Ecc06",2500,2460,2400,2100,2480,2250,0.093,230,2365,"Ecc",40,300,FALSE,TRUE,FALSE,10.22,"young",35,180,88,"m"
21,"ADDUCTOR",1,"Ecc07",2600,2580,2150,2350,2590,2250,0.131,340,2420,"Ecc",20,-200,FALSE,FALSE,FALSE,15.11,"young",35,180,88,"m"
21,"ADDUCTOR",1,"Ecc08",2580,2620,2400,2600,2600,2500,0.038,100,2550,"Ecc",-40,-200,FALSE,TRUE,FALSE,4,"young",35,180,88,"m"
21,"ADDUCTOR",1,"Ecc09",2360,2340,2200,2200,2350,2200,0.064,150,2275,"Ecc",20,0,FALSE,FALSE,FALSE,6.82,"young",35,180,88,"m"
21,"ADDUCTOR",1,"Ecc10",2120,2120,2050,2050,2120,2050,0.033,70,2085,"Ecc",0,0,FALSE,FALSE,FALSE,3.41,"young",35,180,88,"m"
21,"ADDUCTOR",2,"Ecc01",2080,2060,2050,1950,2070,2000,0.034,70,2035,"Ecc",20,100,FALSE,FALSE,FALSE,3.5,"young",35,180,88,"m"
21,"ADDUCTOR",2,"Ecc02",2040,2020,1200,1400,2030,1300,0.36,730,1665,"Ecc",20,-200,TRUE,FALSE,FALSE,56.15,"young",35,180,88,"m"
21,"ADDUCTOR",2,"Ecc03",2140,2100,1850,1500,2120,1675,0.21,445,1897.5,"Ecc",40,350,FALSE,TRUE,TRUE,26.57,"young",35,180,88,"m"
21,"ADDUCTOR",2,"Ecc04",2180,2160,1950,2000,2170,1975,0.09,195,2072.5,"Ecc",20,-50,FALSE,FALSE,FALSE,9.87,"young",35,180,88,"m"
21,"ADDUCTOR",2,"Ecc05",2000,1960,1900,1900,1980,1900,0.04,80,1940,"Ecc",40,0,FALSE,TRUE,FALSE,4.21,"young",35,180,88,"m"
21,"ADDUCTOR",2,"Ecc06",2200,2160,2150,2150,2180,2150,0.014,30,2165,"Ecc",40,0,FALSE,TRUE,FALSE,1.4,"young",35,180,88,"m"
21,"ADDUCTOR",2,"Ecc07",1900,1960,1800,1800,1930,1800,0.067,130,1865,"Ecc",-60,0,FALSE,TRUE,FALSE,7.22,"young",35,180,88,"m"
21,"ADDUCTOR",2,"Ecc08",1700,1660,1350,1450,1680,1400,0.167,280,1540,"Ecc",40,-100,FALSE,TRUE,FALSE,20,"young",35,180,88,"m"
21,"ADDUCTOR",2,"Ecc09",2020,2000,1700,1550,2010,1625,0.192,385,1817.5,"Ecc",20,150,FALSE,FALSE,FALSE,23.69,"young",35,180,88,"m"
21,"ADDUCTOR",2,"Ecc10",2080,2080,2050,1700,2080,1875,0.099,205,1977.5,"Ecc",0,350,FALSE,FALSE,TRUE,10.93,"young",35,180,88,"m"
21,"ADDUCTOR",1,"Rep01",2720,2720,2650,2700,2720,2675,0.017,45,2697.5,"Rep",0,-50,FALSE,FALSE,FALSE,1.68,"young",35,180,88,"m"
21,"ADDUCTOR",1,"Rep02",2420,2440,2400,2300,2430,2350,0.033,80,2390,"Rep",-20,100,FALSE,FALSE,FALSE,3.4,"young",35,180,88,"m"
21,"ADDUCTOR",1,"Rep03",2620,2620,2700,2700,2620,2700,0.031,-80,2660,"Rep",0,0,FALSE,FALSE,FALSE,2.96,"young",35,180,88,"m"
21,"ADDUCTOR",1,"Rep04",2820,2820,2700,2800,2820,2750,0.025,70,2785,"Rep",0,-100,FALSE,FALSE,FALSE,2.55,"young",35,180,88,"m"
21,"ADDUCTOR",1,"Rep05",3080,3080,2600,2650,3080,2625,0.148,455,2852.5,"Rep",0,-50,TRUE,FALSE,FALSE,17.33,"young",35,180,88,"m"
21,"ADDUCTOR",1,"Rep06",3540,3480,4050,3800,3510,3925,0.118,-415,3717.5,"Rep",60,250,TRUE,FALSE,TRUE,10.57,"young",35,180,88,"m"
21,"ADDUCTOR",1,"Rep07",3460,3500,3450,3600,3480,3525,0.013,-45,3502.5,"Rep",-40,-150,FALSE,FALSE,FALSE,1.28,"young",35,180,88,"m"
21,"ADDUCTOR",1,"Rep08",3540,3560,3600,3650,3550,3625,0.021,-75,3587.5,"Rep",-20,-50,FALSE,FALSE,FALSE,2.07,"young",35,180,88,"m"
21,"ADDUCTOR",1,"Rep09",3220,3200,3250,3150,3210,3200,0.003,10,3205,"Rep",20,100,FALSE,FALSE,FALSE,0.31,"young",35,180,88,"m"
21,"ADDUCTOR",1,"Rep10",3140,3160,3250,3200,3150,3225,0.024,-75,3187.5,"Rep",-20,50,FALSE,FALSE,FALSE,2.33,"young",35,180,88,"m"
21,"ADDUCTOR",2,"Rep01",3020,3000,2950,2950,3010,2950,0.02,60,2980,"Rep",20,0,FALSE,FALSE,FALSE,2.03,"young",35,180,88,"m"
21,"ADDUCTOR",2,"Rep02",2960,2960,2700,2800,2960,2750,0.071,210,2855,"Rep",0,-100,FALSE,FALSE,FALSE,7.64,"young",35,180,88,"m"
21,"ADDUCTOR",2,"Rep03",2980,2980,3200,3000,2980,3100,0.04,-120,3040,"Rep",0,200,FALSE,FALSE,FALSE,3.87,"young",35,180,88,"m"
21,"ADDUCTOR",2,"Rep04",3020,3020,2950,3150,3020,3050,0.01,-30,3035,"Rep",0,-200,FALSE,FALSE,FALSE,0.98,"young",35,180,88,"m"
21,"ADDUCTOR",2,"Rep05",2800,2800,2900,2850,2800,2875,0.027,-75,2837.5,"Rep",0,50,FALSE,FALSE,FALSE,2.61,"young",35,180,88,"m"
21,"ADDUCTOR",2,"Rep06",2960,2960,3000,3000,2960,3000,0.014,-40,2980,"Rep",0,0,FALSE,FALSE,FALSE,1.33,"young",35,180,88,"m"
21,"ADDUCTOR",2,"Rep07",2800,2880,2750,2750,2840,2750,0.032,90,2795,"Rep",-80,0,FALSE,TRUE,FALSE,3.27,"young",35,180,88,"m"
21,"ADDUCTOR",2,"Rep08",2620,2540,2450,2550,2580,2500,0.031,80,2540,"Rep",80,-100,FALSE,TRUE,FALSE,3.2,"young",35,180,88,"m"
21,"ADDUCTOR",2,"Rep09",2900,2920,2950,2700,2910,2825,0.029,85,2867.5,"Rep",-20,250,FALSE,FALSE,TRUE,3.01,"young",35,180,88,"m"
21,"ADDUCTOR",2,"Rep10",3020,3020,3250,3350,3020,3300,0.093,-280,3160,"Rep",0,-100,FALSE,FALSE,FALSE,8.48,"young",35,180,88,"m"
21,"ADDUCTOR",1,"TuT",30560,30580,30650,30550,30570,30600,0.001,-30,30585,"TuT",-20,100,FALSE,FALSE,FALSE,0.1,"young",35,180,88,"m"
21,"ADDUCTOR",2,"TuT",29080,29080,29100,29100,29080,29100,0.001,-20,29090,"TuT",0,0,FALSE,FALSE,FALSE,0.07,"young",35,180,88,"m"
21,"LOWER BACK",1,"Con01",1100,1100,1250,1250,1100,1250,0.136,-150,1175,"Con",0,0,FALSE,FALSE,FALSE,12,"young",35,180,88,"m"
21,"LOWER BACK",1,"Con02",1220,1220,1250,1300,1220,1275,0.045,-55,1247.5,"Con",0,-50,FALSE,FALSE,FALSE,4.31,"young",35,180,88,"m"
21,"LOWER BACK",1,"Con03",1140,1140,1200,1200,1140,1200,0.053,-60,1170,"Con",0,0,FALSE,FALSE,FALSE,5,"young",35,180,88,"m"
21,"LOWER BACK",1,"Con04",1200,1200,1250,1250,1200,1250,0.042,-50,1225,"Con",0,0,FALSE,FALSE,FALSE,4,"young",35,180,88,"m"
21,"LOWER BACK",1,"Con05",1160,1160,1250,1200,1160,1225,0.056,-65,1192.5,"Con",0,50,FALSE,FALSE,FALSE,5.31,"young",35,180,88,"m"
21,"LOWER BACK",1,"Con06",1300,1300,1400,1350,1300,1375,0.058,-75,1337.5,"Con",0,50,FALSE,FALSE,FALSE,5.45,"young",35,180,88,"m"
21,"LOWER BACK",1,"Con07",1340,1340,1450,1450,1340,1450,0.082,-110,1395,"Con",0,0,FALSE,FALSE,FALSE,7.59,"young",35,180,88,"m"
21,"LOWER BACK",1,"Con08",1360,1380,1500,1550,1370,1525,0.113,-155,1447.5,"Con",-20,-50,FALSE,FALSE,FALSE,10.16,"young",35,180,88,"m"
21,"LOWER BACK",1,"Con09",1360,1340,1500,1600,1350,1550,0.148,-200,1450,"Con",20,-100,TRUE,FALSE,FALSE,12.9,"young",35,180,88,"m"
21,"LOWER BACK",1,"Con10",1560,1580,1750,1800,1570,1775,0.131,-205,1672.5,"Con",-20,-50,TRUE,FALSE,FALSE,11.55,"young",35,180,88,"m"
21,"LOWER BACK",2,"Con01",1280,1280,1500,1400,1280,1450,0.133,-170,1365,"Con",0,100,FALSE,FALSE,FALSE,11.72,"young",35,180,88,"m"
21,"LOWER BACK",2,"Con02",1280,1260,1300,1350,1270,1325,0.043,-55,1297.5,"Con",20,-50,FALSE,FALSE,FALSE,4.15,"young",35,180,88,"m"
21,"LOWER BACK",2,"Con03",1220,1260,1300,1300,1240,1300,0.048,-60,1270,"Con",-40,0,FALSE,TRUE,FALSE,4.62,"young",35,180,88,"m"
21,"LOWER BACK",2,"Con04",1340,1360,1350,1400,1350,1375,0.019,-25,1362.5,"Con",-20,-50,FALSE,FALSE,FALSE,1.82,"young",35,180,88,"m"
21,"LOWER BACK",2,"Con05",1320,1320,1400,1350,1320,1375,0.042,-55,1347.5,"Con",0,50,FALSE,FALSE,FALSE,4,"young",35,180,88,"m"
21,"LOWER BACK",2,"Con06",1380,1380,1500,1450,1380,1475,0.069,-95,1427.5,"Con",0,50,FALSE,FALSE,FALSE,6.44,"young",35,180,88,"m"
21,"LOWER BACK",2,"Con07",1400,1380,1450,1450,1390,1450,0.043,-60,1420,"Con",20,0,FALSE,FALSE,FALSE,4.14,"young",35,180,88,"m"
21,"LOWER BACK",2,"Con08",1380,1400,1550,1550,1390,1550,0.115,-160,1470,"Con",-20,0,FALSE,FALSE,FALSE,10.32,"young",35,180,88,"m"
21,"LOWER BACK",2,"Con09",1220,1240,1450,1450,1230,1450,0.179,-220,1340,"Con",-20,0,TRUE,FALSE,FALSE,15.17,"young",35,180,88,"m"
21,"LOWER BACK",2,"Con10",1180,1220,1500,1500,1200,1500,0.25,-300,1350,"Con",-40,0,TRUE,TRUE,FALSE,20,"young",35,180,88,"m"
21,"LOWER BACK",1,"Ecc01",1780,1780,1800,1700,1780,1750,0.017,30,1765,"Ecc",0,100,FALSE,FALSE,FALSE,1.71,"young",35,180,88,"m"
21,"LOWER BACK",1,"Ecc02",1840,1840,1750,1800,1840,1775,0.035,65,1807.5,"Ecc",0,-50,FALSE,FALSE,FALSE,3.66,"young",35,180,88,"m"
21,"LOWER BACK",1,"Ecc03",1900,1900,1850,1800,1900,1825,0.039,75,1862.5,"Ecc",0,50,FALSE,FALSE,FALSE,4.11,"young",35,180,88,"m"
21,"LOWER BACK",1,"Ecc04",1760,1780,1700,1750,1770,1725,0.025,45,1747.5,"Ecc",-20,-50,FALSE,FALSE,FALSE,2.61,"young",35,180,88,"m"
21,"LOWER BACK",1,"Ecc05",1780,1760,1700,1750,1770,1725,0.025,45,1747.5,"Ecc",20,-50,FALSE,FALSE,FALSE,2.61,"young",35,180,88,"m"
21,"LOWER BACK",1,"Ecc06",1940,1940,1800,1800,1940,1800,0.072,140,1870,"Ecc",0,0,FALSE,FALSE,FALSE,7.78,"young",35,180,88,"m"
21,"LOWER BACK",1,"Ecc07",1880,1880,1750,1750,1880,1750,0.069,130,1815,"Ecc",0,0,FALSE,FALSE,FALSE,7.43,"young",35,180,88,"m"
21,"LOWER BACK",1,"Ecc08",1960,1960,1850,1750,1960,1800,0.082,160,1880,"Ecc",0,100,FALSE,FALSE,FALSE,8.89,"young",35,180,88,"m"
21,"LOWER BACK",1,"Ecc09",2140,2160,2000,1900,2150,1950,0.093,200,2050,"Ecc",-20,100,TRUE,FALSE,FALSE,10.26,"young",35,180,88,"m"
21,"LOWER BACK",1,"Ecc10",2320,2320,2300,2300,2320,2300,0.009,20,2310,"Ecc",0,0,FALSE,FALSE,FALSE,0.87,"young",35,180,88,"m"
21,"LOWER BACK",2,"Ecc01",1840,1860,1800,1800,1850,1800,0.027,50,1825,"Ecc",-20,0,FALSE,FALSE,FALSE,2.78,"young",35,180,88,"m"
21,"LOWER BACK",2,"Ecc02",1840,1820,1750,1750,1830,1750,0.044,80,1790,"Ecc",20,0,FALSE,FALSE,FALSE,4.57,"young",35,180,88,"m"
21,"LOWER BACK",2,"Ecc03",1820,1800,1800,1750,1810,1775,0.019,35,1792.5,"Ecc",20,50,FALSE,FALSE,FALSE,1.97,"young",35,180,88,"m"
21,"LOWER BACK",2,"Ecc04",1940,1920,1900,1900,1930,1900,0.016,30,1915,"Ecc",20,0,FALSE,FALSE,FALSE,1.58,"young",35,180,88,"m"
21,"LOWER BACK",2,"Ecc05",1960,1960,1850,1900,1960,1875,0.043,85,1917.5,"Ecc",0,-50,FALSE,FALSE,FALSE,4.53,"young",35,180,88,"m"
21,"LOWER BACK",2,"Ecc06",1900,1900,1850,1850,1900,1850,0.026,50,1875,"Ecc",0,0,FALSE,FALSE,FALSE,2.7,"young",35,180,88,"m"
21,"LOWER BACK",2,"Ecc07",1920,1920,1750,1800,1920,1775,0.076,145,1847.5,"Ecc",0,-50,FALSE,FALSE,FALSE,8.17,"young",35,180,88,"m"
21,"LOWER BACK",2,"Ecc08",1880,1860,1700,1700,1870,1700,0.091,170,1785,"Ecc",20,0,FALSE,FALSE,FALSE,10,"young",35,180,88,"m"
21,"LOWER BACK",2,"Ecc09",2120,2100,1850,1800,2110,1825,0.135,285,1967.5,"Ecc",20,50,TRUE,FALSE,FALSE,15.62,"young",35,180,88,"m"
21,"LOWER BACK",2,"Ecc10",2380,2380,2300,2350,2380,2325,0.023,55,2352.5,"Ecc",0,-50,FALSE,FALSE,FALSE,2.37,"young",35,180,88,"m"
21,"LOWER BACK",1,"Rep01",2880,2880,3050,2950,2880,3000,0.042,-120,2940,"Rep",0,100,TRUE,FALSE,FALSE,4,"young",35,180,88,"m"
21,"LOWER BACK",1,"Rep02",3060,3060,3000,3100,3060,3050,0.003,10,3055,"Rep",0,-100,FALSE,FALSE,FALSE,0.33,"young",35,180,88,"m"
21,"LOWER BACK",1,"Rep03",3040,3040,3050,3000,3040,3025,0.005,15,3032.5,"Rep",0,50,FALSE,FALSE,FALSE,0.5,"young",35,180,88,"m"
21,"LOWER BACK",1,"Rep04",2960,2980,2950,3000,2970,2975,0.002,-5,2972.5,"Rep",-20,-50,FALSE,FALSE,FALSE,0.17,"young",35,180,88,"m"
21,"LOWER BACK",1,"Rep05",2940,2920,2950,2950,2930,2950,0.007,-20,2940,"Rep",20,0,FALSE,FALSE,FALSE,0.68,"young",35,180,88,"m"
21,"LOWER BACK",1,"Rep06",3240,3240,3200,3150,3240,3175,0.02,65,3207.5,"Rep",0,50,FALSE,FALSE,FALSE,2.05,"young",35,180,88,"m"
21,"LOWER BACK",1,"Rep07",3220,3220,3200,3200,3220,3200,0.006,20,3210,"Rep",0,0,FALSE,FALSE,FALSE,0.62,"young",35,180,88,"m"
21,"LOWER BACK",1,"Rep08",3320,3340,3350,3300,3330,3325,0.002,5,3327.5,"Rep",-20,50,FALSE,FALSE,FALSE,0.15,"young",35,180,88,"m"
21,"LOWER BACK",1,"Rep09",3500,3500,3500,3500,3500,3500,0,0,3500,"Rep",0,0,FALSE,FALSE,FALSE,0,"young",35,180,88,"m"
21,"LOWER BACK",1,"Rep10",3880,3900,4050,4100,3890,4075,0.048,-185,3982.5,"Rep",-20,-50,TRUE,FALSE,FALSE,4.54,"young",35,180,88,"m"
21,"LOWER BACK",2,"Rep01",3120,3140,3300,3200,3130,3250,0.038,-120,3190,"Rep",-20,100,TRUE,FALSE,FALSE,3.69,"young",35,180,88,"m"
21,"LOWER BACK",2,"Rep02",3120,3080,3050,3100,3100,3075,0.008,25,3087.5,"Rep",40,-50,FALSE,FALSE,FALSE,0.81,"young",35,180,88,"m"
21,"LOWER BACK",2,"Rep03",3040,3060,3100,3050,3050,3075,0.008,-25,3062.5,"Rep",-20,50,FALSE,FALSE,FALSE,0.81,"young",35,180,88,"m"
21,"LOWER BACK",2,"Rep04",3280,3280,3250,3300,3280,3275,0.002,5,3277.5,"Rep",0,-50,FALSE,FALSE,FALSE,0.15,"young",35,180,88,"m"
21,"LOWER BACK",2,"Rep05",3280,3280,3250,3250,3280,3250,0.009,30,3265,"Rep",0,0,FALSE,FALSE,FALSE,0.92,"young",35,180,88,"m"
21,"LOWER BACK",2,"Rep06",3280,3280,3350,3300,3280,3325,0.014,-45,3302.5,"Rep",0,50,FALSE,FALSE,FALSE,1.35,"young",35,180,88,"m"
21,"LOWER BACK",2,"Rep07",3320,3300,3200,3250,3310,3225,0.026,85,3267.5,"Rep",20,-50,FALSE,FALSE,FALSE,2.64,"young",35,180,88,"m"
21,"LOWER BACK",2,"Rep08",3260,3260,3250,3250,3260,3250,0.003,10,3255,"Rep",0,0,FALSE,FALSE,FALSE,0.31,"young",35,180,88,"m"
21,"LOWER BACK",2,"Rep09",3340,3340,3300,3250,3340,3275,0.019,65,3307.5,"Rep",0,50,FALSE,FALSE,FALSE,1.98,"young",35,180,88,"m"
21,"LOWER BACK",2,"Rep10",3560,3600,3800,3850,3580,3825,0.068,-245,3702.5,"Rep",-40,-50,TRUE,FALSE,FALSE,6.41,"young",35,180,88,"m"
21,"LOWER BACK",1,"TuT",32040,32080,32300,32250,32060,32275,0.007,-215,32167.5,"TuT",-40,50,TRUE,FALSE,FALSE,0.67,"young",35,180,88,"m"
21,"LOWER BACK",2,"TuT",32600,32620,32850,32800,32610,32825,0.007,-215,32717.5,"TuT",-20,50,TRUE,FALSE,FALSE,0.65,"young",35,180,88,"m"
21,"TOTAL ABDOMINAL",1,"Con01",1080,1060,1250,1250,1070,1250,0.168,-180,1160,"Con",20,0,TRUE,FALSE,FALSE,14.4,"young",35,180,88,"m"
21,"TOTAL ABDOMINAL",1,"Con02",1020,1040,1050,1100,1030,1075,0.044,-45,1052.5,"Con",-20,-50,FALSE,FALSE,FALSE,4.19,"young",35,180,88,"m"
21,"TOTAL ABDOMINAL",1,"Con03",1000,1000,1000,1100,1000,1050,0.05,-50,1025,"Con",0,-100,FALSE,FALSE,FALSE,4.76,"young",35,180,88,"m"
21,"TOTAL ABDOMINAL",1,"Con04",1120,1120,1100,1150,1120,1125,0.004,-5,1122.5,"Con",0,-50,FALSE,FALSE,FALSE,0.44,"young",35,180,88,"m"
21,"TOTAL ABDOMINAL",1,"Con05",1060,1060,1150,1150,1060,1150,0.085,-90,1105,"Con",0,0,FALSE,FALSE,FALSE,7.83,"young",35,180,88,"m"
21,"TOTAL ABDOMINAL",1,"Con06",1060,1060,1150,1150,1060,1150,0.085,-90,1105,"Con",0,0,FALSE,FALSE,FALSE,7.83,"young",35,180,88,"m"
21,"TOTAL ABDOMINAL",1,"Con07",1060,1060,1150,1100,1060,1125,0.061,-65,1092.5,"Con",0,50,FALSE,FALSE,FALSE,5.78,"young",35,180,88,"m"
21,"TOTAL ABDOMINAL",1,"Con08",1100,1080,1100,1100,1090,1100,0.009,-10,1095,"Con",20,0,FALSE,FALSE,FALSE,0.91,"young",35,180,88,"m"
21,"TOTAL ABDOMINAL",1,"Con09",1040,1060,1100,1100,1050,1100,0.048,-50,1075,"Con",-20,0,FALSE,FALSE,FALSE,4.55,"young",35,180,88,"m"
21,"TOTAL ABDOMINAL",1,"Con10",1160,1120,1350,1250,1140,1300,0.14,-160,1220,"Con",40,100,TRUE,TRUE,FALSE,12.31,"young",35,180,88,"m"
21,"TOTAL ABDOMINAL",2,"Con01",1080,1080,1200,1150,1080,1175,0.088,-95,1127.5,"Con",0,50,FALSE,FALSE,FALSE,8.09,"young",35,180,88,"m"
21,"TOTAL ABDOMINAL",2,"Con02",1000,1000,1000,1000,1000,1000,0,0,1000,"Con",0,0,FALSE,FALSE,FALSE,0,"young",35,180,88,"m"
21,"TOTAL ABDOMINAL",2,"Con03",960,960,1000,1000,960,1000,0.042,-40,980,"Con",0,0,FALSE,FALSE,FALSE,4,"young",35,180,88,"m"
21,"TOTAL ABDOMINAL",2,"Con04",960,960,1000,1000,960,1000,0.042,-40,980,"Con",0,0,FALSE,FALSE,FALSE,4,"young",35,180,88,"m"
21,"TOTAL ABDOMINAL",2,"Con05",920,920,950,950,920,950,0.033,-30,935,"Con",0,0,FALSE,FALSE,FALSE,3.16,"young",35,180,88,"m"
21,"TOTAL ABDOMINAL",2,"Con06",900,920,950,1000,910,975,0.071,-65,942.5,"Con",-20,-50,FALSE,FALSE,FALSE,6.67,"young",35,180,88,"m"
21,"TOTAL ABDOMINAL",2,"Con07",1080,1060,1150,1200,1070,1175,0.098,-105,1122.5,"Con",20,-50,FALSE,FALSE,FALSE,8.94,"young",35,180,88,"m"
21,"TOTAL ABDOMINAL",2,"Con08",1080,1080,1150,1150,1080,1150,0.065,-70,1115,"Con",0,0,FALSE,FALSE,FALSE,6.09,"young",35,180,88,"m"
21,"TOTAL ABDOMINAL",2,"Con09",1060,1080,1200,1150,1070,1175,0.098,-105,1122.5,"Con",-20,50,FALSE,FALSE,FALSE,8.94,"young",35,180,88,"m"
21,"TOTAL ABDOMINAL",2,"Con10",1140,1100,1350,1400,1120,1375,0.228,-255,1247.5,"Con",40,-50,TRUE,TRUE,FALSE,18.55,"young",35,180,88,"m"
21,"TOTAL ABDOMINAL",1,"Ecc01",1940,1920,1850,1800,1930,1825,0.054,105,1877.5,"Ecc",20,50,FALSE,FALSE,FALSE,5.75,"young",35,180,88,"m"
21,"TOTAL ABDOMINAL",1,"Ecc02",1980,1980,1950,1850,1980,1900,0.04,80,1940,"Ecc",0,100,FALSE,FALSE,FALSE,4.21,"young",35,180,88,"m"
21,"TOTAL ABDOMINAL",1,"Ecc03",1620,1620,1650,1600,1620,1625,0.003,-5,1622.5,"Ecc",0,50,FALSE,FALSE,FALSE,0.31,"young",35,180,88,"m"
21,"TOTAL ABDOMINAL",1,"Ecc04",1740,1740,1700,1650,1740,1675,0.037,65,1707.5,"Ecc",0,50,FALSE,FALSE,FALSE,3.88,"young",35,180,88,"m"
21,"TOTAL ABDOMINAL",1,"Ecc05",1740,1740,1650,1650,1740,1650,0.052,90,1695,"Ecc",0,0,FALSE,FALSE,FALSE,5.45,"young",35,180,88,"m"
21,"TOTAL ABDOMINAL",1,"Ecc06",1680,1680,1550,1600,1680,1575,0.062,105,1627.5,"Ecc",0,-50,FALSE,FALSE,FALSE,6.67,"young",35,180,88,"m"
21,"TOTAL ABDOMINAL",1,"Ecc07",1600,1620,1600,1600,1610,1600,0.006,10,1605,"Ecc",-20,0,FALSE,FALSE,FALSE,0.62,"young",35,180,88,"m"
21,"TOTAL ABDOMINAL",1,"Ecc08",1860,1840,1800,1800,1850,1800,0.027,50,1825,"Ecc",20,0,FALSE,FALSE,FALSE,2.78,"young",35,180,88,"m"
21,"TOTAL ABDOMINAL",1,"Ecc09",1800,1820,1700,1750,1810,1725,0.047,85,1767.5,"Ecc",-20,-50,FALSE,FALSE,FALSE,4.93,"young",35,180,88,"m"
21,"TOTAL ABDOMINAL",1,"Ecc10",1980,2000,1850,2050,1990,1950,0.02,40,1970,"Ecc",-20,-200,FALSE,FALSE,TRUE,2.05,"young",35,180,88,"m"
21,"TOTAL ABDOMINAL",2,"Ecc01",1480,1480,1450,1500,1480,1475,0.003,5,1477.5,"Ecc",0,-50,FALSE,FALSE,FALSE,0.34,"young",35,180,88,"m"
21,"TOTAL ABDOMINAL",2,"Ecc02",1560,1560,1550,1550,1560,1550,0.006,10,1555,"Ecc",0,0,FALSE,FALSE,FALSE,0.65,"young",35,180,88,"m"
21,"TOTAL ABDOMINAL",2,"Ecc03",1480,1480,1450,1450,1480,1450,0.02,30,1465,"Ecc",0,0,FALSE,FALSE,FALSE,2.07,"young",35,180,88,"m"
21,"TOTAL ABDOMINAL",2,"Ecc04",1560,1560,1500,1500,1560,1500,0.038,60,1530,"Ecc",0,0,FALSE,FALSE,FALSE,4,"young",35,180,88,"m"
21,"TOTAL ABDOMINAL",2,"Ecc05",1520,1500,1500,1450,1510,1475,0.023,35,1492.5,"Ecc",20,50,FALSE,FALSE,FALSE,2.37,"young",35,180,88,"m"
21,"TOTAL ABDOMINAL",2,"Ecc06",1740,1740,1650,1600,1740,1625,0.066,115,1682.5,"Ecc",0,50,FALSE,FALSE,FALSE,7.08,"young",35,180,88,"m"
21,"TOTAL ABDOMINAL",2,"Ecc07",1560,1580,1500,1500,1570,1500,0.045,70,1535,"Ecc",-20,0,FALSE,FALSE,FALSE,4.67,"young",35,180,88,"m"
21,"TOTAL ABDOMINAL",2,"Ecc08",1600,1580,1500,1500,1590,1500,0.057,90,1545,"Ecc",20,0,FALSE,FALSE,FALSE,6,"young",35,180,88,"m"
21,"TOTAL ABDOMINAL",2,"Ecc09",1820,1840,1600,1600,1830,1600,0.126,230,1715,"Ecc",-20,0,TRUE,FALSE,FALSE,14.37,"young",35,180,88,"m"
21,"TOTAL ABDOMINAL",2,"Ecc10",1980,1980,1950,1900,1980,1925,0.028,55,1952.5,"Ecc",0,50,FALSE,FALSE,FALSE,2.86,"young",35,180,88,"m"
21,"TOTAL ABDOMINAL",1,"Rep01",3020,2980,3100,3050,3000,3075,0.025,-75,3037.5,"Rep",40,50,FALSE,FALSE,FALSE,2.44,"young",35,180,88,"m"
21,"TOTAL ABDOMINAL",1,"Rep02",3000,3020,3000,2950,3010,2975,0.012,35,2992.5,"Rep",-20,50,FALSE,FALSE,FALSE,1.18,"young",35,180,88,"m"
21,"TOTAL ABDOMINAL",1,"Rep03",2620,2620,2650,2700,2620,2675,0.021,-55,2647.5,"Rep",0,-50,FALSE,FALSE,FALSE,2.06,"young",35,180,88,"m"
21,"TOTAL ABDOMINAL",1,"Rep04",2860,2860,2800,2800,2860,2800,0.021,60,2830,"Rep",0,0,FALSE,FALSE,FALSE,2.14,"young",35,180,88,"m"
21,"TOTAL ABDOMINAL",1,"Rep05",2800,2800,2800,2800,2800,2800,0,0,2800,"Rep",0,0,FALSE,FALSE,FALSE,0,"young",35,180,88,"m"
21,"TOTAL ABDOMINAL",1,"Rep06",2740,2740,2700,2750,2740,2725,0.005,15,2732.5,"Rep",0,-50,FALSE,FALSE,FALSE,0.55,"young",35,180,88,"m"
21,"TOTAL ABDOMINAL",1,"Rep07",2660,2680,2750,2700,2670,2725,0.021,-55,2697.5,"Rep",-20,50,FALSE,FALSE,FALSE,2.02,"young",35,180,88,"m"
21,"TOTAL ABDOMINAL",1,"Rep08",2960,2920,2900,2900,2940,2900,0.014,40,2920,"Rep",40,0,FALSE,FALSE,FALSE,1.38,"young",35,180,88,"m"
21,"TOTAL ABDOMINAL",1,"Rep09",2840,2880,2800,2850,2860,2825,0.012,35,2842.5,"Rep",-40,-50,FALSE,FALSE,FALSE,1.24,"young",35,180,88,"m"
21,"TOTAL ABDOMINAL",1,"Rep10",3140,3120,3200,3300,3130,3250,0.038,-120,3190,"Rep",20,-100,FALSE,FALSE,FALSE,3.69,"young",35,180,88,"m"
21,"TOTAL ABDOMINAL",2,"Rep01",2560,2560,2650,2650,2560,2650,0.035,-90,2605,"Rep",0,0,FALSE,FALSE,FALSE,3.4,"young",35,180,88,"m"
21,"TOTAL ABDOMINAL",2,"Rep02",2560,2560,2550,2550,2560,2550,0.004,10,2555,"Rep",0,0,FALSE,FALSE,FALSE,0.39,"young",35,180,88,"m"
21,"TOTAL ABDOMINAL",2,"Rep03",2440,2440,2450,2450,2440,2450,0.004,-10,2445,"Rep",0,0,FALSE,FALSE,FALSE,0.41,"young",35,180,88,"m"
21,"TOTAL ABDOMINAL",2,"Rep04",2520,2520,2500,2500,2520,2500,0.008,20,2510,"Rep",0,0,FALSE,FALSE,FALSE,0.8,"young",35,180,88,"m"
21,"TOTAL ABDOMINAL",2,"Rep05",2440,2420,2450,2400,2430,2425,0.002,5,2427.5,"Rep",20,50,FALSE,FALSE,FALSE,0.21,"young",35,180,88,"m"
21,"TOTAL ABDOMINAL",2,"Rep06",2640,2660,2600,2600,2650,2600,0.019,50,2625,"Rep",-20,0,FALSE,FALSE,FALSE,1.92,"young",35,180,88,"m"
21,"TOTAL ABDOMINAL",2,"Rep07",2640,2640,2650,2700,2640,2675,0.013,-35,2657.5,"Rep",0,-50,FALSE,FALSE,FALSE,1.31,"young",35,180,88,"m"
21,"TOTAL ABDOMINAL",2,"Rep08",2680,2660,2650,2650,2670,2650,0.007,20,2660,"Rep",20,0,FALSE,FALSE,FALSE,0.75,"young",35,180,88,"m"
21,"TOTAL ABDOMINAL",2,"Rep09",2880,2920,2800,2750,2900,2775,0.043,125,2837.5,"Rep",-40,50,TRUE,FALSE,FALSE,4.5,"young",35,180,88,"m"
21,"TOTAL ABDOMINAL",2,"Rep10",3120,3080,3300,3300,3100,3300,0.065,-200,3200,"Rep",40,0,TRUE,FALSE,FALSE,6.06,"young",35,180,88,"m"
21,"TOTAL ABDOMINAL",1,"TuT",28640,28620,28700,28800,28630,28750,0.004,-120,28690,"TuT",20,-100,FALSE,FALSE,FALSE,0.42,"young",35,180,88,"m"
21,"TOTAL ABDOMINAL",2,"TuT",26480,26460,26600,26550,26470,26575,0.004,-105,26522.5,"TuT",20,50,FALSE,FALSE,FALSE,0.4,"young",35,180,88,"m"
21,"VERTICAL TRACTION",1,"Con01",2220,2220,1950,2050,2220,2000,0.099,220,2110,"Con",0,-100,FALSE,FALSE,FALSE,11,"young",35,180,88,"m"
21,"VERTICAL TRACTION",1,"Con02",1420,1440,1600,1650,1430,1625,0.136,-195,1527.5,"Con",-20,-50,FALSE,FALSE,FALSE,12,"young",35,180,88,"m"
21,"VERTICAL TRACTION",1,"Con03",1500,1480,1500,1550,1490,1525,0.023,-35,1507.5,"Con",20,-50,FALSE,FALSE,FALSE,2.3,"young",35,180,88,"m"
21,"VERTICAL TRACTION",1,"Con04",1340,1360,1450,1500,1350,1475,0.093,-125,1412.5,"Con",-20,-50,FALSE,FALSE,FALSE,8.47,"young",35,180,88,"m"
21,"VERTICAL TRACTION",1,"Con05",1360,1360,1400,1500,1360,1450,0.066,-90,1405,"Con",0,-100,FALSE,FALSE,FALSE,6.21,"young",35,180,88,"m"
21,"VERTICAL TRACTION",1,"Con06",1380,1380,1500,1500,1380,1500,0.087,-120,1440,"Con",0,0,FALSE,FALSE,FALSE,8,"young",35,180,88,"m"
21,"VERTICAL TRACTION",1,"Con07",1380,1380,1450,1650,1380,1550,0.123,-170,1465,"Con",0,-200,FALSE,FALSE,TRUE,10.97,"young",35,180,88,"m"
21,"VERTICAL TRACTION",1,"Con08",1340,1340,1600,1600,1340,1600,0.194,-260,1470,"Con",0,0,FALSE,FALSE,FALSE,16.25,"young",35,180,88,"m"
21,"VERTICAL TRACTION",1,"Con09",1460,1460,2050,1800,1460,1925,0.318,-465,1692.5,"Con",0,250,TRUE,FALSE,TRUE,24.16,"young",35,180,88,"m"
21,"VERTICAL TRACTION",1,"Con10",1500,1500,3250,2500,1500,2875,0.917,-1375,2187.5,"Con",0,750,TRUE,FALSE,TRUE,47.83,"young",35,180,88,"m"
21,"VERTICAL TRACTION",2,"Con01",2520,2560,1850,1850,2540,1850,0.272,690,2195,"Con",-40,0,TRUE,FALSE,FALSE,37.3,"young",35,180,88,"m"
21,"VERTICAL TRACTION",2,"Con02",1700,1700,1900,1800,1700,1850,0.088,-150,1775,"Con",0,100,FALSE,FALSE,FALSE,8.11,"young",35,180,88,"m"
21,"VERTICAL TRACTION",2,"Con03",1680,1700,1800,1750,1690,1775,0.05,-85,1732.5,"Con",-20,50,FALSE,FALSE,FALSE,4.79,"young",35,180,88,"m"
21,"VERTICAL TRACTION",2,"Con04",1520,1520,1750,1700,1520,1725,0.135,-205,1622.5,"Con",0,50,FALSE,FALSE,FALSE,11.88,"young",35,180,88,"m"
21,"VERTICAL TRACTION",2,"Con05",1400,1420,1600,1600,1410,1600,0.135,-190,1505,"Con",-20,0,FALSE,FALSE,FALSE,11.88,"young",35,180,88,"m"
21,"VERTICAL TRACTION",2,"Con06",1440,1420,1550,1550,1430,1550,0.084,-120,1490,"Con",20,0,FALSE,FALSE,FALSE,7.74,"young",35,180,88,"m"
21,"VERTICAL TRACTION",2,"Con07",1540,1540,1900,2000,1540,1950,0.266,-410,1745,"Con",0,-100,TRUE,FALSE,FALSE,21.03,"young",35,180,88,"m"
21,"VERTICAL TRACTION",2,"Con08",1540,1580,1850,1950,1560,1900,0.218,-340,1730,"Con",-40,-100,TRUE,FALSE,FALSE,17.89,"young",35,180,88,"m"
21,"VERTICAL TRACTION",2,"Con09",1580,1600,1800,1850,1590,1825,0.148,-235,1707.5,"Con",-20,-50,FALSE,FALSE,FALSE,12.88,"young",35,180,88,"m"
21,"VERTICAL TRACTION",2,"Con10",1700,1720,2400,2650,1710,2525,0.477,-815,2117.5,"Con",-20,-250,TRUE,FALSE,TRUE,32.28,"young",35,180,88,"m"
21,"VERTICAL TRACTION",1,"Ecc01",2220,2180,2100,2000,2200,2050,0.068,150,2125,"Ecc",40,100,FALSE,FALSE,FALSE,7.32,"young",35,180,88,"m"
21,"VERTICAL TRACTION",1,"Ecc02",2100,2100,2050,2000,2100,2025,0.036,75,2062.5,"Ecc",0,50,FALSE,FALSE,FALSE,3.7,"young",35,180,88,"m"
21,"VERTICAL TRACTION",1,"Ecc03",2460,2480,2350,2300,2470,2325,0.059,145,2397.5,"Ecc",-20,50,FALSE,FALSE,FALSE,6.24,"young",35,180,88,"m"
21,"VERTICAL TRACTION",1,"Ecc04",2620,2600,2550,2500,2610,2525,0.033,85,2567.5,"Ecc",20,50,FALSE,FALSE,FALSE,3.37,"young",35,180,88,"m"
21,"VERTICAL TRACTION",1,"Ecc05",2580,2580,2500,2450,2580,2475,0.041,105,2527.5,"Ecc",0,50,FALSE,FALSE,FALSE,4.24,"young",35,180,88,"m"
21,"VERTICAL TRACTION",1,"Ecc06",2440,2440,2350,2250,2440,2300,0.057,140,2370,"Ecc",0,100,FALSE,FALSE,FALSE,6.09,"young",35,180,88,"m"
21,"VERTICAL TRACTION",1,"Ecc07",2420,2420,2250,2150,2420,2200,0.091,220,2310,"Ecc",0,100,FALSE,FALSE,FALSE,10,"young",35,180,88,"m"
21,"VERTICAL TRACTION",1,"Ecc08",2660,2660,2400,2350,2660,2375,0.107,285,2517.5,"Ecc",0,50,TRUE,FALSE,FALSE,12,"young",35,180,88,"m"
21,"VERTICAL TRACTION",1,"Ecc09",2660,2660,1800,2350,2660,2075,0.22,585,2367.5,"Ecc",0,-550,TRUE,FALSE,TRUE,28.19,"young",35,180,88,"m"
21,"VERTICAL TRACTION",1,"Ecc10",2620,2620,1100,1650,2620,1375,0.475,1245,1997.5,"Ecc",0,-550,TRUE,FALSE,TRUE,90.55,"young",35,180,88,"m"
21,"VERTICAL TRACTION",2,"Ecc01",2360,2360,2250,2300,2360,2275,0.036,85,2317.5,"Ecc",0,-50,FALSE,FALSE,FALSE,3.74,"young",35,180,88,"m"
21,"VERTICAL TRACTION",2,"Ecc02",2440,2420,2250,2350,2430,2300,0.053,130,2365,"Ecc",20,-100,FALSE,FALSE,FALSE,5.65,"young",35,180,88,"m"
21,"VERTICAL TRACTION",2,"Ecc03",2480,2480,2300,2350,2480,2325,0.062,155,2402.5,"Ecc",0,-50,FALSE,FALSE,FALSE,6.67,"young",35,180,88,"m"
21,"VERTICAL TRACTION",2,"Ecc04",2500,2480,2250,2300,2490,2275,0.086,215,2382.5,"Ecc",20,-50,FALSE,FALSE,FALSE,9.45,"young",35,180,88,"m"
21,"VERTICAL TRACTION",2,"Ecc05",2760,2780,2650,2600,2770,2625,0.052,145,2697.5,"Ecc",-20,50,FALSE,FALSE,FALSE,5.52,"young",35,180,88,"m"
21,"VERTICAL TRACTION",2,"Ecc06",2460,2440,2300,2300,2450,2300,0.061,150,2375,"Ecc",20,0,FALSE,FALSE,FALSE,6.52,"young",35,180,88,"m"
21,"VERTICAL TRACTION",2,"Ecc07",2580,2580,2200,2100,2580,2150,0.167,430,2365,"Ecc",0,100,TRUE,FALSE,FALSE,20,"young",35,180,88,"m"
21,"VERTICAL TRACTION",2,"Ecc08",2680,2660,2400,2300,2670,2350,0.12,320,2510,"Ecc",20,100,TRUE,FALSE,FALSE,13.62,"young",35,180,88,"m"
21,"VERTICAL TRACTION",2,"Ecc09",2560,2540,2300,2250,2550,2275,0.108,275,2412.5,"Ecc",20,50,TRUE,FALSE,FALSE,12.09,"young",35,180,88,"m"
21,"VERTICAL TRACTION",2,"Ecc10",2760,2740,2150,1900,2750,2025,0.264,725,2387.5,"Ecc",20,250,TRUE,FALSE,TRUE,35.8,"young",35,180,88,"m"
21,"VERTICAL TRACTION",1,"Rep01",4440,4400,4050,4050,4420,4050,0.084,370,4235,"Rep",40,0,TRUE,FALSE,FALSE,9.14,"young",35,180,88,"m"
21,"VERTICAL TRACTION",1,"Rep02",3520,3540,3650,3650,3530,3650,0.034,-120,3590,"Rep",-20,0,FALSE,FALSE,FALSE,3.29,"young",35,180,88,"m"
21,"VERTICAL TRACTION",1,"Rep03",3960,3960,3850,3850,3960,3850,0.028,110,3905,"Rep",0,0,FALSE,FALSE,FALSE,2.86,"young",35,180,88,"m"
21,"VERTICAL TRACTION",1,"Rep04",3960,3960,4000,4000,3960,4000,0.01,-40,3980,"Rep",0,0,FALSE,FALSE,FALSE,1,"young",35,180,88,"m"
21,"VERTICAL TRACTION",1,"Rep05",3940,3940,3900,3950,3940,3925,0.004,15,3932.5,"Rep",0,-50,FALSE,FALSE,FALSE,0.38,"young",35,180,88,"m"
21,"VERTICAL TRACTION",1,"Rep06",3820,3820,3850,3750,3820,3800,0.005,20,3810,"Rep",0,100,FALSE,FALSE,FALSE,0.53,"young",35,180,88,"m"
21,"VERTICAL TRACTION",1,"Rep07",3800,3800,3700,3800,3800,3750,0.013,50,3775,"Rep",0,-100,FALSE,FALSE,FALSE,1.33,"young",35,180,88,"m"
21,"VERTICAL TRACTION",1,"Rep08",4000,4000,4000,3950,4000,3975,0.006,25,3987.5,"Rep",0,50,FALSE,FALSE,FALSE,0.63,"young",35,180,88,"m"
21,"VERTICAL TRACTION",1,"Rep09",4120,4120,3850,4150,4120,4000,0.029,120,4060,"Rep",0,-300,FALSE,FALSE,TRUE,3,"young",35,180,88,"m"
21,"VERTICAL TRACTION",1,"Rep10",4120,4120,4350,4150,4120,4250,0.032,-130,4185,"Rep",0,200,FALSE,FALSE,TRUE,3.06,"young",35,180,88,"m"
21,"VERTICAL TRACTION",2,"Rep01",4880,4920,4100,4150,4900,4125,0.158,775,4512.5,"Rep",-40,-50,TRUE,FALSE,FALSE,18.79,"young",35,180,88,"m"
21,"VERTICAL TRACTION",2,"Rep02",4140,4120,4150,4150,4130,4150,0.005,-20,4140,"Rep",20,0,FALSE,FALSE,FALSE,0.48,"young",35,180,88,"m"
21,"VERTICAL TRACTION",2,"Rep03",4160,4180,4100,4100,4170,4100,0.017,70,4135,"Rep",-20,0,FALSE,FALSE,FALSE,1.71,"young",35,180,88,"m"
21,"VERTICAL TRACTION",2,"Rep04",4020,4000,4000,4000,4010,4000,0.002,10,4005,"Rep",20,0,FALSE,FALSE,FALSE,0.25,"young",35,180,88,"m"
21,"VERTICAL TRACTION",2,"Rep05",4160,4200,4250,4200,4180,4225,0.011,-45,4202.5,"Rep",-40,50,FALSE,FALSE,FALSE,1.07,"young",35,180,88,"m"
21,"VERTICAL TRACTION",2,"Rep06",3900,3860,3850,3850,3880,3850,0.008,30,3865,"Rep",40,0,FALSE,FALSE,FALSE,0.78,"young",35,180,88,"m"
21,"VERTICAL TRACTION",2,"Rep07",4120,4120,4100,4100,4120,4100,0.005,20,4110,"Rep",0,0,FALSE,FALSE,FALSE,0.49,"young",35,180,88,"m"
21,"VERTICAL TRACTION",2,"Rep08",4220,4240,4250,4250,4230,4250,0.005,-20,4240,"Rep",-20,0,FALSE,FALSE,FALSE,0.47,"young",35,180,88,"m"
21,"VERTICAL TRACTION",2,"Rep09",4140,4140,4100,4100,4140,4100,0.01,40,4120,"Rep",0,0,FALSE,FALSE,FALSE,0.98,"young",35,180,88,"m"
21,"VERTICAL TRACTION",2,"Rep10",4460,4460,4550,4550,4460,4550,0.02,-90,4505,"Rep",0,0,FALSE,FALSE,FALSE,1.98,"young",35,180,88,"m"
21,"VERTICAL TRACTION",1,"TuT",39680,39660,39200,39300,39670,39250,0.011,420,39460,"TuT",20,-100,FALSE,FALSE,FALSE,1.07,"young",35,180,88,"m"
21,"VERTICAL TRACTION",2,"TuT",42200,42240,41450,41450,42220,41450,0.018,770,41835,"TuT",-40,0,FALSE,FALSE,FALSE,1.86,"young",35,180,88,"m"
21,"CHEST PRESS",1,"Con01",2160,2140,2000,2100,2150,2050,0.047,100,2100,"Con",20,-100,FALSE,FALSE,FALSE,4.88,"young",35,180,88,"m"
21,"CHEST PRESS",1,"Con02",1220,1220,1400,1450,1220,1425,0.168,-205,1322.5,"Con",0,-50,FALSE,FALSE,FALSE,14.39,"young",35,180,88,"m"
21,"CHEST PRESS",1,"Con03",1160,1160,1200,1250,1160,1225,0.056,-65,1192.5,"Con",0,-50,FALSE,FALSE,FALSE,5.31,"young",35,180,88,"m"
21,"CHEST PRESS",1,"Con04",1160,1160,1250,1250,1160,1250,0.078,-90,1205,"Con",0,0,FALSE,FALSE,FALSE,7.2,"young",35,180,88,"m"
21,"CHEST PRESS",1,"Con05",1100,1100,1400,1250,1100,1325,0.205,-225,1212.5,"Con",0,150,FALSE,FALSE,FALSE,16.98,"young",35,180,88,"m"
21,"CHEST PRESS",1,"Con06",1200,1220,1550,1550,1210,1550,0.281,-340,1380,"Con",-20,0,FALSE,FALSE,FALSE,21.94,"young",35,180,88,"m"
21,"CHEST PRESS",1,"Con07",1240,1220,1450,1400,1230,1425,0.159,-195,1327.5,"Con",20,50,FALSE,FALSE,FALSE,13.68,"young",35,180,88,"m"
21,"CHEST PRESS",1,"Con08",1200,1240,1300,1250,1220,1275,0.045,-55,1247.5,"Con",-40,50,FALSE,TRUE,FALSE,4.31,"young",35,180,88,"m"
21,"CHEST PRESS",1,"Con09",1240,1240,1300,1400,1240,1350,0.089,-110,1295,"Con",0,-100,FALSE,FALSE,FALSE,8.15,"young",35,180,88,"m"
21,"CHEST PRESS",1,"Con10",1420,1400,1450,1700,1410,1575,0.117,-165,1492.5,"Con",20,-250,FALSE,FALSE,FALSE,10.48,"young",35,180,88,"m"
21,"CHEST PRESS",2,"Con01",1460,1440,2850,2900,1450,2875,0.983,-1425,2162.5,"Con",20,-50,TRUE,FALSE,FALSE,49.57,"young",35,180,88,"m"
21,"CHEST PRESS",2,"Con02",1280,1300,1750,1800,1290,1775,0.376,-485,1532.5,"Con",-20,-50,TRUE,FALSE,FALSE,27.32,"young",35,180,88,"m"
21,"CHEST PRESS",2,"Con03",1380,1400,1750,1750,1390,1750,0.259,-360,1570,"Con",-20,0,TRUE,FALSE,FALSE,20.57,"young",35,180,88,"m"
21,"CHEST PRESS",2,"Con04",1420,1420,1600,1550,1420,1575,0.109,-155,1497.5,"Con",0,50,FALSE,FALSE,FALSE,9.84,"young",35,180,88,"m"
21,"CHEST PRESS",2,"Con05",1400,1420,1450,1500,1410,1475,0.046,-65,1442.5,"Con",-20,-50,FALSE,FALSE,FALSE,4.41,"young",35,180,88,"m"
21,"CHEST PRESS",2,"Con06",1480,1480,1500,1550,1480,1525,0.03,-45,1502.5,"Con",0,-50,FALSE,FALSE,FALSE,2.95,"young",35,180,88,"m"
21,"CHEST PRESS",2,"Con07",1400,1420,1600,1650,1410,1625,0.152,-215,1517.5,"Con",-20,-50,FALSE,FALSE,FALSE,13.23,"young",35,180,88,"m"
21,"CHEST PRESS",2,"Con08",1520,1520,1600,1650,1520,1625,0.069,-105,1572.5,"Con",0,-50,FALSE,FALSE,FALSE,6.46,"young",35,180,88,"m"
21,"CHEST PRESS",2,"Con09",1640,1640,1750,1700,1640,1725,0.052,-85,1682.5,"Con",0,50,FALSE,FALSE,FALSE,4.93,"young",35,180,88,"m"
21,"CHEST PRESS",2,"Con10",1920,1920,1900,1900,1920,1900,0.01,20,1910,"Con",0,0,FALSE,FALSE,FALSE,1.05,"young",35,180,88,"m"
21,"CHEST PRESS",1,"Ecc01",1840,1820,1700,1550,1830,1625,0.112,205,1727.5,"Ecc",20,150,FALSE,FALSE,FALSE,12.62,"young",35,180,88,"m"
21,"CHEST PRESS",1,"Ecc02",1920,1900,1750,1700,1910,1725,0.097,185,1817.5,"Ecc",20,50,FALSE,FALSE,FALSE,10.72,"young",35,180,88,"m"
21,"CHEST PRESS",1,"Ecc03",1740,1760,1700,1700,1750,1700,0.029,50,1725,"Ecc",-20,0,FALSE,FALSE,FALSE,2.94,"young",35,180,88,"m"
21,"CHEST PRESS",1,"Ecc04",1880,1880,1800,1800,1880,1800,0.043,80,1840,"Ecc",0,0,FALSE,FALSE,FALSE,4.44,"young",35,180,88,"m"
21,"CHEST PRESS",1,"Ecc05",2020,2020,1600,1750,2020,1675,0.171,345,1847.5,"Ecc",0,-150,TRUE,FALSE,FALSE,20.6,"young",35,180,88,"m"
21,"CHEST PRESS",1,"Ecc06",1840,1840,1600,1600,1840,1600,0.13,240,1720,"Ecc",0,0,FALSE,FALSE,FALSE,15,"young",35,180,88,"m"
21,"CHEST PRESS",1,"Ecc07",1780,1760,1600,1650,1770,1625,0.082,145,1697.5,"Ecc",20,-50,FALSE,FALSE,FALSE,8.92,"young",35,180,88,"m"
21,"CHEST PRESS",1,"Ecc08",1760,1740,1650,1650,1750,1650,0.057,100,1700,"Ecc",20,0,FALSE,FALSE,FALSE,6.06,"young",35,180,88,"m"
21,"CHEST PRESS",1,"Ecc09",2180,2200,2100,1900,2190,2000,0.087,190,2095,"Ecc",-20,200,FALSE,FALSE,FALSE,9.5,"young",35,180,88,"m"
21,"CHEST PRESS",1,"Ecc10",2740,2740,2800,2800,2740,2800,0.022,-60,2770,"Ecc",0,0,FALSE,FALSE,FALSE,2.14,"young",35,180,88,"m"
21,"CHEST PRESS",2,"Ecc01",1940,1920,1700,1650,1930,1675,0.132,255,1802.5,"Ecc",20,50,FALSE,FALSE,FALSE,15.22,"young",35,180,88,"m"
21,"CHEST PRESS",2,"Ecc02",1980,1960,1500,1450,1970,1475,0.251,495,1722.5,"Ecc",20,50,TRUE,FALSE,FALSE,33.56,"young",35,180,88,"m"
21,"CHEST PRESS",2,"Ecc03",1940,1940,1650,1700,1940,1675,0.137,265,1807.5,"Ecc",0,-50,FALSE,FALSE,FALSE,15.82,"young",35,180,88,"m"
21,"CHEST PRESS",2,"Ecc04",2060,2040,1950,1950,2050,1950,0.049,100,2000,"Ecc",20,0,FALSE,FALSE,FALSE,5.13,"young",35,180,88,"m"
21,"CHEST PRESS",2,"Ecc05",2200,2200,2150,2100,2200,2125,0.034,75,2162.5,"Ecc",0,50,FALSE,FALSE,FALSE,3.53,"young",35,180,88,"m"
21,"CHEST PRESS",2,"Ecc06",2000,1980,1950,1900,1990,1925,0.033,65,1957.5,"Ecc",20,50,FALSE,FALSE,FALSE,3.38,"young",35,180,88,"m"
21,"CHEST PRESS",2,"Ecc07",2340,2340,2100,2050,2340,2075,0.113,265,2207.5,"Ecc",0,50,FALSE,FALSE,FALSE,12.77,"young",35,180,88,"m"
21,"CHEST PRESS",2,"Ecc08",2100,2100,2050,2050,2100,2050,0.024,50,2075,"Ecc",0,0,FALSE,FALSE,FALSE,2.44,"young",35,180,88,"m"
21,"CHEST PRESS",2,"Ecc09",2280,2280,2150,2200,2280,2175,0.046,105,2227.5,"Ecc",0,-50,FALSE,FALSE,FALSE,4.83,"young",35,180,88,"m"
21,"CHEST PRESS",2,"Ecc10",3520,3540,1200,1250,3530,1225,0.653,2305,2377.5,"Ecc",-20,-50,TRUE,FALSE,FALSE,188.16,"young",35,180,88,"m"
21,"CHEST PRESS",1,"Rep01",4000,3960,3700,3650,3980,3675,0.077,305,3827.5,"Rep",40,50,TRUE,FALSE,FALSE,8.3,"young",35,180,88,"m"
21,"CHEST PRESS",1,"Rep02",3140,3120,3150,3150,3130,3150,0.006,-20,3140,"Rep",20,0,FALSE,FALSE,FALSE,0.63,"young",35,180,88,"m"
21,"CHEST PRESS",1,"Rep03",2900,2920,2900,2950,2910,2925,0.005,-15,2917.5,"Rep",-20,-50,FALSE,FALSE,FALSE,0.51,"young",35,180,88,"m"
21,"CHEST PRESS",1,"Rep04",3040,3040,3050,3050,3040,3050,0.003,-10,3045,"Rep",0,0,FALSE,FALSE,FALSE,0.33,"young",35,180,88,"m"
21,"CHEST PRESS",1,"Rep05",3120,3120,3000,3000,3120,3000,0.038,120,3060,"Rep",0,0,FALSE,FALSE,FALSE,4,"young",35,180,88,"m"
21,"CHEST PRESS",1,"Rep06",3040,3060,3150,3150,3050,3150,0.033,-100,3100,"Rep",-20,0,FALSE,FALSE,FALSE,3.17,"young",35,180,88,"m"
21,"CHEST PRESS",1,"Rep07",3020,2980,3050,3050,3000,3050,0.017,-50,3025,"Rep",40,0,FALSE,FALSE,FALSE,1.64,"young",35,180,88,"m"
21,"CHEST PRESS",1,"Rep08",2960,2980,2950,2900,2970,2925,0.015,45,2947.5,"Rep",-20,50,FALSE,FALSE,FALSE,1.54,"young",35,180,88,"m"
21,"CHEST PRESS",1,"Rep09",3420,3440,3400,3300,3430,3350,0.023,80,3390,"Rep",-20,100,FALSE,FALSE,FALSE,2.39,"young",35,180,88,"m"
21,"CHEST PRESS",1,"Rep10",4160,4140,4250,4500,4150,4375,0.054,-225,4262.5,"Rep",20,-250,TRUE,FALSE,TRUE,5.14,"young",35,180,88,"m"
21,"CHEST PRESS",2,"Rep01",3400,3360,4550,4550,3380,4550,0.346,-1170,3965,"Rep",40,0,TRUE,FALSE,FALSE,25.71,"young",35,180,88,"m"
21,"CHEST PRESS",2,"Rep02",3260,3260,3250,3250,3260,3250,0.003,10,3255,"Rep",0,0,FALSE,FALSE,FALSE,0.31,"young",35,180,88,"m"
21,"CHEST PRESS",2,"Rep03",3320,3340,3400,3450,3330,3425,0.029,-95,3377.5,"Rep",-20,-50,FALSE,FALSE,FALSE,2.77,"young",35,180,88,"m"
21,"CHEST PRESS",2,"Rep04",3480,3460,3550,3500,3470,3525,0.016,-55,3497.5,"Rep",20,50,FALSE,FALSE,FALSE,1.56,"young",35,180,88,"m"
21,"CHEST PRESS",2,"Rep05",3600,3620,3600,3600,3610,3600,0.003,10,3605,"Rep",-20,0,FALSE,FALSE,FALSE,0.28,"young",35,180,88,"m"
21,"CHEST PRESS",2,"Rep06",3480,3460,3450,3450,3470,3450,0.006,20,3460,"Rep",20,0,FALSE,FALSE,FALSE,0.58,"young",35,180,88,"m"
21,"CHEST PRESS",2,"Rep07",3740,3760,3700,3700,3750,3700,0.013,50,3725,"Rep",-20,0,FALSE,FALSE,FALSE,1.35,"young",35,180,88,"m"
21,"CHEST PRESS",2,"Rep08",3620,3620,3650,3700,3620,3675,0.015,-55,3647.5,"Rep",0,-50,FALSE,FALSE,FALSE,1.5,"young",35,180,88,"m"
21,"CHEST PRESS",2,"Rep09",3920,3920,3900,3900,3920,3900,0.005,20,3910,"Rep",0,0,FALSE,FALSE,FALSE,0.51,"young",35,180,88,"m"
21,"CHEST PRESS",2,"Rep10",5440,5460,3100,3150,5450,3125,0.427,2325,4287.5,"Rep",-20,-50,TRUE,FALSE,FALSE,74.4,"young",35,180,88,"m"
21,"CHEST PRESS",1,"TuT",32800,32760,32600,32700,32780,32650,0.004,130,32715,"TuT",40,-100,FALSE,FALSE,FALSE,0.4,"young",35,180,88,"m"
21,"CHEST PRESS",2,"TuT",37260,37260,36150,36250,37260,36200,0.028,1060,36730,"TuT",0,-100,FALSE,FALSE,FALSE,2.93,"young",35,180,88,"m"
22,"LEG PRESS",1,"Con01",2320,2320,2600,2550,2320,2575,0.11,-255,2447.5,"Con",0,50,FALSE,FALSE,FALSE,9.9,"young",43,185,90,"m"
22,"LEG PRESS",1,"Con02",1940,1920,1850,1850,1930,1850,0.041,80,1890,"Con",20,0,FALSE,FALSE,FALSE,4.32,"young",43,185,90,"m"
22,"LEG PRESS",1,"Con03",1780,1780,1800,1850,1780,1825,0.025,-45,1802.5,"Con",0,-50,FALSE,FALSE,FALSE,2.47,"young",43,185,90,"m"
22,"LEG PRESS",1,"Con04",2000,1980,2050,2050,1990,2050,0.03,-60,2020,"Con",20,0,FALSE,FALSE,FALSE,2.93,"young",43,185,90,"m"
22,"LEG PRESS",1,"Con05",2100,2160,2250,2350,2130,2300,0.08,-170,2215,"Con",-60,-100,FALSE,FALSE,FALSE,7.39,"young",43,185,90,"m"
22,"LEG PRESS",1,"Con06",2260,2260,2450,2500,2260,2475,0.095,-215,2367.5,"Con",0,-50,FALSE,FALSE,FALSE,8.69,"young",43,185,90,"m"
22,"LEG PRESS",1,"Con07",1800,1760,2500,2050,1780,2275,0.278,-495,2027.5,"Con",40,450,TRUE,FALSE,TRUE,21.76,"young",43,185,90,"m"
22,"LEG PRESS",1,"Con08",2140,2120,2800,2800,2130,2800,0.315,-670,2465,"Con",20,0,TRUE,FALSE,FALSE,23.93,"young",43,185,90,"m"
22,"LEG PRESS",1,"Con09",1840,1860,3050,3100,1850,3075,0.662,-1225,2462.5,"Con",-20,-50,TRUE,FALSE,FALSE,39.84,"young",43,185,90,"m"
22,"LEG PRESS",1,"Con10",1660,1680,2900,2950,1670,2925,0.751,-1255,2297.5,"Con",-20,-50,TRUE,FALSE,FALSE,42.91,"young",43,185,90,"m"
22,"LEG PRESS",2,"Con01",2020,2000,1750,1850,2010,1800,0.104,210,1905,"Con",20,-100,FALSE,FALSE,FALSE,11.67,"young",43,185,90,"m"
22,"LEG PRESS",2,"Con02",1480,1480,1750,1600,1480,1675,0.132,-195,1577.5,"Con",0,150,FALSE,FALSE,FALSE,11.64,"young",43,185,90,"m"
22,"LEG PRESS",2,"Con03",1500,1540,2000,1850,1520,1925,0.266,-405,1722.5,"Con",-40,150,TRUE,FALSE,FALSE,21.04,"young",43,185,90,"m"
22,"LEG PRESS",2,"Con04",2260,2280,2200,2250,2270,2225,0.02,45,2247.5,"Con",-20,-50,FALSE,FALSE,FALSE,2.02,"young",43,185,90,"m"
22,"LEG PRESS",2,"Con05",1520,1520,1700,1650,1520,1675,0.102,-155,1597.5,"Con",0,50,FALSE,FALSE,FALSE,9.25,"young",43,185,90,"m"
22,"LEG PRESS",2,"Con06",1740,1720,1800,2150,1730,1975,0.142,-245,1852.5,"Con",20,-350,FALSE,FALSE,TRUE,12.41,"young",43,185,90,"m"
22,"LEG PRESS",2,"Con07",1740,1760,2350,2450,1750,2400,0.371,-650,2075,"Con",-20,-100,TRUE,FALSE,FALSE,27.08,"young",43,185,90,"m"
22,"LEG PRESS",2,"Con08",1640,1640,2500,2400,1640,2450,0.494,-810,2045,"Con",0,100,TRUE,FALSE,FALSE,33.06,"young",43,185,90,"m"
22,"LEG PRESS",2,"Con09",1960,1920,2700,2700,1940,2700,0.392,-760,2320,"Con",40,0,TRUE,FALSE,FALSE,28.15,"young",43,185,90,"m"
22,"LEG PRESS",2,"Con10",1620,1600,2750,2850,1610,2800,0.739,-1190,2205,"Con",20,-100,TRUE,FALSE,FALSE,42.5,"young",43,185,90,"m"
22,"LEG PRESS",1,"Ecc01",3020,3000,2950,3000,3010,2975,0.012,35,2992.5,"Ecc",20,-50,FALSE,FALSE,FALSE,1.18,"young",43,185,90,"m"
22,"LEG PRESS",1,"Ecc02",3100,3140,3200,3150,3120,3175,0.018,-55,3147.5,"Ecc",-40,50,FALSE,FALSE,FALSE,1.73,"young",43,185,90,"m"
22,"LEG PRESS",1,"Ecc03",3260,3260,3150,3150,3260,3150,0.034,110,3205,"Ecc",0,0,FALSE,FALSE,FALSE,3.49,"young",43,185,90,"m"
22,"LEG PRESS",1,"Ecc04",3480,3460,3400,3300,3470,3350,0.035,120,3410,"Ecc",20,100,FALSE,FALSE,FALSE,3.58,"young",43,185,90,"m"
22,"LEG PRESS",1,"Ecc05",3660,3600,3450,3400,3630,3425,0.056,205,3527.5,"Ecc",60,50,FALSE,FALSE,FALSE,5.99,"young",43,185,90,"m"
22,"LEG PRESS",1,"Ecc06",3660,3680,3350,3500,3670,3425,0.067,245,3547.5,"Ecc",-20,-150,FALSE,FALSE,FALSE,7.15,"young",43,185,90,"m"
22,"LEG PRESS",1,"Ecc07",3480,3520,2600,2900,3500,2750,0.214,750,3125,"Ecc",-40,-300,TRUE,FALSE,TRUE,27.27,"young",43,185,90,"m"
22,"LEG PRESS",1,"Ecc08",3340,3380,2550,2500,3360,2525,0.249,835,2942.5,"Ecc",-40,50,TRUE,FALSE,FALSE,33.07,"young",43,185,90,"m"
22,"LEG PRESS",1,"Ecc09",3480,3420,2250,2150,3450,2200,0.362,1250,2825,"Ecc",60,100,TRUE,FALSE,FALSE,56.82,"young",43,185,90,"m"
22,"LEG PRESS",1,"Ecc10",3220,3220,2650,3300,3220,2975,0.076,245,3097.5,"Ecc",0,-650,FALSE,FALSE,TRUE,8.24,"young",43,185,90,"m"
22,"LEG PRESS",2,"Ecc01",2520,2520,2700,2650,2520,2675,0.062,-155,2597.5,"Ecc",0,50,FALSE,FALSE,FALSE,5.79,"young",43,185,90,"m"
22,"LEG PRESS",2,"Ecc02",2700,2680,2450,2550,2690,2500,0.071,190,2595,"Ecc",20,-100,FALSE,FALSE,FALSE,7.6,"young",43,185,90,"m"
22,"LEG PRESS",2,"Ecc03",3340,3300,2750,2950,3320,2850,0.142,470,3085,"Ecc",40,-200,TRUE,FALSE,TRUE,16.49,"young",43,185,90,"m"
22,"LEG PRESS",2,"Ecc04",2640,2640,2800,2700,2640,2750,0.042,-110,2695,"Ecc",0,100,FALSE,FALSE,FALSE,4,"young",43,185,90,"m"
22,"LEG PRESS",2,"Ecc05",3460,3460,3350,3400,3460,3375,0.025,85,3417.5,"Ecc",0,-50,FALSE,FALSE,FALSE,2.52,"young",43,185,90,"m"
22,"LEG PRESS",2,"Ecc06",3460,3500,3200,2900,3480,3050,0.124,430,3265,"Ecc",-40,300,TRUE,FALSE,TRUE,14.1,"young",43,185,90,"m"
22,"LEG PRESS",2,"Ecc07",3780,3740,3150,3000,3760,3075,0.182,685,3417.5,"Ecc",40,150,TRUE,FALSE,FALSE,22.28,"young",43,185,90,"m"
22,"LEG PRESS",2,"Ecc08",3440,3440,2650,2800,3440,2725,0.208,715,3082.5,"Ecc",0,-150,TRUE,FALSE,FALSE,26.24,"young",43,185,90,"m"
22,"LEG PRESS",2,"Ecc09",3620,3660,2600,2500,3640,2550,0.299,1090,3095,"Ecc",-40,100,TRUE,FALSE,FALSE,42.75,"young",43,185,90,"m"
22,"LEG PRESS",2,"Ecc10",3880,3880,3850,3750,3880,3800,0.021,80,3840,"Ecc",0,100,FALSE,FALSE,FALSE,2.11,"young",43,185,90,"m"
22,"LEG PRESS",1,"Rep01",5340,5320,5550,5550,5330,5550,0.041,-220,5440,"Rep",20,0,TRUE,FALSE,FALSE,3.96,"young",43,185,90,"m"
22,"LEG PRESS",1,"Rep02",5040,5060,5050,5000,5050,5025,0.005,25,5037.5,"Rep",-20,50,FALSE,FALSE,FALSE,0.5,"young",43,185,90,"m"
22,"LEG PRESS",1,"Rep03",5040,5040,4950,5000,5040,4975,0.013,65,5007.5,"Rep",0,-50,FALSE,FALSE,FALSE,1.31,"young",43,185,90,"m"
22,"LEG PRESS",1,"Rep04",5480,5440,5450,5350,5460,5400,0.011,60,5430,"Rep",40,100,FALSE,FALSE,TRUE,1.11,"young",43,185,90,"m"
22,"LEG PRESS",1,"Rep05",5760,5760,5700,5750,5760,5725,0.006,35,5742.5,"Rep",0,-50,FALSE,FALSE,FALSE,0.61,"young",43,185,90,"m"
22,"LEG PRESS",1,"Rep06",5920,5940,5800,6000,5930,5900,0.005,30,5915,"Rep",-20,-200,FALSE,FALSE,TRUE,0.51,"young",43,185,90,"m"
22,"LEG PRESS",1,"Rep07",5280,5280,5100,4950,5280,5025,0.048,255,5152.5,"Rep",0,150,TRUE,FALSE,TRUE,5.07,"young",43,185,90,"m"
22,"LEG PRESS",1,"Rep08",5480,5500,5350,5300,5490,5325,0.03,165,5407.5,"Rep",-20,50,TRUE,FALSE,FALSE,3.1,"young",43,185,90,"m"
22,"LEG PRESS",1,"Rep09",5320,5280,5300,5250,5300,5275,0.005,25,5287.5,"Rep",40,50,FALSE,FALSE,FALSE,0.47,"young",43,185,90,"m"
22,"LEG PRESS",1,"Rep10",4880,4900,5550,6250,4890,5900,0.207,-1010,5395,"Rep",-20,-700,TRUE,FALSE,TRUE,17.12,"young",43,185,90,"m"
22,"LEG PRESS",2,"Rep01",4540,4520,4450,4500,4530,4475,0.012,55,4502.5,"Rep",20,-50,FALSE,FALSE,FALSE,1.23,"young",43,185,90,"m"
22,"LEG PRESS",2,"Rep02",4180,4160,4200,4150,4170,4175,0.001,-5,4172.5,"Rep",20,50,FALSE,FALSE,FALSE,0.12,"young",43,185,90,"m"
22,"LEG PRESS",2,"Rep03",4840,4840,4750,4800,4840,4775,0.013,65,4807.5,"Rep",0,-50,FALSE,FALSE,FALSE,1.36,"young",43,185,90,"m"
22,"LEG PRESS",2,"Rep04",4900,4920,5000,4950,4910,4975,0.013,-65,4942.5,"Rep",-20,50,FALSE,FALSE,FALSE,1.31,"young",43,185,90,"m"
22,"LEG PRESS",2,"Rep05",4980,4980,5050,5050,4980,5050,0.014,-70,5015,"Rep",0,0,FALSE,FALSE,FALSE,1.39,"young",43,185,90,"m"
22,"LEG PRESS",2,"Rep06",5200,5220,5000,5050,5210,5025,0.036,185,5117.5,"Rep",-20,-50,TRUE,FALSE,FALSE,3.68,"young",43,185,90,"m"
22,"LEG PRESS",2,"Rep07",5520,5500,5500,5450,5510,5475,0.006,35,5492.5,"Rep",20,50,FALSE,FALSE,FALSE,0.64,"young",43,185,90,"m"
22,"LEG PRESS",2,"Rep08",5080,5080,5150,5200,5080,5175,0.019,-95,5127.5,"Rep",0,-50,FALSE,FALSE,FALSE,1.84,"young",43,185,90,"m"
22,"LEG PRESS",2,"Rep09",5580,5580,5300,5200,5580,5250,0.059,330,5415,"Rep",0,100,TRUE,FALSE,TRUE,6.29,"young",43,185,90,"m"
22,"LEG PRESS",2,"Rep10",5500,5480,6600,6600,5490,6600,0.202,-1110,6045,"Rep",20,0,TRUE,FALSE,FALSE,16.82,"young",43,185,90,"m"
22,"LEG PRESS",1,"TuT",53540,53520,53800,54400,53530,54100,0.011,-570,53815,"TuT",20,-600,FALSE,FALSE,TRUE,1.05,"young",43,185,90,"m"
22,"LEG PRESS",2,"TuT",50320,50280,51000,50950,50300,50975,0.013,-675,50637.5,"TuT",40,50,TRUE,FALSE,FALSE,1.32,"young",43,185,90,"m"
22,"LEG EXTENSION",1,"Con01",2240,2220,2350,2450,2230,2400,0.076,-170,2315,"Con",20,-100,FALSE,FALSE,FALSE,7.08,"young",43,185,90,"m"
22,"LEG EXTENSION",1,"Con02",1600,1600,1750,1750,1600,1750,0.094,-150,1675,"Con",0,0,FALSE,FALSE,FALSE,8.57,"young",43,185,90,"m"
22,"LEG EXTENSION",1,"Con03",1680,1700,2500,2000,1690,2250,0.331,-560,1970,"Con",-20,500,TRUE,FALSE,TRUE,24.89,"young",43,185,90,"m"
22,"LEG EXTENSION",1,"Con04",1520,1520,1850,1750,1520,1800,0.184,-280,1660,"Con",0,100,TRUE,FALSE,FALSE,15.56,"young",43,185,90,"m"
22,"LEG EXTENSION",1,"Con05",1440,1440,1650,1550,1440,1600,0.111,-160,1520,"Con",0,100,FALSE,FALSE,FALSE,10,"young",43,185,90,"m"
22,"LEG EXTENSION",1,"Con06",1520,1520,1600,1600,1520,1600,0.053,-80,1560,"Con",0,0,FALSE,FALSE,FALSE,5,"young",43,185,90,"m"
22,"LEG EXTENSION",1,"Con07",1400,1420,1550,1650,1410,1600,0.135,-190,1505,"Con",-20,-100,TRUE,FALSE,FALSE,11.88,"young",43,185,90,"m"
22,"LEG EXTENSION",1,"Con08",1360,1400,1650,1700,1380,1675,0.214,-295,1527.5,"Con",-40,-50,TRUE,TRUE,FALSE,17.61,"young",43,185,90,"m"
22,"LEG EXTENSION",1,"Con09",1600,1600,1800,2350,1600,2075,0.297,-475,1837.5,"Con",0,-550,TRUE,FALSE,TRUE,22.89,"young",43,185,90,"m"
22,"LEG EXTENSION",1,"Con10",1400,1400,2800,2900,1400,2850,1.036,-1450,2125,"Con",0,-100,TRUE,FALSE,FALSE,50.88,"young",43,185,90,"m"
22,"LEG EXTENSION",2,"Con01",1960,1960,2000,2000,1960,2000,0.02,-40,1980,"Con",0,0,FALSE,FALSE,FALSE,2,"young",43,185,90,"m"
22,"LEG EXTENSION",2,"Con02",1500,1540,1600,2250,1520,1925,0.266,-405,1722.5,"Con",-40,-650,TRUE,TRUE,TRUE,21.04,"young",43,185,90,"m"
22,"LEG EXTENSION",2,"Con03",1360,1320,1400,1450,1340,1425,0.063,-85,1382.5,"Con",40,-50,FALSE,TRUE,FALSE,5.96,"young",43,185,90,"m"
22,"LEG EXTENSION",2,"Con04",1240,1240,1400,1350,1240,1375,0.109,-135,1307.5,"Con",0,50,FALSE,FALSE,FALSE,9.82,"young",43,185,90,"m"
22,"LEG EXTENSION",2,"Con05",1200,1180,1400,1350,1190,1375,0.155,-185,1282.5,"Con",20,50,TRUE,FALSE,FALSE,13.45,"young",43,185,90,"m"
22,"LEG EXTENSION",2,"Con06",1520,1500,2300,2400,1510,2350,0.556,-840,1930,"Con",20,-100,TRUE,FALSE,FALSE,35.74,"young",43,185,90,"m"
22,"LEG EXTENSION",2,"Con07",1640,1660,1950,1850,1650,1900,0.152,-250,1775,"Con",-20,100,TRUE,FALSE,FALSE,13.16,"young",43,185,90,"m"
22,"LEG EXTENSION",2,"Con08",1340,1360,1600,1550,1350,1575,0.167,-225,1462.5,"Con",-20,50,TRUE,FALSE,FALSE,14.29,"young",43,185,90,"m"
22,"LEG EXTENSION",2,"Con09",1400,1400,1600,2500,1400,2050,0.464,-650,1725,"Con",0,-900,TRUE,FALSE,TRUE,31.71,"young",43,185,90,"m"
22,"LEG EXTENSION",2,"Con10",1280,1240,2650,2850,1260,2750,1.183,-1490,2005,"Con",40,-200,TRUE,TRUE,TRUE,54.18,"young",43,185,90,"m"
22,"LEG EXTENSION",1,"Ecc01",3600,3580,3450,3400,3590,3425,0.046,165,3507.5,"Ecc",20,50,FALSE,FALSE,FALSE,4.82,"young",43,185,90,"m"
22,"LEG EXTENSION",1,"Ecc02",3040,3060,2800,2800,3050,2800,0.082,250,2925,"Ecc",-20,0,TRUE,FALSE,FALSE,8.93,"young",43,185,90,"m"
22,"LEG EXTENSION",1,"Ecc03",3420,3400,2650,3150,3410,2900,0.15,510,3155,"Ecc",20,-500,TRUE,FALSE,TRUE,17.59,"young",43,185,90,"m"
22,"LEG EXTENSION",1,"Ecc04",3300,3300,3000,3100,3300,3050,0.076,250,3175,"Ecc",0,-100,TRUE,FALSE,FALSE,8.2,"young",43,185,90,"m"
22,"LEG EXTENSION",1,"Ecc05",3380,3380,3200,3250,3380,3225,0.046,155,3302.5,"Ecc",0,-50,FALSE,FALSE,FALSE,4.81,"young",43,185,90,"m"
22,"LEG EXTENSION",1,"Ecc06",3560,3540,3500,3450,3550,3475,0.021,75,3512.5,"Ecc",20,50,FALSE,FALSE,FALSE,2.16,"young",43,185,90,"m"
22,"LEG EXTENSION",1,"Ecc07",3640,3620,3400,3300,3630,3350,0.077,280,3490,"Ecc",20,100,TRUE,FALSE,FALSE,8.36,"young",43,185,90,"m"
22,"LEG EXTENSION",1,"Ecc08",3640,3620,3400,3400,3630,3400,0.063,230,3515,"Ecc",20,0,TRUE,FALSE,FALSE,6.76,"young",43,185,90,"m"
22,"LEG EXTENSION",1,"Ecc09",3440,3420,2650,2100,3430,2375,0.308,1055,2902.5,"Ecc",20,550,TRUE,FALSE,TRUE,44.42,"young",43,185,90,"m"
22,"LEG EXTENSION",1,"Ecc10",3020,3040,2350,2250,3030,2300,0.241,730,2665,"Ecc",-20,100,TRUE,FALSE,FALSE,31.74,"young",43,185,90,"m"
22,"LEG EXTENSION",2,"Ecc01",2500,2480,2550,2500,2490,2525,0.014,-35,2507.5,"Ecc",20,50,FALSE,FALSE,FALSE,1.39,"young",43,185,90,"m"
22,"LEG EXTENSION",2,"Ecc02",3120,3120,3050,2400,3120,2725,0.127,395,2922.5,"Ecc",0,650,TRUE,FALSE,TRUE,14.5,"young",43,185,90,"m"
22,"LEG EXTENSION",2,"Ecc03",3100,3120,2950,2950,3110,2950,0.051,160,3030,"Ecc",-20,0,FALSE,FALSE,FALSE,5.42,"young",43,185,90,"m"
22,"LEG EXTENSION",2,"Ecc04",3380,3380,3150,3250,3380,3200,0.053,180,3290,"Ecc",0,-100,FALSE,FALSE,FALSE,5.62,"young",43,185,90,"m"
22,"LEG EXTENSION",2,"Ecc05",3300,3320,3150,2500,3310,2825,0.147,485,3067.5,"Ecc",-20,650,TRUE,FALSE,TRUE,17.17,"young",43,185,90,"m"
22,"LEG EXTENSION",2,"Ecc06",3200,3200,2400,3000,3200,2700,0.156,500,2950,"Ecc",0,-600,TRUE,FALSE,TRUE,18.52,"young",43,185,90,"m"
22,"LEG EXTENSION",2,"Ecc07",3520,3500,3150,3250,3510,3200,0.088,310,3355,"Ecc",20,-100,TRUE,FALSE,FALSE,9.69,"young",43,185,90,"m"
22,"LEG EXTENSION",2,"Ecc08",2980,2980,2800,2750,2980,2775,0.069,205,2877.5,"Ecc",0,50,TRUE,FALSE,FALSE,7.39,"young",43,185,90,"m"
22,"LEG EXTENSION",2,"Ecc09",3580,3600,2800,1700,3590,2250,0.373,1340,2920,"Ecc",-20,1100,TRUE,FALSE,TRUE,59.56,"young",43,185,90,"m"
22,"LEG EXTENSION",2,"Ecc10",2800,2820,2200,2250,2810,2225,0.208,585,2517.5,"Ecc",-20,-50,TRUE,FALSE,FALSE,26.29,"young",43,185,90,"m"
22,"LEG EXTENSION",1,"Rep01",5840,5800,5800,5850,5820,5825,0.001,-5,5822.5,"Rep",40,-50,FALSE,FALSE,FALSE,0.09,"young",43,185,90,"m"
22,"LEG EXTENSION",1,"Rep02",4640,4660,4550,4550,4650,4550,0.022,100,4600,"Rep",-20,0,FALSE,FALSE,FALSE,2.2,"young",43,185,90,"m"
22,"LEG EXTENSION",1,"Rep03",5100,5100,5150,5150,5100,5150,0.01,-50,5125,"Rep",0,0,FALSE,FALSE,FALSE,0.97,"young",43,185,90,"m"
22,"LEG EXTENSION",1,"Rep04",4820,4820,4850,4850,4820,4850,0.006,-30,4835,"Rep",0,0,FALSE,FALSE,FALSE,0.62,"young",43,185,90,"m"
22,"LEG EXTENSION",1,"Rep05",4820,4820,4850,4800,4820,4825,0.001,-5,4822.5,"Rep",0,50,FALSE,FALSE,FALSE,0.1,"young",43,185,90,"m"
22,"LEG EXTENSION",1,"Rep06",5080,5060,5100,5050,5070,5075,0.001,-5,5072.5,"Rep",20,50,FALSE,FALSE,FALSE,0.1,"young",43,185,90,"m"
22,"LEG EXTENSION",1,"Rep07",5040,5040,4950,4950,5040,4950,0.018,90,4995,"Rep",0,0,FALSE,FALSE,FALSE,1.82,"young",43,185,90,"m"
22,"LEG EXTENSION",1,"Rep08",5000,5020,5050,5100,5010,5075,0.013,-65,5042.5,"Rep",-20,-50,FALSE,FALSE,FALSE,1.28,"young",43,185,90,"m"
22,"LEG EXTENSION",1,"Rep09",5040,5020,4450,4450,5030,4450,0.115,580,4740,"Rep",20,0,TRUE,FALSE,FALSE,13.03,"young",43,185,90,"m"
22,"LEG EXTENSION",1,"Rep10",4420,4440,5150,5150,4430,5150,0.163,-720,4790,"Rep",-20,0,TRUE,FALSE,FALSE,13.98,"young",43,185,90,"m"
22,"LEG EXTENSION",2,"Rep01",4460,4440,4550,4500,4450,4525,0.017,-75,4487.5,"Rep",20,50,FALSE,FALSE,FALSE,1.66,"young",43,185,90,"m"
22,"LEG EXTENSION",2,"Rep02",4620,4660,4650,4650,4640,4650,0.002,-10,4645,"Rep",-40,0,FALSE,FALSE,FALSE,0.22,"young",43,185,90,"m"
22,"LEG EXTENSION",2,"Rep03",4460,4440,4350,4400,4450,4375,0.017,75,4412.5,"Rep",20,-50,FALSE,FALSE,FALSE,1.71,"young",43,185,90,"m"
22,"LEG EXTENSION",2,"Rep04",4620,4620,4550,4600,4620,4575,0.01,45,4597.5,"Rep",0,-50,FALSE,FALSE,FALSE,0.98,"young",43,185,90,"m"
22,"LEG EXTENSION",2,"Rep05",4500,4500,4550,3850,4500,4200,0.067,300,4350,"Rep",0,700,TRUE,FALSE,TRUE,7.14,"young",43,185,90,"m"
22,"LEG EXTENSION",2,"Rep06",4720,4700,4700,5400,4710,5050,0.072,-340,4880,"Rep",20,-700,TRUE,FALSE,TRUE,6.73,"young",43,185,90,"m"
22,"LEG EXTENSION",2,"Rep07",5160,5160,5100,5100,5160,5100,0.012,60,5130,"Rep",0,0,FALSE,FALSE,FALSE,1.18,"young",43,185,90,"m"
22,"LEG EXTENSION",2,"Rep08",4320,4340,4400,4300,4330,4350,0.005,-20,4340,"Rep",-20,100,FALSE,FALSE,FALSE,0.46,"young",43,185,90,"m"
22,"LEG EXTENSION",2,"Rep09",4980,5000,4400,4200,4990,4300,0.138,690,4645,"Rep",-20,200,TRUE,FALSE,TRUE,16.05,"young",43,185,90,"m"
22,"LEG EXTENSION",2,"Rep10",4080,4060,4850,5100,4070,4975,0.222,-905,4522.5,"Rep",20,-250,TRUE,FALSE,TRUE,18.19,"young",43,185,90,"m"
22,"LEG EXTENSION",1,"TuT",49800,49780,49900,49900,49790,49900,0.002,-110,49845,"TuT",20,0,FALSE,FALSE,FALSE,0.22,"young",43,185,90,"m"
22,"LEG EXTENSION",2,"TuT",45920,45920,46100,46100,45920,46100,0.004,-180,46010,"TuT",0,0,TRUE,FALSE,FALSE,0.39,"young",43,185,90,"m"
22,"LEG CURL",1,"Con01",3100,3120,2850,2900,3110,2875,0.076,235,2992.5,"Con",-20,-50,TRUE,FALSE,FALSE,8.17,"young",43,185,90,"m"
22,"LEG CURL",1,"Con02",2700,2660,2800,2850,2680,2825,0.054,-145,2752.5,"Con",40,-50,FALSE,FALSE,FALSE,5.13,"young",43,185,90,"m"
22,"LEG CURL",1,"Con03",2440,2440,2800,2400,2440,2600,0.066,-160,2520,"Con",0,400,FALSE,FALSE,TRUE,6.15,"young",43,185,90,"m"
22,"LEG CURL",1,"Con04",2360,2320,2450,2400,2340,2425,0.036,-85,2382.5,"Con",40,50,FALSE,FALSE,FALSE,3.51,"young",43,185,90,"m"
22,"LEG CURL",1,"Con05",2260,2220,2400,2450,2240,2425,0.083,-185,2332.5,"Con",40,-50,FALSE,FALSE,FALSE,7.63,"young",43,185,90,"m"
22,"LEG CURL",1,"Con06",2420,2440,2600,2600,2430,2600,0.07,-170,2515,"Con",-20,0,FALSE,FALSE,FALSE,6.54,"young",43,185,90,"m"
22,"LEG CURL",1,"Con07",2180,2140,2400,2300,2160,2350,0.088,-190,2255,"Con",40,100,FALSE,FALSE,FALSE,8.09,"young",43,185,90,"m"
22,"LEG CURL",1,"Con08",2200,2200,2400,2400,2200,2400,0.091,-200,2300,"Con",0,0,FALSE,FALSE,FALSE,8.33,"young",43,185,90,"m"
22,"LEG CURL",1,"Con09",2280,2220,2500,2500,2250,2500,0.111,-250,2375,"Con",60,0,TRUE,FALSE,FALSE,10,"young",43,185,90,"m"
22,"LEG CURL",1,"Con10",2420,2420,3400,3250,2420,3325,0.374,-905,2872.5,"Con",0,150,TRUE,FALSE,FALSE,27.22,"young",43,185,90,"m"
22,"LEG CURL",2,"Con01",2260,2240,2250,2350,2250,2300,0.022,-50,2275,"Con",20,-100,FALSE,FALSE,FALSE,2.17,"young",43,185,90,"m"
22,"LEG CURL",2,"Con02",1940,1940,1950,2100,1940,2025,0.044,-85,1982.5,"Con",0,-150,FALSE,FALSE,FALSE,4.2,"young",43,185,90,"m"
22,"LEG CURL",2,"Con03",2200,2140,2200,2250,2170,2225,0.025,-55,2197.5,"Con",60,-50,FALSE,FALSE,FALSE,2.47,"young",43,185,90,"m"
22,"LEG CURL",2,"Con04",1960,1940,2000,1950,1950,1975,0.013,-25,1962.5,"Con",20,50,FALSE,FALSE,FALSE,1.27,"young",43,185,90,"m"
22,"LEG CURL",2,"Con05",1880,1900,1900,1950,1890,1925,0.019,-35,1907.5,"Con",-20,-50,FALSE,FALSE,FALSE,1.82,"young",43,185,90,"m"
22,"LEG CURL",2,"Con06",2260,2200,2250,2200,2230,2225,0.002,5,2227.5,"Con",60,50,FALSE,FALSE,FALSE,0.22,"young",43,185,90,"m"
22,"LEG CURL",2,"Con07",1980,1960,2150,2050,1970,2100,0.066,-130,2035,"Con",20,100,FALSE,FALSE,FALSE,6.19,"young",43,185,90,"m"
22,"LEG CURL",2,"Con08",2100,2100,2350,2300,2100,2325,0.107,-225,2212.5,"Con",0,50,FALSE,FALSE,FALSE,9.68,"young",43,185,90,"m"
22,"LEG CURL",2,"Con09",2020,2020,2550,2650,2020,2600,0.287,-580,2310,"Con",0,-100,TRUE,FALSE,FALSE,22.31,"young",43,185,90,"m"
22,"LEG CURL",2,"Con10",1820,1860,3300,3650,1840,3475,0.889,-1635,2657.5,"Con",-40,-350,TRUE,FALSE,TRUE,47.05,"young",43,185,90,"m"
22,"LEG CURL",1,"Ecc01",4060,4120,4200,4050,4090,4125,0.009,-35,4107.5,"Ecc",-60,150,FALSE,FALSE,FALSE,0.85,"young",43,185,90,"m"
22,"LEG CURL",1,"Ecc02",3780,3740,3700,3750,3760,3725,0.009,35,3742.5,"Ecc",40,-50,FALSE,FALSE,FALSE,0.94,"young",43,185,90,"m"
22,"LEG CURL",1,"Ecc03",4560,4600,4100,4500,4580,4300,0.061,280,4440,"Ecc",-40,-400,TRUE,FALSE,TRUE,6.51,"young",43,185,90,"m"
22,"LEG CURL",1,"Ecc04",4620,4660,4550,4450,4640,4500,0.03,140,4570,"Ecc",-40,100,FALSE,FALSE,FALSE,3.11,"young",43,185,90,"m"
22,"LEG CURL",1,"Ecc05",4960,4980,4900,4800,4970,4850,0.024,120,4910,"Ecc",-20,100,FALSE,FALSE,FALSE,2.47,"young",43,185,90,"m"
22,"LEG CURL",1,"Ecc06",5280,5300,5000,5200,5290,5100,0.036,190,5195,"Ecc",-20,-200,FALSE,FALSE,TRUE,3.73,"young",43,185,90,"m"
22,"LEG CURL",1,"Ecc07",4320,4340,4100,4150,4330,4125,0.047,205,4227.5,"Ecc",-20,-50,FALSE,FALSE,FALSE,4.97,"young",43,185,90,"m"
22,"LEG CURL",1,"Ecc08",4400,4440,4150,4100,4420,4125,0.067,295,4272.5,"Ecc",-40,50,TRUE,FALSE,FALSE,7.15,"young",43,185,90,"m"
22,"LEG CURL",1,"Ecc09",4320,4320,4000,4100,4320,4050,0.062,270,4185,"Ecc",0,-100,TRUE,FALSE,FALSE,6.67,"young",43,185,90,"m"
22,"LEG CURL",1,"Ecc10",4400,4400,3650,3700,4400,3675,0.165,725,4037.5,"Ecc",0,-50,TRUE,FALSE,FALSE,19.73,"young",43,185,90,"m"
22,"LEG CURL",2,"Ecc01",3900,3920,3900,3750,3910,3825,0.022,85,3867.5,"Ecc",-20,150,FALSE,FALSE,FALSE,2.22,"young",43,185,90,"m"
22,"LEG CURL",2,"Ecc02",4000,4020,4000,3950,4010,3975,0.009,35,3992.5,"Ecc",-20,50,FALSE,FALSE,FALSE,0.88,"young",43,185,90,"m"
22,"LEG CURL",2,"Ecc03",3420,3460,3400,3400,3440,3400,0.012,40,3420,"Ecc",-40,0,FALSE,FALSE,FALSE,1.18,"young",43,185,90,"m"
22,"LEG CURL",2,"Ecc04",3460,3460,3400,3400,3460,3400,0.017,60,3430,"Ecc",0,0,FALSE,FALSE,FALSE,1.76,"young",43,185,90,"m"
22,"LEG CURL",2,"Ecc05",4100,4140,4150,4150,4120,4150,0.007,-30,4135,"Ecc",-40,0,FALSE,FALSE,FALSE,0.72,"young",43,185,90,"m"
22,"LEG CURL",2,"Ecc06",3760,3780,3600,3700,3770,3650,0.032,120,3710,"Ecc",-20,-100,FALSE,FALSE,FALSE,3.29,"young",43,185,90,"m"
22,"LEG CURL",2,"Ecc07",3820,3820,3600,3700,3820,3650,0.045,170,3735,"Ecc",0,-100,FALSE,FALSE,FALSE,4.66,"young",43,185,90,"m"
22,"LEG CURL",2,"Ecc08",4500,4500,3950,3850,4500,3900,0.133,600,4200,"Ecc",0,100,TRUE,FALSE,FALSE,15.38,"young",43,185,90,"m"
22,"LEG CURL",2,"Ecc09",4400,4380,3850,3450,4390,3650,0.169,740,4020,"Ecc",20,400,TRUE,FALSE,TRUE,20.27,"young",43,185,90,"m"
22,"LEG CURL",2,"Ecc10",4400,4400,3400,3450,4400,3425,0.222,975,3912.5,"Ecc",0,-50,TRUE,FALSE,FALSE,28.47,"young",43,185,90,"m"
22,"LEG CURL",1,"Rep01",7160,7240,7050,6950,7200,7000,0.028,200,7100,"Rep",-80,100,TRUE,TRUE,FALSE,2.86,"young",43,185,90,"m"
22,"LEG CURL",1,"Rep02",6480,6400,6500,6600,6440,6550,0.017,-110,6495,"Rep",80,-100,FALSE,TRUE,FALSE,1.68,"young",43,185,90,"m"
22,"LEG CURL",1,"Rep03",7000,7040,6900,6900,7020,6900,0.017,120,6960,"Rep",-40,0,FALSE,FALSE,FALSE,1.74,"young",43,185,90,"m"
22,"LEG CURL",1,"Rep04",6980,6980,7000,6850,6980,6925,0.008,55,6952.5,"Rep",0,150,FALSE,FALSE,FALSE,0.79,"young",43,185,90,"m"
22,"LEG CURL",1,"Rep05",7220,7200,7300,7250,7210,7275,0.009,-65,7242.5,"Rep",20,50,FALSE,FALSE,FALSE,0.89,"young",43,185,90,"m"
22,"LEG CURL",1,"Rep06",7700,7740,7600,7800,7720,7700,0.003,20,7710,"Rep",-40,-200,FALSE,FALSE,TRUE,0.26,"young",43,185,90,"m"
22,"LEG CURL",1,"Rep07",6500,6480,6500,6450,6490,6475,0.002,15,6482.5,"Rep",20,50,FALSE,FALSE,FALSE,0.23,"young",43,185,90,"m"
22,"LEG CURL",1,"Rep08",6600,6640,6550,6500,6620,6525,0.014,95,6572.5,"Rep",-40,50,FALSE,FALSE,FALSE,1.46,"young",43,185,90,"m"
22,"LEG CURL",1,"Rep09",6600,6540,6500,6600,6570,6550,0.003,20,6560,"Rep",60,-100,FALSE,FALSE,FALSE,0.31,"young",43,185,90,"m"
22,"LEG CURL",1,"Rep10",6820,6820,7050,6950,6820,7000,0.026,-180,6910,"Rep",0,100,TRUE,FALSE,FALSE,2.57,"young",43,185,90,"m"
22,"LEG CURL",2,"Rep01",6160,6160,6150,6100,6160,6125,0.006,35,6142.5,"Rep",0,50,FALSE,FALSE,FALSE,0.57,"young",43,185,90,"m"
22,"LEG CURL",2,"Rep02",5940,5960,5950,6050,5950,6000,0.008,-50,5975,"Rep",-20,-100,FALSE,FALSE,FALSE,0.83,"young",43,185,90,"m"
22,"LEG CURL",2,"Rep03",5620,5600,5600,5650,5610,5625,0.003,-15,5617.5,"Rep",20,-50,FALSE,FALSE,FALSE,0.27,"young",43,185,90,"m"
22,"LEG CURL",2,"Rep04",5420,5400,5400,5350,5410,5375,0.006,35,5392.5,"Rep",20,50,FALSE,FALSE,FALSE,0.65,"young",43,185,90,"m"
22,"LEG CURL",2,"Rep05",5980,6040,6050,6100,6010,6075,0.011,-65,6042.5,"Rep",-60,-50,FALSE,FALSE,FALSE,1.07,"young",43,185,90,"m"
22,"LEG CURL",2,"Rep06",6020,5980,5850,5900,6000,5875,0.021,125,5937.5,"Rep",40,-50,FALSE,FALSE,FALSE,2.13,"young",43,185,90,"m"
22,"LEG CURL",2,"Rep07",5800,5780,5750,5750,5790,5750,0.007,40,5770,"Rep",20,0,FALSE,FALSE,FALSE,0.7,"young",43,185,90,"m"
22,"LEG CURL",2,"Rep08",6600,6600,6300,6150,6600,6225,0.057,375,6412.5,"Rep",0,150,TRUE,FALSE,FALSE,6.02,"young",43,185,90,"m"
22,"LEG CURL",2,"Rep09",6420,6400,6400,6100,6410,6250,0.025,160,6330,"Rep",20,300,TRUE,FALSE,TRUE,2.56,"young",43,185,90,"m"
22,"LEG CURL",2,"Rep10",6220,6260,6700,7100,6240,6900,0.106,-660,6570,"Rep",-40,-400,TRUE,FALSE,TRUE,9.57,"young",43,185,90,"m"
22,"LEG CURL",1,"TuT",69060,69080,68950,68850,69070,68900,0.002,170,68985,"TuT",-20,100,FALSE,FALSE,FALSE,0.25,"young",43,185,90,"m"
22,"LEG CURL",2,"TuT",60180,60180,60150,60250,60180,60200,0,-20,60190,"TuT",0,-100,FALSE,FALSE,FALSE,0.03,"young",43,185,90,"m"
22,"ABDUCTOR",1,"Con01",1560,1540,1800,1600,1550,1700,0.097,-150,1625,"Con",20,200,FALSE,FALSE,FALSE,8.82,"young",43,185,90,"m"
22,"ABDUCTOR",1,"Con02",1000,1000,1550,1550,1000,1550,0.55,-550,1275,"Con",0,0,TRUE,FALSE,FALSE,35.48,"young",43,185,90,"m"
22,"ABDUCTOR",1,"Con03",1160,1140,1400,1750,1150,1575,0.37,-425,1362.5,"Con",20,-350,TRUE,FALSE,TRUE,26.98,"young",43,185,90,"m"
22,"ABDUCTOR",1,"Con04",1180,1200,1300,1400,1190,1350,0.134,-160,1270,"Con",-20,-100,FALSE,FALSE,FALSE,11.85,"young",43,185,90,"m"
22,"ABDUCTOR",1,"Con05",1420,1440,1400,1350,1430,1375,0.038,55,1402.5,"Con",-20,50,FALSE,FALSE,FALSE,4,"young",43,185,90,"m"
22,"ABDUCTOR",1,"Con06",1220,1160,1550,1400,1190,1475,0.239,-285,1332.5,"Con",60,150,FALSE,TRUE,FALSE,19.32,"young",43,185,90,"m"
22,"ABDUCTOR",1,"Con07",1600,1580,2000,1800,1590,1900,0.195,-310,1745,"Con",20,200,TRUE,FALSE,FALSE,16.32,"young",43,185,90,"m"
22,"ABDUCTOR",1,"Con08",2140,2160,2550,2350,2150,2450,0.14,-300,2300,"Con",-20,200,TRUE,FALSE,FALSE,12.24,"young",43,185,90,"m"
22,"ABDUCTOR",1,"Con09",1280,1280,1650,1800,1280,1725,0.348,-445,1502.5,"Con",0,-150,TRUE,FALSE,FALSE,25.8,"young",43,185,90,"m"
22,"ABDUCTOR",1,"Con10",1280,1260,1550,2700,1270,2125,0.673,-855,1697.5,"Con",20,-1150,TRUE,FALSE,TRUE,40.24,"young",43,185,90,"m"
22,"ABDUCTOR",2,"Con01",1160,1140,1450,1350,1150,1400,0.217,-250,1275,"Con",20,100,FALSE,FALSE,FALSE,17.86,"young",43,185,90,"m"
22,"ABDUCTOR",2,"Con02",1200,1220,1450,1350,1210,1400,0.157,-190,1305,"Con",-20,100,FALSE,FALSE,FALSE,13.57,"young",43,185,90,"m"
22,"ABDUCTOR",2,"Con03",1280,1240,1450,1650,1260,1550,0.23,-290,1405,"Con",40,-200,FALSE,TRUE,FALSE,18.71,"young",43,185,90,"m"
22,"ABDUCTOR",2,"Con04",1200,1200,1450,1600,1200,1525,0.271,-325,1362.5,"Con",0,-150,TRUE,FALSE,FALSE,21.31,"young",43,185,90,"m"
22,"ABDUCTOR",2,"Con05",1320,1280,1650,2300,1300,1975,0.519,-675,1637.5,"Con",40,-650,TRUE,TRUE,TRUE,34.18,"young",43,185,90,"m"
22,"ABDUCTOR",2,"Con06",1420,1420,1700,1750,1420,1725,0.215,-305,1572.5,"Con",0,-50,TRUE,FALSE,FALSE,17.68,"young",43,185,90,"m"
22,"ABDUCTOR",2,"Con07",1340,1300,1450,1450,1320,1450,0.098,-130,1385,"Con",40,0,FALSE,TRUE,FALSE,8.97,"young",43,185,90,"m"
22,"ABDUCTOR",2,"Con08",1260,1240,1600,1500,1250,1550,0.24,-300,1400,"Con",20,100,TRUE,FALSE,FALSE,19.35,"young",43,185,90,"m"
22,"ABDUCTOR",2,"Con09",1400,1340,2150,1650,1370,1900,0.387,-530,1635,"Con",60,500,TRUE,TRUE,TRUE,27.89,"young",43,185,90,"m"
22,"ABDUCTOR",2,"Con10",1240,1220,3400,1600,1230,2500,1.033,-1270,1865,"Con",20,1800,TRUE,FALSE,TRUE,50.8,"young",43,185,90,"m"
22,"ABDUCTOR",1,"Ecc01",2440,2440,1950,2100,2440,2025,0.17,415,2232.5,"Ecc",0,-150,TRUE,FALSE,FALSE,20.49,"young",43,185,90,"m"
22,"ABDUCTOR",1,"Ecc02",3240,3260,2950,2650,3250,2800,0.138,450,3025,"Ecc",-20,300,TRUE,FALSE,FALSE,16.07,"young",43,185,90,"m"
22,"ABDUCTOR",1,"Ecc03",3520,3500,3350,3200,3510,3275,0.067,235,3392.5,"Ecc",20,150,FALSE,FALSE,FALSE,7.18,"young",43,185,90,"m"
22,"ABDUCTOR",1,"Ecc04",3540,3540,3500,3500,3540,3500,0.011,40,3520,"Ecc",0,0,FALSE,FALSE,FALSE,1.14,"young",43,185,90,"m"
22,"ABDUCTOR",1,"Ecc05",3780,3780,3600,3700,3780,3650,0.034,130,3715,"Ecc",0,-100,FALSE,FALSE,FALSE,3.56,"young",43,185,90,"m"
22,"ABDUCTOR",1,"Ecc06",2540,2600,2200,2400,2570,2300,0.105,270,2435,"Ecc",-60,-200,FALSE,TRUE,FALSE,11.74,"young",43,185,90,"m"
22,"ABDUCTOR",1,"Ecc07",3760,3740,3300,3500,3750,3400,0.093,350,3575,"Ecc",20,-200,TRUE,FALSE,FALSE,10.29,"young",43,185,90,"m"
22,"ABDUCTOR",1,"Ecc08",2240,2240,2000,2050,2240,2025,0.096,215,2132.5,"Ecc",0,-50,FALSE,FALSE,FALSE,10.62,"young",43,185,90,"m"
22,"ABDUCTOR",1,"Ecc09",3460,3480,3050,2300,3470,2675,0.229,795,3072.5,"Ecc",-20,750,TRUE,FALSE,TRUE,29.72,"young",43,185,90,"m"
22,"ABDUCTOR",1,"Ecc10",2760,2760,2650,2050,2760,2350,0.149,410,2555,"Ecc",0,600,TRUE,FALSE,TRUE,17.45,"young",43,185,90,"m"
22,"ABDUCTOR",2,"Ecc01",2740,2740,2500,2600,2740,2550,0.069,190,2645,"Ecc",0,-100,FALSE,FALSE,FALSE,7.45,"young",43,185,90,"m"
22,"ABDUCTOR",2,"Ecc02",3020,3040,2750,2650,3030,2700,0.109,330,2865,"Ecc",-20,100,TRUE,FALSE,FALSE,12.22,"young",43,185,90,"m"
22,"ABDUCTOR",2,"Ecc03",3400,3440,3250,3050,3420,3150,0.079,270,3285,"Ecc",-40,200,FALSE,TRUE,FALSE,8.57,"young",43,185,90,"m"
22,"ABDUCTOR",2,"Ecc04",3640,3640,3300,3050,3640,3175,0.128,465,3407.5,"Ecc",0,250,TRUE,FALSE,FALSE,14.65,"young",43,185,90,"m"
22,"ABDUCTOR",2,"Ecc05",3920,3940,3600,3150,3930,3375,0.141,555,3652.5,"Ecc",-20,450,TRUE,FALSE,TRUE,16.44,"young",43,185,90,"m"
22,"ABDUCTOR",2,"Ecc06",4020,4040,3900,3900,4030,3900,0.032,130,3965,"Ecc",-20,0,FALSE,FALSE,FALSE,3.33,"young",43,185,90,"m"
22,"ABDUCTOR",2,"Ecc07",4180,4180,3900,3900,4180,3900,0.067,280,4040,"Ecc",0,0,FALSE,FALSE,FALSE,7.18,"young",43,185,90,"m"
22,"ABDUCTOR",2,"Ecc08",3440,3500,2950,3150,3470,3050,0.121,420,3260,"Ecc",-60,-200,TRUE,TRUE,FALSE,13.77,"young",43,185,90,"m"
22,"ABDUCTOR",2,"Ecc09",3740,3800,1800,3500,3770,2650,0.297,1120,3210,"Ecc",-60,-1700,TRUE,TRUE,TRUE,42.26,"young",43,185,90,"m"
22,"ABDUCTOR",2,"Ecc10",3220,3220,2650,3100,3220,2875,0.107,345,3047.5,"Ecc",0,-450,TRUE,FALSE,TRUE,12,"young",43,185,90,"m"
22,"ABDUCTOR",1,"Rep01",4000,3980,3750,3700,3990,3725,0.066,265,3857.5,"Rep",20,50,FALSE,FALSE,FALSE,7.11,"young",43,185,90,"m"
22,"ABDUCTOR",1,"Rep02",4240,4260,4500,4200,4250,4350,0.024,-100,4300,"Rep",-20,300,FALSE,FALSE,FALSE,2.3,"young",43,185,90,"m"
22,"ABDUCTOR",1,"Rep03",4680,4640,4750,4950,4660,4850,0.041,-190,4755,"Rep",40,-200,FALSE,FALSE,FALSE,3.92,"young",43,185,90,"m"
22,"ABDUCTOR",1,"Rep04",4720,4740,4800,4900,4730,4850,0.025,-120,4790,"Rep",-20,-100,FALSE,FALSE,FALSE,2.47,"young",43,185,90,"m"
22,"ABDUCTOR",1,"Rep05",5200,5220,5000,5050,5210,5025,0.036,185,5117.5,"Rep",-20,-50,FALSE,FALSE,FALSE,3.68,"young",43,185,90,"m"
22,"ABDUCTOR",1,"Rep06",3760,3760,3750,3800,3760,3775,0.004,-15,3767.5,"Rep",0,-50,FALSE,FALSE,FALSE,0.4,"young",43,185,90,"m"
22,"ABDUCTOR",1,"Rep07",5360,5320,5300,5300,5340,5300,0.007,40,5320,"Rep",40,0,FALSE,FALSE,FALSE,0.75,"young",43,185,90,"m"
22,"ABDUCTOR",1,"Rep08",4380,4400,4550,4400,4390,4475,0.019,-85,4432.5,"Rep",-20,150,FALSE,FALSE,FALSE,1.9,"young",43,185,90,"m"
22,"ABDUCTOR",1,"Rep09",4740,4760,4700,4100,4750,4400,0.074,350,4575,"Rep",-20,600,TRUE,FALSE,TRUE,7.95,"young",43,185,90,"m"
22,"ABDUCTOR",1,"Rep10",4040,4020,4200,4750,4030,4475,0.11,-445,4252.5,"Rep",20,-550,TRUE,FALSE,TRUE,9.94,"young",43,185,90,"m"
22,"ABDUCTOR",2,"Rep01",3900,3880,3950,3950,3890,3950,0.015,-60,3920,"Rep",20,0,FALSE,FALSE,FALSE,1.52,"young",43,185,90,"m"
22,"ABDUCTOR",2,"Rep02",4220,4260,4200,4000,4240,4100,0.033,140,4170,"Rep",-40,200,FALSE,FALSE,FALSE,3.41,"young",43,185,90,"m"
22,"ABDUCTOR",2,"Rep03",4680,4680,4700,4700,4680,4700,0.004,-20,4690,"Rep",0,0,FALSE,FALSE,FALSE,0.43,"young",43,185,90,"m"
22,"ABDUCTOR",2,"Rep04",4840,4840,4750,4650,4840,4700,0.029,140,4770,"Rep",0,100,FALSE,FALSE,FALSE,2.98,"young",43,185,90,"m"
22,"ABDUCTOR",2,"Rep05",5240,5220,5250,5450,5230,5350,0.023,-120,5290,"Rep",20,-200,FALSE,FALSE,FALSE,2.24,"young",43,185,90,"m"
22,"ABDUCTOR",2,"Rep06",5440,5460,5600,5650,5450,5625,0.032,-175,5537.5,"Rep",-20,-50,FALSE,FALSE,FALSE,3.11,"young",43,185,90,"m"
22,"ABDUCTOR",2,"Rep07",5520,5480,5350,5350,5500,5350,0.027,150,5425,"Rep",40,0,FALSE,FALSE,FALSE,2.8,"young",43,185,90,"m"
22,"ABDUCTOR",2,"Rep08",4700,4740,4550,4650,4720,4600,0.025,120,4660,"Rep",-40,-100,FALSE,FALSE,FALSE,2.61,"young",43,185,90,"m"
22,"ABDUCTOR",2,"Rep09",5140,5140,3950,5150,5140,4550,0.115,590,4845,"Rep",0,-1200,TRUE,FALSE,TRUE,12.97,"young",43,185,90,"m"
22,"ABDUCTOR",2,"Rep10",4460,4440,6050,4700,4450,5375,0.208,-925,4912.5,"Rep",20,1350,TRUE,FALSE,TRUE,17.21,"young",43,185,90,"m"
22,"ABDUCTOR",1,"TuT",45120,45100,45300,45150,45110,45225,0.003,-115,45167.5,"TuT",20,150,FALSE,FALSE,FALSE,0.25,"young",43,185,90,"m"
22,"ABDUCTOR",2,"TuT",48140,48140,48350,48250,48140,48300,0.003,-160,48220,"TuT",0,100,FALSE,FALSE,FALSE,0.33,"young",43,185,90,"m"
22,"ADDUCTOR",1,"Con01",1240,1240,2250,2050,1240,2150,0.734,-910,1695,"Con",0,200,TRUE,FALSE,FALSE,42.33,"young",43,185,90,"m"
22,"ADDUCTOR",1,"Con02",1300,1340,1100,1250,1320,1175,0.11,145,1247.5,"Con",-40,-150,FALSE,TRUE,FALSE,12.34,"young",43,185,90,"m"
22,"ADDUCTOR",1,"Con03",1040,1080,850,1050,1060,950,0.104,110,1005,"Con",-40,-200,FALSE,TRUE,FALSE,11.58,"young",43,185,90,"m"
22,"ADDUCTOR",1,"Con04",1000,1020,950,1550,1010,1250,0.238,-240,1130,"Con",-20,-600,FALSE,FALSE,TRUE,19.2,"young",43,185,90,"m"
22,"ADDUCTOR",1,"Con05",1200,1200,1900,2000,1200,1950,0.625,-750,1575,"Con",0,-100,TRUE,FALSE,FALSE,38.46,"young",43,185,90,"m"
22,"ADDUCTOR",1,"Con06",1040,1040,1850,1750,1040,1800,0.731,-760,1420,"Con",0,100,TRUE,FALSE,FALSE,42.22,"young",43,185,90,"m"
22,"ADDUCTOR",1,"Con07",1100,1120,1800,1600,1110,1700,0.532,-590,1405,"Con",-20,200,TRUE,FALSE,FALSE,34.71,"young",43,185,90,"m"
22,"ADDUCTOR",1,"Con08",1020,1020,2050,1900,1020,1975,0.936,-955,1497.5,"Con",0,150,TRUE,FALSE,FALSE,48.35,"young",43,185,90,"m"
22,"ADDUCTOR",1,"Con09",1240,1220,2900,2750,1230,2825,1.297,-1595,2027.5,"Con",20,150,TRUE,FALSE,FALSE,56.46,"young",43,185,90,"m"
22,"ADDUCTOR",1,"Con10",1280,1320,5050,5050,1300,5050,2.885,-3750,3175,"Con",-40,0,TRUE,TRUE,FALSE,74.26,"young",43,185,90,"m"
22,"ADDUCTOR",2,"Con01",1240,1220,1450,1800,1230,1625,0.321,-395,1427.5,"Con",20,-350,FALSE,FALSE,TRUE,24.31,"young",43,185,90,"m"
22,"ADDUCTOR",2,"Con02",1160,1200,1800,1700,1180,1750,0.483,-570,1465,"Con",-40,100,FALSE,TRUE,FALSE,32.57,"young",43,185,90,"m"
22,"ADDUCTOR",2,"Con03",1080,1080,2650,1900,1080,2275,1.106,-1195,1677.5,"Con",0,750,TRUE,FALSE,TRUE,52.53,"young",43,185,90,"m"
22,"ADDUCTOR",2,"Con04",1100,1120,3250,1700,1110,2475,1.23,-1365,1792.5,"Con",-20,1550,TRUE,FALSE,TRUE,55.15,"young",43,185,90,"m"
22,"ADDUCTOR",2,"Con05",1160,1160,1250,1600,1160,1425,0.228,-265,1292.5,"Con",0,-350,FALSE,FALSE,TRUE,18.6,"young",43,185,90,"m"
22,"ADDUCTOR",2,"Con06",1220,1240,1000,1200,1230,1100,0.106,130,1165,"Con",-20,-200,FALSE,FALSE,FALSE,11.82,"young",43,185,90,"m"
22,"ADDUCTOR",2,"Con07",1180,1180,1200,2000,1180,1600,0.356,-420,1390,"Con",0,-800,FALSE,FALSE,TRUE,26.25,"young",43,185,90,"m"
22,"ADDUCTOR",2,"Con08",1080,1120,1950,2100,1100,2025,0.841,-925,1562.5,"Con",-40,-150,TRUE,TRUE,FALSE,45.68,"young",43,185,90,"m"
22,"ADDUCTOR",2,"Con09",1080,1080,2650,2350,1080,2500,1.315,-1420,1790,"Con",0,300,TRUE,FALSE,FALSE,56.8,"young",43,185,90,"m"
22,"ADDUCTOR",2,"Con10",1120,1160,3550,2100,1140,2825,1.478,-1685,1982.5,"Con",-40,1450,TRUE,TRUE,TRUE,59.65,"young",43,185,90,"m"
22,"ADDUCTOR",1,"Ecc01",3000,2960,2050,2200,2980,2125,0.287,855,2552.5,"Ecc",40,-150,TRUE,TRUE,FALSE,40.24,"young",43,185,90,"m"
22,"ADDUCTOR",1,"Ecc02",2720,2700,2950,2750,2710,2850,0.052,-140,2780,"Ecc",20,200,FALSE,FALSE,FALSE,4.91,"young",43,185,90,"m"
22,"ADDUCTOR",1,"Ecc03",3000,2960,3200,2900,2980,3050,0.023,-70,3015,"Ecc",40,300,FALSE,TRUE,FALSE,2.3,"young",43,185,90,"m"
22,"ADDUCTOR",1,"Ecc04",2980,2980,3050,2550,2980,2800,0.06,180,2890,"Ecc",0,500,FALSE,FALSE,TRUE,6.43,"young",43,185,90,"m"
22,"ADDUCTOR",1,"Ecc05",3420,3420,2500,2500,3420,2500,0.269,920,2960,"Ecc",0,0,TRUE,FALSE,FALSE,36.8,"young",43,185,90,"m"
22,"ADDUCTOR",1,"Ecc06",2720,2720,1900,1900,2720,1900,0.301,820,2310,"Ecc",0,0,TRUE,FALSE,FALSE,43.16,"young",43,185,90,"m"
22,"ADDUCTOR",1,"Ecc07",3080,3060,2450,2700,3070,2575,0.161,495,2822.5,"Ecc",20,-250,FALSE,FALSE,FALSE,19.22,"young",43,185,90,"m"
22,"ADDUCTOR",1,"Ecc08",3860,3880,2850,2950,3870,2900,0.251,970,3385,"Ecc",-20,-100,TRUE,FALSE,FALSE,33.45,"young",43,185,90,"m"
22,"ADDUCTOR",1,"Ecc09",3500,3460,1350,1700,3480,1525,0.562,1955,2502.5,"Ecc",40,-350,TRUE,TRUE,TRUE,128.2,"young",43,185,90,"m"
22,"ADDUCTOR",1,"Ecc10",3520,3540,2450,2450,3530,2450,0.306,1080,2990,"Ecc",-20,0,TRUE,FALSE,FALSE,44.08,"young",43,185,90,"m"
22,"ADDUCTOR",2,"Ecc01",3080,3060,3150,3000,3070,3075,0.002,-5,3072.5,"Ecc",20,150,FALSE,FALSE,FALSE,0.16,"young",43,185,90,"m"
22,"ADDUCTOR",2,"Ecc02",3040,3040,1600,2400,3040,2000,0.342,1040,2520,"Ecc",0,-800,TRUE,FALSE,TRUE,52,"young",43,185,90,"m"
22,"ADDUCTOR",2,"Ecc03",3540,3520,950,2650,3530,1800,0.49,1730,2665,"Ecc",20,-1700,TRUE,FALSE,TRUE,96.11,"young",43,185,90,"m"
22,"ADDUCTOR",2,"Ecc04",3000,3000,2650,2550,3000,2600,0.133,400,2800,"Ecc",0,100,FALSE,FALSE,FALSE,15.38,"young",43,185,90,"m"
22,"ADDUCTOR",2,"Ecc05",3100,3100,3100,2750,3100,2925,0.056,175,3012.5,"Ecc",0,350,FALSE,FALSE,TRUE,5.98,"young",43,185,90,"m"
22,"ADDUCTOR",2,"Ecc06",3480,3460,3600,3400,3470,3500,0.009,-30,3485,"Ecc",20,200,FALSE,FALSE,FALSE,0.86,"young",43,185,90,"m"
22,"ADDUCTOR",2,"Ecc07",3540,3520,3300,2400,3530,2850,0.193,680,3190,"Ecc",20,900,TRUE,FALSE,TRUE,23.86,"young",43,185,90,"m"
22,"ADDUCTOR",2,"Ecc08",3560,3540,2450,2550,3550,2500,0.296,1050,3025,"Ecc",20,-100,TRUE,FALSE,FALSE,42,"young",43,185,90,"m"
22,"ADDUCTOR",2,"Ecc09",3980,3940,1100,2900,3960,2000,0.495,1960,2980,"Ecc",40,-1800,TRUE,TRUE,TRUE,98,"young",43,185,90,"m"
22,"ADDUCTOR",2,"Ecc10",3180,3160,2450,2300,3170,2375,0.251,795,2772.5,"Ecc",20,150,TRUE,FALSE,FALSE,33.47,"young",43,185,90,"m"
22,"ADDUCTOR",1,"Rep01",4240,4200,4300,4250,4220,4275,0.013,-55,4247.5,"Rep",40,50,FALSE,FALSE,FALSE,1.29,"young",43,185,90,"m"
22,"ADDUCTOR",1,"Rep02",4020,4040,4050,4000,4030,4025,0.001,5,4027.5,"Rep",-20,50,FALSE,FALSE,FALSE,0.12,"young",43,185,90,"m"
22,"ADDUCTOR",1,"Rep03",4040,4040,4050,3950,4040,4000,0.01,40,4020,"Rep",0,100,FALSE,FALSE,FALSE,1,"young",43,185,90,"m"
22,"ADDUCTOR",1,"Rep04",3980,4000,4000,4100,3990,4050,0.015,-60,4020,"Rep",-20,-100,FALSE,FALSE,FALSE,1.48,"young",43,185,90,"m"
22,"ADDUCTOR",1,"Rep05",4620,4620,4400,4500,4620,4450,0.037,170,4535,"Rep",0,-100,FALSE,FALSE,FALSE,3.82,"young",43,185,90,"m"
22,"ADDUCTOR",1,"Rep06",3760,3760,3750,3650,3760,3700,0.016,60,3730,"Rep",0,100,FALSE,FALSE,FALSE,1.62,"young",43,185,90,"m"
22,"ADDUCTOR",1,"Rep07",4180,4180,4250,4300,4180,4275,0.023,-95,4227.5,"Rep",0,-50,FALSE,FALSE,FALSE,2.22,"young",43,185,90,"m"
22,"ADDUCTOR",1,"Rep08",4880,4900,4900,4850,4890,4875,0.003,15,4882.5,"Rep",-20,50,FALSE,FALSE,FALSE,0.31,"young",43,185,90,"m"
22,"ADDUCTOR",1,"Rep09",4740,4680,4250,4450,4710,4350,0.076,360,4530,"Rep",60,-200,FALSE,FALSE,FALSE,8.28,"young",43,185,90,"m"
22,"ADDUCTOR",1,"Rep10",4800,4860,7500,7500,4830,7500,0.553,-2670,6165,"Rep",-60,0,TRUE,FALSE,FALSE,35.6,"young",43,185,90,"m"
22,"ADDUCTOR",2,"Rep01",4320,4280,4600,4800,4300,4700,0.093,-400,4500,"Rep",40,-200,TRUE,FALSE,FALSE,8.51,"young",43,185,90,"m"
22,"ADDUCTOR",2,"Rep02",4200,4240,3400,4100,4220,3750,0.111,470,3985,"Rep",-40,-700,TRUE,FALSE,TRUE,12.53,"young",43,185,90,"m"
22,"ADDUCTOR",2,"Rep03",4620,4600,3600,4550,4610,4075,0.116,535,4342.5,"Rep",20,-950,TRUE,FALSE,TRUE,13.13,"young",43,185,90,"m"
22,"ADDUCTOR",2,"Rep04",4100,4120,5900,4250,4110,5075,0.235,-965,4592.5,"Rep",-20,1650,TRUE,FALSE,TRUE,19.01,"young",43,185,90,"m"
22,"ADDUCTOR",2,"Rep05",4260,4260,4350,4350,4260,4350,0.021,-90,4305,"Rep",0,0,FALSE,FALSE,FALSE,2.07,"young",43,185,90,"m"
22,"ADDUCTOR",2,"Rep06",4700,4700,4600,4600,4700,4600,0.021,100,4650,"Rep",0,0,FALSE,FALSE,FALSE,2.17,"young",43,185,90,"m"
22,"ADDUCTOR",2,"Rep07",4720,4700,4500,4400,4710,4450,0.055,260,4580,"Rep",20,100,FALSE,FALSE,FALSE,5.84,"young",43,185,90,"m"
22,"ADDUCTOR",2,"Rep08",4640,4660,4400,4650,4650,4525,0.027,125,4587.5,"Rep",-20,-250,FALSE,FALSE,TRUE,2.76,"young",43,185,90,"m"
22,"ADDUCTOR",2,"Rep09",5060,5020,3750,5250,5040,4500,0.107,540,4770,"Rep",40,-1500,TRUE,FALSE,TRUE,12,"young",43,185,90,"m"
22,"ADDUCTOR",2,"Rep10",4300,4320,6000,4400,4310,5200,0.206,-890,4755,"Rep",-20,1600,TRUE,FALSE,TRUE,17.12,"young",43,185,90,"m"
22,"ADDUCTOR",1,"TuT",43260,43280,45450,45550,43270,45500,0.052,-2230,44385,"TuT",-20,-100,TRUE,FALSE,FALSE,4.9,"young",43,185,90,"m"
22,"ADDUCTOR",2,"TuT",44920,44900,45100,45350,44910,45225,0.007,-315,45067.5,"TuT",20,-250,FALSE,FALSE,FALSE,0.7,"young",43,185,90,"m"
22,"LOWER BACK",1,"Con01",1880,1880,2350,2000,1880,2175,0.157,-295,2027.5,"Con",0,350,TRUE,FALSE,TRUE,13.56,"young",43,185,90,"m"
22,"LOWER BACK",1,"Con02",2020,2020,1950,2150,2020,2050,0.015,-30,2035,"Con",0,-200,FALSE,FALSE,TRUE,1.46,"young",43,185,90,"m"
22,"LOWER BACK",1,"Con03",1880,1860,1850,2000,1870,1925,0.029,-55,1897.5,"Con",20,-150,FALSE,FALSE,FALSE,2.86,"young",43,185,90,"m"
22,"LOWER BACK",1,"Con04",1940,1980,2000,2100,1960,2050,0.046,-90,2005,"Con",-40,-100,FALSE,TRUE,FALSE,4.39,"young",43,185,90,"m"
22,"LOWER BACK",1,"Con05",1820,1820,2050,1950,1820,2000,0.099,-180,1910,"Con",0,100,FALSE,FALSE,FALSE,9,"young",43,185,90,"m"
22,"LOWER BACK",1,"Con06",2000,2020,2900,2200,2010,2550,0.269,-540,2280,"Con",-20,700,TRUE,FALSE,TRUE,21.18,"young",43,185,90,"m"
22,"LOWER BACK",1,"Con07",2180,2160,2450,2250,2170,2350,0.083,-180,2260,"Con",20,200,FALSE,FALSE,TRUE,7.66,"young",43,185,90,"m"
22,"LOWER BACK",1,"Con08",2120,2100,2700,2450,2110,2575,0.22,-465,2342.5,"Con",20,250,TRUE,FALSE,TRUE,18.06,"young",43,185,90,"m"
22,"LOWER BACK",1,"Con09",2180,2160,2750,3450,2170,3100,0.429,-930,2635,"Con",20,-700,TRUE,FALSE,TRUE,30,"young",43,185,90,"m"
22,"LOWER BACK",1,"Con10",2240,2220,2750,3400,2230,3075,0.379,-845,2652.5,"Con",20,-650,TRUE,FALSE,TRUE,27.48,"young",43,185,90,"m"
22,"LOWER BACK",2,"Con01",1900,1900,2300,2100,1900,2200,0.158,-300,2050,"Con",0,200,TRUE,FALSE,TRUE,13.64,"young",43,185,90,"m"
22,"LOWER BACK",2,"Con02",1900,1880,1950,1950,1890,1950,0.032,-60,1920,"Con",20,0,FALSE,FALSE,FALSE,3.08,"young",43,185,90,"m"
22,"LOWER BACK",2,"Con03",1980,1940,1950,2050,1960,2000,0.02,-40,1980,"Con",40,-100,FALSE,TRUE,FALSE,2,"young",43,185,90,"m"
22,"LOWER BACK",2,"Con04",2040,2040,2000,2200,2040,2100,0.029,-60,2070,"Con",0,-200,FALSE,FALSE,TRUE,2.86,"young",43,185,90,"m"
22,"LOWER BACK",2,"Con05",1980,2000,2100,2150,1990,2125,0.068,-135,2057.5,"Con",-20,-50,FALSE,FALSE,FALSE,6.35,"young",43,185,90,"m"
22,"LOWER BACK",2,"Con06",1940,1940,2350,2200,1940,2275,0.173,-335,2107.5,"Con",0,150,TRUE,FALSE,FALSE,14.73,"young",43,185,90,"m"
22,"LOWER BACK",2,"Con07",2100,2060,2550,2400,2080,2475,0.19,-395,2277.5,"Con",40,150,TRUE,TRUE,FALSE,15.96,"young",43,185,90,"m"
22,"LOWER BACK",2,"Con08",2020,2020,2850,2550,2020,2700,0.337,-680,2360,"Con",0,300,TRUE,FALSE,TRUE,25.19,"young",43,185,90,"m"
22,"LOWER BACK",2,"Con09",2100,2120,3050,2750,2110,2900,0.374,-790,2505,"Con",-20,300,TRUE,FALSE,TRUE,27.24,"young",43,185,90,"m"
22,"LOWER BACK",2,"Con10",2040,2000,2350,2500,2020,2425,0.2,-405,2222.5,"Con",40,-150,TRUE,TRUE,FALSE,16.7,"young",43,185,90,"m"
22,"LOWER BACK",1,"Ecc01",3340,3320,3400,3300,3330,3350,0.006,-20,3340,"Ecc",20,100,FALSE,FALSE,FALSE,0.6,"young",43,185,90,"m"
22,"LOWER BACK",1,"Ecc02",4020,4060,4100,3850,4040,3975,0.016,65,4007.5,"Ecc",-40,250,FALSE,FALSE,TRUE,1.64,"young",43,185,90,"m"
22,"LOWER BACK",1,"Ecc03",4160,4140,4100,4050,4150,4075,0.018,75,4112.5,"Ecc",20,50,FALSE,FALSE,FALSE,1.84,"young",43,185,90,"m"
22,"LOWER BACK",1,"Ecc04",3860,3860,3750,3700,3860,3725,0.035,135,3792.5,"Ecc",0,50,FALSE,FALSE,FALSE,3.62,"young",43,185,90,"m"
22,"LOWER BACK",1,"Ecc05",3920,3880,3450,3700,3900,3575,0.083,325,3737.5,"Ecc",40,-250,TRUE,FALSE,TRUE,9.09,"young",43,185,90,"m"
22,"LOWER BACK",1,"Ecc06",3560,3560,2850,3550,3560,3200,0.101,360,3380,"Ecc",0,-700,TRUE,FALSE,TRUE,11.25,"young",43,185,90,"m"
22,"LOWER BACK",1,"Ecc07",4140,4180,3700,3900,4160,3800,0.087,360,3980,"Ecc",-40,-200,TRUE,FALSE,TRUE,9.47,"young",43,185,90,"m"
22,"LOWER BACK",1,"Ecc08",3980,4000,3400,3400,3990,3400,0.148,590,3695,"Ecc",-20,0,TRUE,FALSE,FALSE,17.35,"young",43,185,90,"m"
22,"LOWER BACK",1,"Ecc09",4020,4020,3350,2600,4020,2975,0.26,1045,3497.5,"Ecc",0,750,TRUE,FALSE,TRUE,35.13,"young",43,185,90,"m"
22,"LOWER BACK",1,"Ecc10",3780,3800,3650,3200,3790,3425,0.096,365,3607.5,"Ecc",-20,450,TRUE,FALSE,TRUE,10.66,"young",43,185,90,"m"
22,"LOWER BACK",2,"Ecc01",3340,3340,3150,3200,3340,3175,0.049,165,3257.5,"Ecc",0,-50,FALSE,FALSE,FALSE,5.2,"young",43,185,90,"m"
22,"LOWER BACK",2,"Ecc02",3260,3300,3300,3250,3280,3275,0.002,5,3277.5,"Ecc",-40,50,FALSE,FALSE,FALSE,0.15,"young",43,185,90,"m"
22,"LOWER BACK",2,"Ecc03",3560,3580,3600,3400,3570,3500,0.02,70,3535,"Ecc",-20,200,FALSE,FALSE,TRUE,2,"young",43,185,90,"m"
22,"LOWER BACK",2,"Ecc04",3600,3580,3600,3500,3590,3550,0.011,40,3570,"Ecc",20,100,FALSE,FALSE,FALSE,1.13,"young",43,185,90,"m"
22,"LOWER BACK",2,"Ecc05",4140,4140,3750,3850,4140,3800,0.082,340,3970,"Ecc",0,-100,TRUE,FALSE,FALSE,8.95,"young",43,185,90,"m"
22,"LOWER BACK",2,"Ecc06",3560,3580,3250,3350,3570,3300,0.076,270,3435,"Ecc",-20,-100,TRUE,FALSE,FALSE,8.18,"young",43,185,90,"m"
22,"LOWER BACK",2,"Ecc07",3620,3620,2850,3200,3620,3025,0.164,595,3322.5,"Ecc",0,-350,TRUE,FALSE,TRUE,19.67,"young",43,185,90,"m"
22,"LOWER BACK",2,"Ecc08",3580,3580,2800,3100,3580,2950,0.176,630,3265,"Ecc",0,-300,TRUE,FALSE,TRUE,21.36,"young",43,185,90,"m"
22,"LOWER BACK",2,"Ecc09",3460,3480,2750,2800,3470,2775,0.2,695,3122.5,"Ecc",-20,-50,TRUE,FALSE,FALSE,25.05,"young",43,185,90,"m"
22,"LOWER BACK",2,"Ecc10",3340,3360,3300,3250,3350,3275,0.022,75,3312.5,"Ecc",-20,50,FALSE,FALSE,FALSE,2.29,"young",43,185,90,"m"
22,"LOWER BACK",1,"Rep01",5220,5200,5750,5300,5210,5525,0.06,-315,5367.5,"Rep",20,450,TRUE,FALSE,TRUE,5.7,"young",43,185,90,"m"
22,"LOWER BACK",1,"Rep02",6040,6080,6050,6000,6060,6025,0.006,35,6042.5,"Rep",-40,50,FALSE,FALSE,FALSE,0.58,"young",43,185,90,"m"
22,"LOWER BACK",1,"Rep03",6040,6000,5950,6050,6020,6000,0.003,20,6010,"Rep",40,-100,FALSE,FALSE,FALSE,0.33,"young",43,185,90,"m"
22,"LOWER BACK",1,"Rep04",5800,5840,5750,5800,5820,5775,0.008,45,5797.5,"Rep",-40,-50,FALSE,FALSE,FALSE,0.78,"young",43,185,90,"m"
22,"LOWER BACK",1,"Rep05",5740,5700,5500,5650,5720,5575,0.025,145,5647.5,"Rep",40,-150,TRUE,FALSE,FALSE,2.6,"young",43,185,90,"m"
22,"LOWER BACK",1,"Rep06",5560,5580,5750,5750,5570,5750,0.032,-180,5660,"Rep",-20,0,TRUE,FALSE,FALSE,3.13,"young",43,185,90,"m"
22,"LOWER BACK",1,"Rep07",6320,6340,6150,6150,6330,6150,0.028,180,6240,"Rep",-20,0,TRUE,FALSE,FALSE,2.93,"young",43,185,90,"m"
22,"LOWER BACK",1,"Rep08",6100,6100,6100,5850,6100,5975,0.02,125,6037.5,"Rep",0,250,TRUE,FALSE,TRUE,2.09,"young",43,185,90,"m"
22,"LOWER BACK",1,"Rep09",6200,6180,6100,6050,6190,6075,0.019,115,6132.5,"Rep",20,50,TRUE,FALSE,FALSE,1.89,"young",43,185,90,"m"
22,"LOWER BACK",1,"Rep10",6020,6020,6400,6600,6020,6500,0.08,-480,6260,"Rep",0,-200,TRUE,FALSE,TRUE,7.38,"young",43,185,90,"m"
22,"LOWER BACK",2,"Rep01",5240,5240,5450,5300,5240,5375,0.026,-135,5307.5,"Rep",0,150,TRUE,FALSE,FALSE,2.51,"young",43,185,90,"m"
22,"LOWER BACK",2,"Rep02",5160,5180,5250,5200,5170,5225,0.011,-55,5197.5,"Rep",-20,50,FALSE,FALSE,FALSE,1.05,"young",43,185,90,"m"
22,"LOWER BACK",2,"Rep03",5540,5520,5550,5450,5530,5500,0.005,30,5515,"Rep",20,100,FALSE,FALSE,FALSE,0.55,"young",43,185,90,"m"
22,"LOWER BACK",2,"Rep04",5640,5620,5600,5700,5630,5650,0.004,-20,5640,"Rep",20,-100,FALSE,FALSE,FALSE,0.35,"young",43,185,90,"m"
22,"LOWER BACK",2,"Rep05",6120,6140,5850,6000,6130,5925,0.033,205,6027.5,"Rep",-20,-150,TRUE,FALSE,FALSE,3.46,"young",43,185,90,"m"
22,"LOWER BACK",2,"Rep06",5500,5520,5600,5550,5510,5575,0.012,-65,5542.5,"Rep",-20,50,FALSE,FALSE,FALSE,1.17,"young",43,185,90,"m"
22,"LOWER BACK",2,"Rep07",5720,5680,5400,5600,5700,5500,0.035,200,5600,"Rep",40,-200,TRUE,FALSE,TRUE,3.64,"young",43,185,90,"m"
22,"LOWER BACK",2,"Rep08",5600,5600,5650,5650,5600,5650,0.009,-50,5625,"Rep",0,0,FALSE,FALSE,FALSE,0.88,"young",43,185,90,"m"
22,"LOWER BACK",2,"Rep09",5560,5600,5800,5550,5580,5675,0.017,-95,5627.5,"Rep",-40,250,FALSE,FALSE,TRUE,1.67,"young",43,185,90,"m"
22,"LOWER BACK",2,"Rep10",5380,5360,5650,5750,5370,5700,0.061,-330,5535,"Rep",20,-100,TRUE,FALSE,FALSE,5.79,"young",43,185,90,"m"
22,"LOWER BACK",1,"TuT",59040,59040,59500,59200,59040,59350,0.005,-310,59195,"TuT",0,300,TRUE,FALSE,TRUE,0.52,"young",43,185,90,"m"
22,"LOWER BACK",2,"TuT",55460,55460,55800,55750,55460,55775,0.006,-315,55617.5,"TuT",0,50,TRUE,FALSE,FALSE,0.56,"young",43,185,90,"m"
22,"TOTAL ABDOMINAL",1,"Con01",2380,2380,2250,2450,2380,2350,0.013,30,2365,"Con",0,-200,FALSE,FALSE,TRUE,1.28,"young",43,185,90,"m"
22,"TOTAL ABDOMINAL",1,"Con02",1940,1980,2050,2100,1960,2075,0.059,-115,2017.5,"Con",-40,-50,FALSE,TRUE,FALSE,5.54,"young",43,185,90,"m"
22,"TOTAL ABDOMINAL",1,"Con03",1920,1900,1900,1850,1910,1875,0.018,35,1892.5,"Con",20,50,FALSE,FALSE,FALSE,1.87,"young",43,185,90,"m"
22,"TOTAL ABDOMINAL",1,"Con04",2220,2240,2250,2250,2230,2250,0.009,-20,2240,"Con",-20,0,FALSE,FALSE,FALSE,0.89,"young",43,185,90,"m"
22,"TOTAL ABDOMINAL",1,"Con05",2040,2040,2100,2050,2040,2075,0.017,-35,2057.5,"Con",0,50,FALSE,FALSE,FALSE,1.69,"young",43,185,90,"m"
22,"TOTAL ABDOMINAL",1,"Con06",2260,2240,2500,2500,2250,2500,0.111,-250,2375,"Con",20,0,TRUE,FALSE,FALSE,10,"young",43,185,90,"m"
22,"TOTAL ABDOMINAL",1,"Con07",1980,2020,2250,2200,2000,2225,0.112,-225,2112.5,"Con",-40,50,TRUE,TRUE,FALSE,10.11,"young",43,185,90,"m"
22,"TOTAL ABDOMINAL",1,"Con08",2280,2280,2550,2500,2280,2525,0.107,-245,2402.5,"Con",0,50,TRUE,FALSE,FALSE,9.7,"young",43,185,90,"m"
22,"TOTAL ABDOMINAL",1,"Con09",2200,2140,2400,2350,2170,2375,0.094,-205,2272.5,"Con",60,50,TRUE,TRUE,FALSE,8.63,"young",43,185,90,"m"
22,"TOTAL ABDOMINAL",1,"Con10",2040,2060,2300,2350,2050,2325,0.134,-275,2187.5,"Con",-20,-50,TRUE,FALSE,FALSE,11.83,"young",43,185,90,"m"
22,"TOTAL ABDOMINAL",2,"Con01",1860,1880,1950,1950,1870,1950,0.043,-80,1910,"Con",-20,0,FALSE,FALSE,FALSE,4.1,"young",43,185,90,"m"
22,"TOTAL ABDOMINAL",2,"Con02",1880,1900,2100,2000,1890,2050,0.085,-160,1970,"Con",-20,100,TRUE,FALSE,FALSE,7.8,"young",43,185,90,"m"
22,"TOTAL ABDOMINAL",2,"Con03",1800,1800,1900,1800,1800,1850,0.028,-50,1825,"Con",0,100,FALSE,FALSE,FALSE,2.7,"young",43,185,90,"m"
22,"TOTAL ABDOMINAL",2,"Con04",1920,1940,1950,2000,1930,1975,0.023,-45,1952.5,"Con",-20,-50,FALSE,FALSE,FALSE,2.28,"young",43,185,90,"m"
22,"TOTAL ABDOMINAL",2,"Con05",1880,1920,1900,1900,1900,1900,0,0,1900,"Con",-40,0,FALSE,TRUE,FALSE,0,"young",43,185,90,"m"
22,"TOTAL ABDOMINAL",2,"Con06",1820,1860,1950,1950,1840,1950,0.06,-110,1895,"Con",-40,0,FALSE,TRUE,FALSE,5.64,"young",43,185,90,"m"
22,"TOTAL ABDOMINAL",2,"Con07",1880,1900,2050,2100,1890,2075,0.098,-185,1982.5,"Con",-20,-50,TRUE,FALSE,FALSE,8.92,"young",43,185,90,"m"
22,"TOTAL ABDOMINAL",2,"Con08",1900,1940,2150,2300,1920,2225,0.159,-305,2072.5,"Con",-40,-150,TRUE,TRUE,FALSE,13.71,"young",43,185,90,"m"
22,"TOTAL ABDOMINAL",2,"Con09",1940,1940,2300,2250,1940,2275,0.173,-335,2107.5,"Con",0,50,TRUE,FALSE,FALSE,14.73,"young",43,185,90,"m"
22,"TOTAL ABDOMINAL",2,"Con10",1860,1840,2000,2000,1850,2000,0.081,-150,1925,"Con",20,0,TRUE,FALSE,FALSE,7.5,"young",43,185,90,"m"
22,"TOTAL ABDOMINAL",1,"Ecc01",2640,2620,2550,2500,2630,2525,0.04,105,2577.5,"Ecc",20,50,FALSE,FALSE,FALSE,4.16,"young",43,185,90,"m"
22,"TOTAL ABDOMINAL",1,"Ecc02",2820,2820,2850,2900,2820,2875,0.02,-55,2847.5,"Ecc",0,-50,FALSE,FALSE,FALSE,1.91,"young",43,185,90,"m"
22,"TOTAL ABDOMINAL",1,"Ecc03",2940,2940,2950,3000,2940,2975,0.012,-35,2957.5,"Ecc",0,-50,FALSE,FALSE,FALSE,1.18,"young",43,185,90,"m"
22,"TOTAL ABDOMINAL",1,"Ecc04",2960,2940,2900,2900,2950,2900,0.017,50,2925,"Ecc",20,0,FALSE,FALSE,FALSE,1.72,"young",43,185,90,"m"
22,"TOTAL ABDOMINAL",1,"Ecc05",3160,3180,2950,2950,3170,2950,0.069,220,3060,"Ecc",-20,0,TRUE,FALSE,FALSE,7.46,"young",43,185,90,"m"
22,"TOTAL ABDOMINAL",1,"Ecc06",2960,2920,2750,2750,2940,2750,0.065,190,2845,"Ecc",40,0,TRUE,TRUE,FALSE,6.91,"young",43,185,90,"m"
22,"TOTAL ABDOMINAL",1,"Ecc07",3660,3680,3400,3450,3670,3425,0.067,245,3547.5,"Ecc",-20,-50,TRUE,FALSE,FALSE,7.15,"young",43,185,90,"m"
22,"TOTAL ABDOMINAL",1,"Ecc08",3480,3540,3250,3350,3510,3300,0.06,210,3405,"Ecc",-60,-100,TRUE,TRUE,FALSE,6.36,"young",43,185,90,"m"
22,"TOTAL ABDOMINAL",1,"Ecc09",3580,3580,3350,3350,3580,3350,0.064,230,3465,"Ecc",0,0,TRUE,FALSE,FALSE,6.87,"young",43,185,90,"m"
22,"TOTAL ABDOMINAL",1,"Ecc10",4220,4220,4100,4050,4220,4075,0.034,145,4147.5,"Ecc",0,50,TRUE,FALSE,FALSE,3.56,"young",43,185,90,"m"
22,"TOTAL ABDOMINAL",2,"Ecc01",2760,2740,2500,2600,2750,2550,0.073,200,2650,"Ecc",20,-100,TRUE,FALSE,FALSE,7.84,"young",43,185,90,"m"
22,"TOTAL ABDOMINAL",2,"Ecc02",2580,2560,2450,2600,2570,2525,0.018,45,2547.5,"Ecc",20,-150,FALSE,FALSE,FALSE,1.78,"young",43,185,90,"m"
22,"TOTAL ABDOMINAL",2,"Ecc03",2860,2840,2800,2800,2850,2800,0.018,50,2825,"Ecc",20,0,FALSE,FALSE,FALSE,1.79,"young",43,185,90,"m"
22,"TOTAL ABDOMINAL",2,"Ecc04",2740,2740,2800,2750,2740,2775,0.013,-35,2757.5,"Ecc",0,50,FALSE,FALSE,FALSE,1.26,"young",43,185,90,"m"
22,"TOTAL ABDOMINAL",2,"Ecc05",2980,2940,2850,2850,2960,2850,0.037,110,2905,"Ecc",40,0,FALSE,TRUE,FALSE,3.86,"young",43,185,90,"m"
22,"TOTAL ABDOMINAL",2,"Ecc06",3000,2960,2850,2800,2980,2825,0.052,155,2902.5,"Ecc",40,50,TRUE,TRUE,FALSE,5.49,"young",43,185,90,"m"
22,"TOTAL ABDOMINAL",2,"Ecc07",3000,2960,2750,2600,2980,2675,0.102,305,2827.5,"Ecc",40,150,TRUE,TRUE,FALSE,11.4,"young",43,185,90,"m"
22,"TOTAL ABDOMINAL",2,"Ecc08",3220,3220,2850,2900,3220,2875,0.107,345,3047.5,"Ecc",0,-50,TRUE,FALSE,FALSE,12,"young",43,185,90,"m"
22,"TOTAL ABDOMINAL",2,"Ecc09",3140,3160,3000,3000,3150,3000,0.048,150,3075,"Ecc",-20,0,TRUE,FALSE,FALSE,5,"young",43,185,90,"m"
22,"TOTAL ABDOMINAL",2,"Ecc10",3460,3480,3400,3450,3470,3425,0.013,45,3447.5,"Ecc",-20,-50,FALSE,FALSE,FALSE,1.31,"young",43,185,90,"m"
22,"TOTAL ABDOMINAL",1,"Rep01",5020,5000,4800,4950,5010,4875,0.027,135,4942.5,"Rep",20,-150,TRUE,FALSE,FALSE,2.77,"young",43,185,90,"m"
22,"TOTAL ABDOMINAL",1,"Rep02",4760,4800,4900,5000,4780,4950,0.036,-170,4865,"Rep",-40,-100,TRUE,FALSE,FALSE,3.43,"young",43,185,90,"m"
22,"TOTAL ABDOMINAL",1,"Rep03",4860,4840,4850,4850,4850,4850,0,0,4850,"Rep",20,0,FALSE,FALSE,FALSE,0,"young",43,185,90,"m"
22,"TOTAL ABDOMINAL",1,"Rep04",5180,5180,5150,5150,5180,5150,0.006,30,5165,"Rep",0,0,FALSE,FALSE,FALSE,0.58,"young",43,185,90,"m"
22,"TOTAL ABDOMINAL",1,"Rep05",5200,5220,5050,5000,5210,5025,0.036,185,5117.5,"Rep",-20,50,TRUE,FALSE,FALSE,3.68,"young",43,185,90,"m"
22,"TOTAL ABDOMINAL",1,"Rep06",5220,5160,5250,5250,5190,5250,0.012,-60,5220,"Rep",60,0,FALSE,FALSE,FALSE,1.14,"young",43,185,90,"m"
22,"TOTAL ABDOMINAL",1,"Rep07",5640,5700,5650,5650,5670,5650,0.004,20,5660,"Rep",-60,0,FALSE,FALSE,FALSE,0.35,"young",43,185,90,"m"
22,"TOTAL ABDOMINAL",1,"Rep08",5760,5820,5800,5850,5790,5825,0.006,-35,5807.5,"Rep",-60,-50,FALSE,FALSE,FALSE,0.6,"young",43,185,90,"m"
22,"TOTAL ABDOMINAL",1,"Rep09",5780,5720,5750,5700,5750,5725,0.004,25,5737.5,"Rep",60,50,FALSE,FALSE,FALSE,0.44,"young",43,185,90,"m"
22,"TOTAL ABDOMINAL",1,"Rep10",6260,6280,6400,6400,6270,6400,0.021,-130,6335,"Rep",-20,0,TRUE,FALSE,FALSE,2.03,"young",43,185,90,"m"
22,"TOTAL ABDOMINAL",2,"Rep01",4620,4620,4450,4550,4620,4500,0.026,120,4560,"Rep",0,-100,FALSE,FALSE,FALSE,2.67,"young",43,185,90,"m"
22,"TOTAL ABDOMINAL",2,"Rep02",4460,4460,4550,4600,4460,4575,0.026,-115,4517.5,"Rep",0,-50,FALSE,FALSE,FALSE,2.51,"young",43,185,90,"m"
22,"TOTAL ABDOMINAL",2,"Rep03",4660,4640,4700,4600,4650,4650,0,0,4650,"Rep",20,100,FALSE,FALSE,FALSE,0,"young",43,185,90,"m"
22,"TOTAL ABDOMINAL",2,"Rep04",4660,4680,4750,4750,4670,4750,0.017,-80,4710,"Rep",-20,0,FALSE,FALSE,FALSE,1.68,"young",43,185,90,"m"
22,"TOTAL ABDOMINAL",2,"Rep05",4860,4860,4750,4750,4860,4750,0.023,110,4805,"Rep",0,0,FALSE,FALSE,FALSE,2.32,"young",43,185,90,"m"
22,"TOTAL ABDOMINAL",2,"Rep06",4820,4820,4800,4750,4820,4775,0.009,45,4797.5,"Rep",0,50,FALSE,FALSE,FALSE,0.94,"young",43,185,90,"m"
22,"TOTAL ABDOMINAL",2,"Rep07",4880,4860,4800,4700,4870,4750,0.025,120,4810,"Rep",20,100,FALSE,FALSE,FALSE,2.53,"young",43,185,90,"m"
22,"TOTAL ABDOMINAL",2,"Rep08",5120,5160,5000,5200,5140,5100,0.008,40,5120,"Rep",-40,-200,FALSE,FALSE,TRUE,0.78,"young",43,185,90,"m"
22,"TOTAL ABDOMINAL",2,"Rep09",5080,5100,5300,5250,5090,5275,0.036,-185,5182.5,"Rep",-20,50,TRUE,FALSE,FALSE,3.51,"young",43,185,90,"m"
22,"TOTAL ABDOMINAL",2,"Rep10",5320,5320,5400,5450,5320,5425,0.02,-105,5372.5,"Rep",0,-50,FALSE,FALSE,FALSE,1.94,"young",43,185,90,"m"
22,"TOTAL ABDOMINAL",1,"TuT",53680,53720,53600,53800,53700,53700,0,0,53700,"TuT",-40,-200,FALSE,TRUE,FALSE,0,"young",43,185,90,"m"
22,"TOTAL ABDOMINAL",2,"TuT",48480,48520,48500,48600,48500,48550,0.001,-50,48525,"TuT",-40,-100,FALSE,TRUE,FALSE,0.1,"young",43,185,90,"m"
22,"VERTICAL TRACTION",1,"Con01",3000,3000,2900,2750,3000,2825,0.058,175,2912.5,"Con",0,150,FALSE,FALSE,FALSE,6.19,"young",43,185,90,"m"
22,"VERTICAL TRACTION",1,"Con02",2000,2000,2600,2250,2000,2425,0.212,-425,2212.5,"Con",0,350,TRUE,FALSE,TRUE,17.53,"young",43,185,90,"m"
22,"VERTICAL TRACTION",1,"Con03",2100,2060,2500,3000,2080,2750,0.322,-670,2415,"Con",40,-500,TRUE,FALSE,TRUE,24.36,"young",43,185,90,"m"
22,"VERTICAL TRACTION",1,"Con04",2040,2040,2900,2400,2040,2650,0.299,-610,2345,"Con",0,500,TRUE,FALSE,TRUE,23.02,"young",43,185,90,"m"
22,"VERTICAL TRACTION",1,"Con05",2200,2200,2550,2250,2200,2400,0.091,-200,2300,"Con",0,300,FALSE,FALSE,TRUE,8.33,"young",43,185,90,"m"
22,"VERTICAL TRACTION",1,"Con06",2200,2200,2350,2350,2200,2350,0.068,-150,2275,"Con",0,0,FALSE,FALSE,FALSE,6.38,"young",43,185,90,"m"
22,"VERTICAL TRACTION",1,"Con07",2180,2120,2050,2200,2150,2125,0.012,25,2137.5,"Con",60,-150,FALSE,FALSE,FALSE,1.18,"young",43,185,90,"m"
22,"VERTICAL TRACTION",1,"Con08",2360,2360,2450,2550,2360,2500,0.059,-140,2430,"Con",0,-100,FALSE,FALSE,FALSE,5.6,"young",43,185,90,"m"
22,"VERTICAL TRACTION",1,"Con09",1960,1940,2350,2300,1950,2325,0.192,-375,2137.5,"Con",20,50,TRUE,FALSE,FALSE,16.13,"young",43,185,90,"m"
22,"VERTICAL TRACTION",1,"Con10",2260,2240,3150,3450,2250,3300,0.467,-1050,2775,"Con",20,-300,TRUE,FALSE,TRUE,31.82,"young",43,185,90,"m"
22,"VERTICAL TRACTION",2,"Con01",1960,1960,2850,2100,1960,2475,0.263,-515,2217.5,"Con",0,750,TRUE,FALSE,TRUE,20.81,"young",43,185,90,"m"
22,"VERTICAL TRACTION",2,"Con02",2020,2040,2050,2050,2030,2050,0.01,-20,2040,"Con",-20,0,FALSE,FALSE,FALSE,0.98,"young",43,185,90,"m"
22,"VERTICAL TRACTION",2,"Con03",1880,1900,1800,1900,1890,1850,0.021,40,1870,"Con",-20,-100,FALSE,FALSE,FALSE,2.16,"young",43,185,90,"m"
22,"VERTICAL TRACTION",2,"Con04",1920,1900,1950,2050,1910,2000,0.047,-90,1955,"Con",20,-100,FALSE,FALSE,FALSE,4.5,"young",43,185,90,"m"
22,"VERTICAL TRACTION",2,"Con05",1960,1980,2150,2050,1970,2100,0.066,-130,2035,"Con",-20,100,FALSE,FALSE,FALSE,6.19,"young",43,185,90,"m"
22,"VERTICAL TRACTION",2,"Con06",1960,1980,2250,2200,1970,2225,0.129,-255,2097.5,"Con",-20,50,FALSE,FALSE,FALSE,11.46,"young",43,185,90,"m"
22,"VERTICAL TRACTION",2,"Con07",1880,1880,2300,2100,1880,2200,0.17,-320,2040,"Con",0,200,TRUE,FALSE,TRUE,14.55,"young",43,185,90,"m"
22,"VERTICAL TRACTION",2,"Con08",1960,1940,2050,2550,1950,2300,0.179,-350,2125,"Con",20,-500,TRUE,FALSE,TRUE,15.22,"young",43,185,90,"m"
22,"VERTICAL TRACTION",2,"Con09",2100,2040,2200,2500,2070,2350,0.135,-280,2210,"Con",60,-300,FALSE,FALSE,TRUE,11.91,"young",43,185,90,"m"
22,"VERTICAL TRACTION",2,"Con10",1960,1920,2900,3200,1940,3050,0.572,-1110,2495,"Con",40,-300,TRUE,FALSE,TRUE,36.39,"young",43,185,90,"m"
22,"VERTICAL TRACTION",1,"Ecc01",2320,2320,2350,2450,2320,2400,0.034,-80,2360,"Ecc",0,-100,FALSE,FALSE,FALSE,3.33,"young",43,185,90,"m"
22,"VERTICAL TRACTION",1,"Ecc02",3080,3100,2350,2650,3090,2500,0.191,590,2795,"Ecc",-20,-300,TRUE,FALSE,TRUE,23.6,"young",43,185,90,"m"
22,"VERTICAL TRACTION",1,"Ecc03",4040,4060,3600,3150,4050,3375,0.167,675,3712.5,"Ecc",-20,450,TRUE,FALSE,TRUE,20,"young",43,185,90,"m"
22,"VERTICAL TRACTION",1,"Ecc04",3500,3500,2700,3400,3500,3050,0.129,450,3275,"Ecc",0,-700,TRUE,FALSE,TRUE,14.75,"young",43,185,90,"m"
22,"VERTICAL TRACTION",1,"Ecc05",3600,3600,3400,3500,3600,3450,0.042,150,3525,"Ecc",0,-100,FALSE,FALSE,FALSE,4.35,"young",43,185,90,"m"
22,"VERTICAL TRACTION",1,"Ecc06",3680,3740,3750,3550,3710,3650,0.016,60,3680,"Ecc",-60,200,FALSE,FALSE,TRUE,1.64,"young",43,185,90,"m"
22,"VERTICAL TRACTION",1,"Ecc07",3500,3500,3500,3450,3500,3475,0.007,25,3487.5,"Ecc",0,50,FALSE,FALSE,FALSE,0.72,"young",43,185,90,"m"
22,"VERTICAL TRACTION",1,"Ecc08",4600,4620,4300,4250,4610,4275,0.073,335,4442.5,"Ecc",-20,50,TRUE,FALSE,FALSE,7.84,"young",43,185,90,"m"
22,"VERTICAL TRACTION",1,"Ecc09",4060,4060,3550,3500,4060,3525,0.132,535,3792.5,"Ecc",0,50,TRUE,FALSE,FALSE,15.18,"young",43,185,90,"m"
22,"VERTICAL TRACTION",1,"Ecc10",4300,4320,3750,4450,4310,4100,0.049,210,4205,"Ecc",-20,-700,FALSE,FALSE,TRUE,5.12,"young",43,185,90,"m"
22,"VERTICAL TRACTION",2,"Ecc01",2480,2480,2350,2450,2480,2400,0.032,80,2440,"Ecc",0,-100,FALSE,FALSE,FALSE,3.33,"young",43,185,90,"m"
22,"VERTICAL TRACTION",2,"Ecc02",2760,2740,2800,2750,2750,2775,0.009,-25,2762.5,"Ecc",20,50,FALSE,FALSE,FALSE,0.9,"young",43,185,90,"m"
22,"VERTICAL TRACTION",2,"Ecc03",3440,3460,3500,3350,3450,3425,0.007,25,3437.5,"Ecc",-20,150,FALSE,FALSE,FALSE,0.73,"young",43,185,90,"m"
22,"VERTICAL TRACTION",2,"Ecc04",3460,3440,3300,3350,3450,3325,0.036,125,3387.5,"Ecc",20,-50,FALSE,FALSE,FALSE,3.76,"young",43,185,90,"m"
22,"VERTICAL TRACTION",2,"Ecc05",3900,3880,3650,3750,3890,3700,0.049,190,3795,"Ecc",20,-100,FALSE,FALSE,FALSE,5.14,"young",43,185,90,"m"
22,"VERTICAL TRACTION",2,"Ecc06",3860,3860,3400,3600,3860,3500,0.093,360,3680,"Ecc",0,-200,TRUE,FALSE,TRUE,10.29,"young",43,185,90,"m"
22,"VERTICAL TRACTION",2,"Ecc07",4020,4040,3900,3850,4030,3875,0.038,155,3952.5,"Ecc",-20,50,FALSE,FALSE,FALSE,4,"young",43,185,90,"m"
22,"VERTICAL TRACTION",2,"Ecc08",3820,3900,3700,3100,3860,3400,0.119,460,3630,"Ecc",-80,600,TRUE,TRUE,TRUE,13.53,"young",43,185,90,"m"
22,"VERTICAL TRACTION",2,"Ecc09",4120,4140,3750,3450,4130,3600,0.128,530,3865,"Ecc",-20,300,TRUE,FALSE,TRUE,14.72,"young",43,185,90,"m"
22,"VERTICAL TRACTION",2,"Ecc10",4180,4200,3550,3000,4190,3275,0.218,915,3732.5,"Ecc",-20,550,TRUE,FALSE,TRUE,27.94,"young",43,185,90,"m"
22,"VERTICAL TRACTION",1,"Rep01",5320,5320,5250,5200,5320,5225,0.018,95,5272.5,"Rep",0,50,FALSE,FALSE,FALSE,1.82,"young",43,185,90,"m"
22,"VERTICAL TRACTION",1,"Rep02",5080,5100,4950,4900,5090,4925,0.032,165,5007.5,"Rep",-20,50,TRUE,FALSE,FALSE,3.35,"young",43,185,90,"m"
22,"VERTICAL TRACTION",1,"Rep03",6140,6120,6100,6150,6130,6125,0.001,5,6127.5,"Rep",20,-50,FALSE,FALSE,FALSE,0.08,"young",43,185,90,"m"
22,"VERTICAL TRACTION",1,"Rep04",5540,5540,5600,5800,5540,5700,0.029,-160,5620,"Rep",0,-200,TRUE,FALSE,TRUE,2.81,"young",43,185,90,"m"
22,"VERTICAL TRACTION",1,"Rep05",5800,5800,5950,5750,5800,5850,0.009,-50,5825,"Rep",0,200,FALSE,FALSE,TRUE,0.85,"young",43,185,90,"m"
22,"VERTICAL TRACTION",1,"Rep06",5880,5940,6100,5900,5910,6000,0.015,-90,5955,"Rep",-60,200,FALSE,FALSE,TRUE,1.5,"young",43,185,90,"m"
22,"VERTICAL TRACTION",1,"Rep07",5680,5620,5550,5650,5650,5600,0.009,50,5625,"Rep",60,-100,FALSE,FALSE,FALSE,0.89,"young",43,185,90,"m"
22,"VERTICAL TRACTION",1,"Rep08",6960,6980,6750,6800,6970,6775,0.028,195,6872.5,"Rep",-20,-50,TRUE,FALSE,FALSE,2.88,"young",43,185,90,"m"
22,"VERTICAL TRACTION",1,"Rep09",6020,6000,5900,5800,6010,5850,0.027,160,5930,"Rep",20,100,TRUE,FALSE,FALSE,2.74,"young",43,185,90,"m"
22,"VERTICAL TRACTION",1,"Rep10",6560,6560,6900,7900,6560,7400,0.128,-840,6980,"Rep",0,-1000,TRUE,FALSE,TRUE,11.35,"young",43,185,90,"m"
22,"VERTICAL TRACTION",2,"Rep01",4440,4440,5200,4550,4440,4875,0.098,-435,4657.5,"Rep",0,650,TRUE,FALSE,TRUE,8.92,"young",43,185,90,"m"
22,"VERTICAL TRACTION",2,"Rep02",4780,4780,4850,4800,4780,4825,0.009,-45,4802.5,"Rep",0,50,FALSE,FALSE,FALSE,0.93,"young",43,185,90,"m"
22,"VERTICAL TRACTION",2,"Rep03",5320,5360,5300,5250,5340,5275,0.012,65,5307.5,"Rep",-40,50,FALSE,FALSE,FALSE,1.23,"young",43,185,90,"m"
22,"VERTICAL TRACTION",2,"Rep04",5380,5340,5250,5400,5360,5325,0.007,35,5342.5,"Rep",40,-150,FALSE,FALSE,FALSE,0.66,"young",43,185,90,"m"
22,"VERTICAL TRACTION",2,"Rep05",5860,5860,5800,5800,5860,5800,0.01,60,5830,"Rep",0,0,FALSE,FALSE,FALSE,1.03,"young",43,185,90,"m"
22,"VERTICAL TRACTION",2,"Rep06",5820,5840,5650,5800,5830,5725,0.018,105,5777.5,"Rep",-20,-150,FALSE,FALSE,FALSE,1.83,"young",43,185,90,"m"
22,"VERTICAL TRACTION",2,"Rep07",5900,5920,6200,5950,5910,6075,0.028,-165,5992.5,"Rep",-20,250,TRUE,FALSE,TRUE,2.72,"young",43,185,90,"m"
22,"VERTICAL TRACTION",2,"Rep08",5780,5840,5750,5650,5810,5700,0.019,110,5755,"Rep",-60,100,FALSE,FALSE,FALSE,1.93,"young",43,185,90,"m"
22,"VERTICAL TRACTION",2,"Rep09",6220,6180,5950,5950,6200,5950,0.04,250,6075,"Rep",40,0,TRUE,FALSE,FALSE,4.2,"young",43,185,90,"m"
22,"VERTICAL TRACTION",2,"Rep10",6140,6120,6450,6200,6130,6325,0.032,-195,6227.5,"Rep",20,250,TRUE,FALSE,TRUE,3.08,"young",43,185,90,"m"
22,"VERTICAL TRACTION",1,"TuT",58980,58980,59050,59850,58980,59450,0.008,-470,59215,"TuT",0,-800,FALSE,FALSE,FALSE,0.79,"young",43,185,90,"m"
22,"VERTICAL TRACTION",2,"TuT",55640,55680,56400,55350,55660,55875,0.004,-215,55767.5,"TuT",-40,1050,FALSE,FALSE,FALSE,0.38,"young",43,185,90,"m"
22,"CHEST PRESS",1,"Con01",3760,3720,6400,4050,3740,5225,0.397,-1485,4482.5,"Con",40,2350,TRUE,TRUE,TRUE,28.42,"young",43,185,90,"m"
22,"CHEST PRESS",1,"Con02",2440,2480,2500,3200,2460,2850,0.159,-390,2655,"Con",-40,-700,TRUE,TRUE,TRUE,13.68,"young",43,185,90,"m"
22,"CHEST PRESS",1,"Con03",2480,2500,2200,3250,2490,2725,0.094,-235,2607.5,"Con",-20,-1050,FALSE,FALSE,TRUE,8.62,"young",43,185,90,"m"
22,"CHEST PRESS",1,"Con04",2340,2400,2350,3650,2370,3000,0.266,-630,2685,"Con",-60,-1300,TRUE,TRUE,TRUE,21,"young",43,185,90,"m"
22,"CHEST PRESS",1,"Con05",2340,2320,2200,2600,2330,2400,0.03,-70,2365,"Con",20,-400,FALSE,FALSE,TRUE,2.92,"young",43,185,90,"m"
22,"CHEST PRESS",1,"Con06",2560,2560,2950,2850,2560,2900,0.133,-340,2730,"Con",0,100,FALSE,FALSE,FALSE,11.72,"young",43,185,90,"m"
22,"CHEST PRESS",1,"Con07",2180,2140,3050,2050,2160,2550,0.181,-390,2355,"Con",40,1000,TRUE,TRUE,TRUE,15.29,"young",43,185,90,"m"
22,"CHEST PRESS",1,"Con08",2240,2220,2950,1950,2230,2450,0.099,-220,2340,"Con",20,1000,FALSE,FALSE,TRUE,8.98,"young",43,185,90,"m"
22,"CHEST PRESS",1,"Con09",2240,2260,3000,2300,2250,2650,0.178,-400,2450,"Con",-20,700,TRUE,FALSE,TRUE,15.09,"young",43,185,90,"m"
22,"CHEST PRESS",1,"Con10",2480,2420,3250,2850,2450,3050,0.245,-600,2750,"Con",60,400,TRUE,TRUE,TRUE,19.67,"young",43,185,90,"m"
22,"CHEST PRESS",2,"Con01",2480,2460,4550,4600,2470,4575,0.852,-2105,3522.5,"Con",20,-50,TRUE,FALSE,FALSE,46.01,"young",43,185,90,"m"
22,"CHEST PRESS",2,"Con02",2440,2440,3700,3650,2440,3675,0.506,-1235,3057.5,"Con",0,50,TRUE,FALSE,FALSE,33.61,"young",43,185,90,"m"
22,"CHEST PRESS",2,"Con03",2320,2360,2850,2700,2340,2775,0.186,-435,2557.5,"Con",-40,150,TRUE,TRUE,FALSE,15.68,"young",43,185,90,"m"
22,"CHEST PRESS",2,"Con04",2360,2320,2300,3000,2340,2650,0.132,-310,2495,"Con",40,-700,FALSE,TRUE,TRUE,11.7,"young",43,185,90,"m"
22,"CHEST PRESS",2,"Con05",2040,2040,2450,2600,2040,2525,0.238,-485,2282.5,"Con",0,-150,TRUE,FALSE,FALSE,19.21,"young",43,185,90,"m"
22,"CHEST PRESS",2,"Con06",2020,2040,2600,2250,2030,2425,0.195,-395,2227.5,"Con",-20,350,TRUE,FALSE,TRUE,16.29,"young",43,185,90,"m"
22,"CHEST PRESS",2,"Con07",2100,2160,2450,2150,2130,2300,0.08,-170,2215,"Con",-60,300,FALSE,TRUE,FALSE,7.39,"young",43,185,90,"m"
22,"CHEST PRESS",2,"Con08",2360,2340,2000,1900,2350,1950,0.17,400,2150,"Con",20,100,TRUE,FALSE,FALSE,20.51,"young",43,185,90,"m"
22,"CHEST PRESS",2,"Con09",2040,2020,3150,3050,2030,3100,0.527,-1070,2565,"Con",20,100,TRUE,FALSE,FALSE,34.52,"young",43,185,90,"m"
22,"CHEST PRESS",2,"Con10",1860,1900,3450,3200,1880,3325,0.769,-1445,2602.5,"Con",-40,250,TRUE,TRUE,FALSE,43.46,"young",43,185,90,"m"
22,"CHEST PRESS",1,"Ecc01",3300,3240,2450,2650,3270,2550,0.22,720,2910,"Ecc",60,-200,TRUE,TRUE,FALSE,28.24,"young",43,185,90,"m"
22,"CHEST PRESS",1,"Ecc02",3300,3280,3450,2600,3290,3025,0.081,265,3157.5,"Ecc",20,850,FALSE,FALSE,TRUE,8.76,"young",43,185,90,"m"
22,"CHEST PRESS",1,"Ecc03",3840,3820,4150,2700,3830,3425,0.106,405,3627.5,"Ecc",20,1450,TRUE,FALSE,TRUE,11.82,"young",43,185,90,"m"
22,"CHEST PRESS",1,"Ecc04",4200,4140,4100,3250,4170,3675,0.119,495,3922.5,"Ecc",60,850,TRUE,TRUE,TRUE,13.47,"young",43,185,90,"m"
22,"CHEST PRESS",1,"Ecc05",3480,3500,3650,3200,3490,3425,0.019,65,3457.5,"Ecc",-20,450,FALSE,FALSE,TRUE,1.9,"young",43,185,90,"m"
22,"CHEST PRESS",1,"Ecc06",3820,3860,3100,3750,3840,3425,0.108,415,3632.5,"Ecc",-40,-650,TRUE,TRUE,TRUE,12.12,"young",43,185,90,"m"
22,"CHEST PRESS",1,"Ecc07",4180,4240,3200,4400,4210,3800,0.097,410,4005,"Ecc",-60,-1200,TRUE,TRUE,TRUE,10.79,"young",43,185,90,"m"
22,"CHEST PRESS",1,"Ecc08",4280,4220,3900,4450,4250,4175,0.018,75,4212.5,"Ecc",60,-550,FALSE,TRUE,TRUE,1.8,"young",43,185,90,"m"
22,"CHEST PRESS",1,"Ecc09",4320,4380,3350,4150,4350,3750,0.138,600,4050,"Ecc",-60,-800,TRUE,TRUE,TRUE,16,"young",43,185,90,"m"
22,"CHEST PRESS",1,"Ecc10",6340,6340,3950,3750,6340,3850,0.393,2490,5095,"Ecc",0,200,TRUE,FALSE,FALSE,64.68,"young",43,185,90,"m"
22,"CHEST PRESS",2,"Ecc01",3740,3760,1950,2000,3750,1975,0.473,1775,2862.5,"Ecc",-20,-50,TRUE,FALSE,FALSE,89.87,"young",43,185,90,"m"
22,"CHEST PRESS",2,"Ecc02",3700,3680,3150,3200,3690,3175,0.14,515,3432.5,"Ecc",20,-50,TRUE,FALSE,FALSE,16.22,"young",43,185,90,"m"
22,"CHEST PRESS",2,"Ecc03",4260,4260,4050,3950,4260,4000,0.061,260,4130,"Ecc",0,100,FALSE,FALSE,FALSE,6.5,"young",43,185,90,"m"
22,"CHEST PRESS",2,"Ecc04",4100,4120,4100,3500,4110,3800,0.075,310,3955,"Ecc",-20,600,FALSE,FALSE,TRUE,8.16,"young",43,185,90,"m"
22,"CHEST PRESS",2,"Ecc05",3900,3880,3350,3400,3890,3375,0.132,515,3632.5,"Ecc",20,-50,TRUE,FALSE,FALSE,15.26,"young",43,185,90,"m"
22,"CHEST PRESS",2,"Ecc06",3720,3700,2950,3500,3710,3225,0.131,485,3467.5,"Ecc",20,-550,TRUE,FALSE,TRUE,15.04,"young",43,185,90,"m"
22,"CHEST PRESS",2,"Ecc07",4300,4260,4250,4350,4280,4300,0.005,-20,4290,"Ecc",40,-100,FALSE,TRUE,FALSE,0.47,"young",43,185,90,"m"
22,"CHEST PRESS",2,"Ecc08",4300,4340,4800,4750,4320,4775,0.105,-455,4547.5,"Ecc",-40,50,TRUE,TRUE,FALSE,9.53,"young",43,185,90,"m"
22,"CHEST PRESS",2,"Ecc09",4560,4540,2500,2950,4550,2725,0.401,1825,3637.5,"Ecc",20,-450,TRUE,FALSE,TRUE,66.97,"young",43,185,90,"m"
22,"CHEST PRESS",2,"Ecc10",4100,4100,4500,4700,4100,4600,0.122,-500,4350,"Ecc",0,-200,TRUE,FALSE,FALSE,10.87,"young",43,185,90,"m"
22,"CHEST PRESS",1,"Rep01",7060,6960,8850,6700,7010,7775,0.109,-765,7392.5,"Rep",100,2150,TRUE,TRUE,TRUE,9.84,"young",43,185,90,"m"
22,"CHEST PRESS",1,"Rep02",5740,5760,5950,5800,5750,5875,0.022,-125,5812.5,"Rep",-20,150,FALSE,FALSE,FALSE,2.13,"young",43,185,90,"m"
22,"CHEST PRESS",1,"Rep03",6320,6320,6350,5950,6320,6150,0.027,170,6235,"Rep",0,400,TRUE,FALSE,TRUE,2.76,"young",43,185,90,"m"
22,"CHEST PRESS",1,"Rep04",6540,6540,6450,6900,6540,6675,0.021,-135,6607.5,"Rep",0,-450,FALSE,FALSE,TRUE,2.02,"young",43,185,90,"m"
22,"CHEST PRESS",1,"Rep05",5820,5820,5850,5800,5820,5825,0.001,-5,5822.5,"Rep",0,50,FALSE,FALSE,FALSE,0.09,"young",43,185,90,"m"
22,"CHEST PRESS",1,"Rep06",6380,6420,6050,6600,6400,6325,0.012,75,6362.5,"Rep",-40,-550,FALSE,FALSE,TRUE,1.19,"young",43,185,90,"m"
22,"CHEST PRESS",1,"Rep07",6360,6380,6250,6450,6370,6350,0.003,20,6360,"Rep",-20,-200,FALSE,FALSE,TRUE,0.31,"young",43,185,90,"m"
22,"CHEST PRESS",1,"Rep08",6520,6440,6850,6400,6480,6625,0.022,-145,6552.5,"Rep",80,450,TRUE,TRUE,TRUE,2.19,"young",43,185,90,"m"
22,"CHEST PRESS",1,"Rep09",6560,6640,6350,6450,6600,6400,0.03,200,6500,"Rep",-80,-100,TRUE,TRUE,FALSE,3.12,"young",43,185,90,"m"
22,"CHEST PRESS",1,"Rep10",8820,8760,7200,6600,8790,6900,0.215,1890,7845,"Rep",60,600,TRUE,FALSE,TRUE,27.39,"young",43,185,90,"m"
22,"CHEST PRESS",2,"Rep01",6220,6220,6500,6600,6220,6550,0.053,-330,6385,"Rep",0,-100,TRUE,FALSE,FALSE,5.04,"young",43,185,90,"m"
22,"CHEST PRESS",2,"Rep02",6140,6120,6850,6850,6130,6850,0.117,-720,6490,"Rep",20,0,TRUE,FALSE,FALSE,10.51,"young",43,185,90,"m"
22,"CHEST PRESS",2,"Rep03",6580,6620,6900,6650,6600,6775,0.027,-175,6687.5,"Rep",-40,250,TRUE,FALSE,TRUE,2.58,"young",43,185,90,"m"
22,"CHEST PRESS",2,"Rep04",6460,6440,6400,6500,6450,6450,0,0,6450,"Rep",20,-100,FALSE,FALSE,FALSE,0,"young",43,185,90,"m"
22,"CHEST PRESS",2,"Rep05",5940,5920,5800,6000,5930,5900,0.005,30,5915,"Rep",20,-200,FALSE,FALSE,TRUE,0.51,"young",43,185,90,"m"
22,"CHEST PRESS",2,"Rep06",5740,5740,5550,5750,5740,5650,0.016,90,5695,"Rep",0,-200,FALSE,FALSE,TRUE,1.59,"young",43,185,90,"m"
22,"CHEST PRESS",2,"Rep07",6400,6420,6700,6500,6410,6600,0.03,-190,6505,"Rep",-20,200,TRUE,FALSE,TRUE,2.88,"young",43,185,90,"m"
22,"CHEST PRESS",2,"Rep08",6660,6680,6800,6650,6670,6725,0.008,-55,6697.5,"Rep",-20,150,FALSE,FALSE,FALSE,0.82,"young",43,185,90,"m"
22,"CHEST PRESS",2,"Rep09",6600,6560,5650,6000,6580,5825,0.115,755,6202.5,"Rep",40,-350,TRUE,FALSE,TRUE,12.96,"young",43,185,90,"m"
22,"CHEST PRESS",2,"Rep10",5960,6000,7950,7900,5980,7925,0.325,-1945,6952.5,"Rep",-40,50,TRUE,FALSE,FALSE,24.54,"young",43,185,90,"m"
22,"CHEST PRESS",1,"TuT",66120,66040,66150,63650,66080,64900,0.018,1180,65490,"TuT",80,2500,FALSE,TRUE,TRUE,1.82,"young",43,185,90,"m"
22,"CHEST PRESS",2,"TuT",62700,62720,65100,65400,62710,65250,0.041,-2540,63980,"TuT",-20,-300,TRUE,FALSE,FALSE,3.89,"young",43,185,90,"m"
